filing_date,negative,positive,words,sentiment,sentiment.ratio,positive.ratio,negative.ratio,Year,TICKER
2010-02-16T00:00:00Z,1123,1892,73405,769,0.010476126,0.025774811,0.015298685,2010,MMM
2011-02-16T00:00:00Z,1092,1789,71068,697,0.009807508,0.025173074,0.015365565,2011,MMM
2012-02-16T00:00:00Z,1167,1867,73396,700,0.009537304,0.025437354,0.015900049,2012,MMM
2013-02-14T00:00:00Z,1183,1697,70812,514,0.007258657,0.023964865,0.016706208,2013,MMM
2014-02-13T00:00:00Z,1176,1663,69081,487,0.007049695,0.024073189,0.017023494,2014,MMM
2015-02-12T00:00:00Z,1161,1609,68575,448,0.006532993,0.023463361,0.016930368,2015,MMM
2016-02-11T00:00:00Z,1095,1675,67389,580,0.008606746,0.024855689,0.016248943,2016,MMM
2017-02-09T00:00:00Z,1222,1861,72778,639,0.008780126,0.025570914,0.016790788,2017,MMM
2018-02-08T00:00:00Z,1243,1852,76199,609,0.007992231,0.024304781,0.01631255,2018,MMM
2019-02-07T00:00:00Z,1229,1763,75988,534,0.007027425,0.023201032,0.016173606,2019,MMM
2011-02-18T00:00:00Z,763,1030,46130,267,0.00578799,0.022328203,0.016540212,2011,ABT
2012-02-21T00:00:00Z,814,1098,48799,284,0.005819791,0.022500461,0.01668067,2012,ABT
2013-02-15T00:00:00Z,801,1014,46390,213,0.004591507,0.021858159,0.017266652,2013,ABT
2014-02-21T00:00:00Z,759,976,42290,217,0.005131237,0.023078742,0.017947505,2014,ABT
2015-02-27T00:00:00Z,761,1009,45192,248,0.005487697,0.022326961,0.016839264,2015,ABT
2016-02-19T00:00:00Z,723,1015,46112,292,0.006332408,0.022011624,0.015679216,2016,ABT
2017-02-17T00:00:00Z,775,1007,48317,232,0.004801623,0.020841526,0.016039903,2017,ABT
2018-02-16T00:00:00Z,838,1152,52620,314,0.005967313,0.021892816,0.015925504,2018,ABT
2019-02-22T00:00:00Z,818,1190,52377,372,0.007102354,0.022719896,0.015617542,2019,ABT
2013-03-15T00:00:00Z,859,1090,49129,231,0.004701907,0.022186489,0.017484581,2013,ABBV
2014-02-21T00:00:00Z,852,1214,51825,362,0.006985046,0.023424988,0.016439942,2014,ABBV
2015-02-20T00:00:00Z,884,1232,53360,348,0.006521739,0.023088456,0.016566717,2015,ABBV
2016-02-19T00:00:00Z,937,1287,55726,350,0.006280731,0.023095144,0.016814413,2016,ABBV
2017-02-17T00:00:00Z,951,1303,56294,352,0.006252887,0.023146339,0.016893452,2017,ABBV
2018-02-16T00:00:00Z,963,1304,54790,341,0.006223763,0.023799963,0.0175762,2018,ABBV
2019-02-27T00:00:00Z,923,1278,53495,355,0.006636134,0.023890083,0.017253949,2019,ABBV
2010-06-08T00:00:00Z,854,1131,43901,277,0.006309651,0.025762511,0.01945286,2010,ABMD
2011-06-02T00:00:00Z,808,1000,37667,192,0.0050973,0.026548438,0.021451138,2011,ABMD
2012-06-04T00:00:00Z,900,1047,41229,147,0.003565452,0.025394746,0.021829295,2012,ABMD
2013-05-28T00:00:00Z,1044,1156,46113,112,0.002428816,0.025068853,0.022640036,2013,ABMD
2014-05-28T00:00:00Z,1068,1243,49861,175,0.003509757,0.024929303,0.021419546,2014,ABMD
2015-05-28T00:00:00Z,1060,1289,51131,229,0.004478692,0.025209755,0.020731063,2015,ABMD
2016-05-26T00:00:00Z,321,537,22270,216,0.009699147,0.024113157,0.01441401,2016,ABMD
2017-05-25T00:00:00Z,942,1259,49363,317,0.006421814,0.025504933,0.019083119,2017,ABMD
2018-05-24T00:00:00Z,1042,1451,53927,409,0.007584327,0.026906744,0.019322417,2018,ABMD
2019-05-23T00:00:00Z,1042,1478,53191,436,0.008196875,0.027786656,0.01958978,2019,ABMD
2010-10-26T00:00:00Z,902,1441,61126,539,0.008817852,0.023574256,0.014756405,2010,ACN
2011-10-21T00:00:00Z,860,1370,57985,510,0.008795378,0.0236268,0.014831422,2011,ACN
2012-10-30T00:00:00Z,883,1356,57475,473,0.008229665,0.023592866,0.015363201,2012,ACN
2013-10-29T00:00:00Z,902,1433,59511,531,0.00892272,0.024079582,0.015156862,2013,ACN
2014-10-24T00:00:00Z,837,1312,56601,475,0.008392078,0.023179802,0.014787725,2014,ACN
2015-10-30T00:00:00Z,779,1204,53156,425,0.007995334,0.022650312,0.014654978,2015,ACN
2016-10-28T00:00:00Z,786,1279,54600,493,0.009029304,0.023424908,0.014395604,2016,ACN
2017-10-26T00:00:00Z,787,1269,52900,482,0.009111531,0.023988658,0.014877127,2017,ACN
2018-10-24T00:00:00Z,773,1207,51066,434,0.008498805,0.023636079,0.015137273,2018,ACN
2011-02-25T00:00:00Z,1050,1476,68448,426,0.006223703,0.021563815,0.015340112,2011,ATVI
2012-02-28T00:00:00Z,999,1444,66414,445,0.006700394,0.021742404,0.015042009,2012,ATVI
2013-02-22T00:00:00Z,1030,1516,69921,486,0.006950702,0.021681612,0.014730911,2013,ATVI
2014-03-03T00:00:00Z,1259,1681,81177,422,0.005198517,0.020707836,0.015509319,2014,ATVI
2015-02-26T00:00:00Z,1274,1747,81846,473,0.005779146,0.021344965,0.015565819,2015,ATVI
2016-02-29T00:00:00Z,1154,1770,80255,616,0.007675534,0.022054701,0.014379166,2016,ATVI
2017-02-28T00:00:00Z,953,1538,71975,585,0.008127822,0.021368531,0.013240709,2017,ATVI
2018-02-27T00:00:00Z,978,1599,71403,621,0.008697114,0.022394017,0.013696903,2018,ATVI
2019-02-28T00:00:00Z,1030,1620,73780,590,0.007996747,0.02195717,0.013960423,2019,ATVI
2010-01-22T00:00:00Z,1020,2116,76495,1096,0.014327734,0.027661939,0.013334205,2010,ADBE
2011-01-27T00:00:00Z,1046,2344,82590,1298,0.015716188,0.02838116,0.012664972,2011,ADBE
2012-01-26T00:00:00Z,978,2023,76881,1045,0.013592435,0.026313393,0.012720958,2012,ADBE
2013-01-22T00:00:00Z,1072,2058,76813,986,0.012836369,0.02679234,0.013955971,2013,ADBE
2014-01-21T00:00:00Z,1102,1541,61418,439,0.007147742,0.025090364,0.017942623,2014,ADBE
2015-01-20T00:00:00Z,1157,1627,63873,470,0.007358352,0.025472422,0.01811407,2015,ADBE
2016-01-19T00:00:00Z,1183,1631,62538,448,0.007163645,0.026080143,0.018916499,2016,ADBE
2017-01-20T00:00:00Z,1146,1570,60769,424,0.006977242,0.025835541,0.018858299,2017,ADBE
2018-01-22T00:00:00Z,1131,1479,58552,348,0.005943435,0.025259598,0.019316163,2018,ADBE
2019-01-25T00:00:00Z,1229,1564,61233,335,0.005470906,0.025541783,0.020070877,2019,ADBE
2010-02-19T00:00:00Z,1298,1871,84402,573,0.006788939,0.022167721,0.015378782,2010,AMD
2011-02-18T00:00:00Z,1220,1719,79887,499,0.006246323,0.021517894,0.015271571,2011,AMD
2012-02-24T00:00:00Z,1079,1659,72759,580,0.007971522,0.022801303,0.014829781,2012,AMD
2013-02-21T00:00:00Z,1085,1482,65998,397,0.006015334,0.022455226,0.016439892,2013,AMD
2014-02-18T00:00:00Z,1118,1406,64067,288,0.004495294,0.021945776,0.017450482,2014,AMD
2015-02-19T00:00:00Z,1154,1483,66602,329,0.004939792,0.022266599,0.017326807,2015,AMD
2016-02-18T00:00:00Z,1207,1566,67091,359,0.005350941,0.023341432,0.017990491,2016,AMD
2017-02-21T00:00:00Z,1234,1598,72203,364,0.005041342,0.022132044,0.017090703,2017,AMD
2018-02-27T00:00:00Z,1314,1631,75965,317,0.004172974,0.021470414,0.01729744,2018,AMD
2019-02-08T00:00:00Z,1264,1401,66615,137,0.002056594,0.021031299,0.018974705,2019,AMD
2010-03-02T00:00:00Z,605,1015,47215,410,0.008683681,0.021497405,0.012813724,2010,AAP
2011-03-01T00:00:00Z,565,912,44321,347,0.007829246,0.020577153,0.012747907,2011,AAP
2012-02-28T00:00:00Z,542,897,43109,355,0.008234939,0.02080772,0.012572781,2012,AAP
2013-02-25T00:00:00Z,604,884,44193,280,0.006335845,0.020003168,0.013667323,2013,AAP
2014-02-25T00:00:00Z,654,932,47788,278,0.00581736,0.019502804,0.013685444,2014,AAP
2015-03-03T00:00:00Z,651,950,47854,299,0.006248172,0.01985205,0.013603878,2015,AAP
2016-03-01T00:00:00Z,673,967,48567,294,0.006053493,0.019910639,0.013857146,2016,AAP
2017-02-28T00:00:00Z,623,978,47731,355,0.007437514,0.020489828,0.013052314,2017,AAP
2018-02-21T00:00:00Z,442,711,34407,269,0.007818177,0.0206644,0.012846223,2018,AAP
2019-02-19T00:00:00Z,455,719,34086,264,0.007745115,0.021093704,0.013348589,2019,AAP
2010-02-26T00:00:00Z,2593,2976,151041,383,0.002535735,0.019703259,0.017167524,2010,AES
2011-02-28T00:00:00Z,2833,3168,165998,335,0.002018097,0.019084567,0.017066471,2011,AES
2012-02-27T00:00:00Z,2573,2880,157666,307,0.001947154,0.018266462,0.016319308,2012,AES
2013-02-27T00:00:00Z,2319,2561,137747,242,0.001756844,0.018592056,0.016835212,2013,AES
2014-02-26T00:00:00Z,2111,2441,124759,330,0.0026451,0.019565723,0.016920623,2014,AES
2015-02-26T00:00:00Z,2216,2544,131611,328,0.002492193,0.019329691,0.016837498,2015,AES
2016-02-24T00:00:00Z,2167,2670,135569,503,0.003710288,0.019694768,0.01598448,2016,AES
2017-02-27T00:00:00Z,2041,2451,124193,410,0.003301313,0.019735412,0.016434099,2017,AES
2018-02-27T00:00:00Z,1989,2135,111583,146,0.001308443,0.019133739,0.017825296,2018,AES
2019-02-27T00:00:00Z,2017,2167,115274,150,0.001301247,0.018798688,0.017497441,2019,AES
2015-02-23T00:00:00Z,474,864,39060,390,0.009984639,0.022119816,0.012135177,2015,AMG
2016-02-25T00:00:00Z,514,946,40599,432,0.010640656,0.023301067,0.01266041,2016,AMG
2017-02-24T00:00:00Z,522,1021,43791,499,0.011395036,0.023315293,0.011920258,2017,AMG
2018-02-23T00:00:00Z,508,1001,42786,493,0.011522461,0.023395503,0.011873043,2018,AMG
2019-02-22T00:00:00Z,532,1001,43692,469,0.010734231,0.022910373,0.012176142,2019,AMG
2010-02-26T00:00:00Z,1332,1630,71307,298,0.004179113,0.022858906,0.018679793,2010,AFL
2011-02-25T00:00:00Z,1394,1693,73496,299,0.004068249,0.023035267,0.018967019,2011,AFL
2012-02-27T00:00:00Z,1556,1837,81430,281,0.003450817,0.022559253,0.019108437,2012,AFL
2013-02-27T00:00:00Z,1584,1941,85308,357,0.004184836,0.022752849,0.018568012,2013,AFL
2014-02-27T00:00:00Z,1643,2049,88526,406,0.004586223,0.023145742,0.018559519,2014,AFL
2015-02-26T00:00:00Z,1664,2126,89537,462,0.005159878,0.023744374,0.018584496,2015,AFL
2016-02-25T00:00:00Z,1834,2256,93953,422,0.004491608,0.024012006,0.019520398,2016,AFL
2017-02-24T00:00:00Z,1767,2282,91154,515,0.005649779,0.025034557,0.019384777,2017,AFL
2018-02-23T00:00:00Z,1874,2392,98237,518,0.005272962,0.024349278,0.019076315,2018,AFL
2019-02-25T00:00:00Z,1965,2590,107558,625,0.005810818,0.024080031,0.018269213,2019,AFL
2009-12-21T00:00:00Z,958,1533,61281,575,0.009383006,0.02501591,0.015632904,2009,A
2010-12-20T00:00:00Z,915,1630,63628,715,0.011237191,0.025617653,0.014380461,2010,A
2011-12-16T00:00:00Z,844,1591,62184,747,0.012012736,0.02558536,0.013572623,2011,A
2012-12-20T00:00:00Z,898,1644,66800,746,0.011167665,0.024610778,0.013443114,2012,A
2013-12-19T00:00:00Z,913,1636,66800,723,0.010823353,0.024491018,0.013667665,2013,A
2014-12-22T00:00:00Z,946,1754,71387,808,0.011318587,0.0245703,0.013251712,2014,A
2015-12-21T00:00:00Z,1038,1665,67879,627,0.009237025,0.024528941,0.015291916,2015,A
2016-12-20T00:00:00Z,964,1647,65314,683,0.010457176,0.025216646,0.01475947,2016,A
2017-12-21T00:00:00Z,895,1578,62058,683,0.011005833,0.025427826,0.014421992,2017,A
2018-12-20T00:00:00Z,863,1574,62037,711,0.011460902,0.025371955,0.013911053,2018,A
2009-11-25T00:00:00Z,840,1098,50091,258,0.005150626,0.021920105,0.01676948,2009,APD
2010-11-23T00:00:00Z,865,1268,54092,403,0.00745027,0.023441544,0.015991274,2010,APD
2011-11-22T00:00:00Z,826,1276,53992,450,0.008334568,0.023633131,0.015298563,2011,APD
2012-11-20T00:00:00Z,872,1290,56451,418,0.007404652,0.022851677,0.015447025,2012,APD
2013-11-26T00:00:00Z,880,1304,56767,424,0.007469128,0.022971092,0.015501964,2013,APD
2014-11-24T00:00:00Z,916,1371,57786,455,0.007873879,0.02372547,0.01585159,2014,APD
2015-11-24T00:00:00Z,275,345,15224,70,0.004598003,0.022661587,0.018063584,2015,APD
2016-11-21T00:00:00Z,321,343,15965,22,0.001378014,0.021484497,0.020106483,2016,APD
2017-11-16T00:00:00Z,1165,1595,64508,430,0.00666584,0.024725615,0.018059776,2017,APD
2018-11-20T00:00:00Z,1092,1568,68299,476,0.006969355,0.022957876,0.015988521,2018,APD
2011-03-01T00:00:00Z,848,1215,53170,367,0.006902389,0.022851232,0.015948843,2011,AKAM
2012-02-29T00:00:00Z,810,1140,47405,330,0.006961291,0.024048096,0.017086805,2012,AKAM
2013-03-01T00:00:00Z,764,1225,48039,461,0.00959637,0.025500114,0.015903745,2013,AKAM
2014-03-03T00:00:00Z,690,1101,45050,411,0.009123196,0.024439512,0.015316315,2014,AKAM
2015-03-02T00:00:00Z,701,1143,46559,442,0.009493331,0.024549496,0.015056165,2015,AKAM
2016-02-29T00:00:00Z,701,1130,46353,429,0.009255064,0.024378142,0.015123077,2016,AKAM
2017-02-28T00:00:00Z,743,1167,47076,424,0.009006713,0.024789702,0.015782989,2017,AKAM
2018-03-01T00:00:00Z,749,1203,48964,454,0.009272118,0.024569071,0.015296953,2018,AKAM
2019-02-28T00:00:00Z,725,1194,49823,469,0.009413323,0.023964836,0.014551512,2019,AKAM
2010-02-19T00:00:00Z,789,997,46836,208,0.004441028,0.021287044,0.016846016,2010,ALK
2011-02-23T00:00:00Z,711,908,44931,197,0.004384501,0.020208765,0.015824264,2011,ALK
2012-02-21T00:00:00Z,619,798,37500,179,0.004773333,0.02128,0.016506667,2012,ALK
2013-02-14T00:00:00Z,572,829,37784,257,0.006801821,0.021940504,0.015138683,2013,ALK
2014-02-13T00:00:00Z,581,878,39491,297,0.007520701,0.022232914,0.014712213,2014,ALK
2015-02-11T00:00:00Z,597,903,39345,306,0.007777354,0.02295082,0.015173465,2015,ALK
2016-02-11T00:00:00Z,579,930,40100,351,0.008753117,0.02319202,0.014438903,2016,ALK
2017-02-28T00:00:00Z,717,1136,47745,419,0.008775788,0.023793067,0.015017279,2017,ALK
2018-02-15T00:00:00Z,667,1141,48112,474,0.009852012,0.023715497,0.013863485,2018,ALK
2019-02-15T00:00:00Z,695,1066,47340,371,0.007836924,0.022517955,0.014681031,2019,ALK
2010-02-26T00:00:00Z,871,1671,58203,800,0.013744996,0.02870986,0.014964864,2010,ALB
2011-02-25T00:00:00Z,894,1587,61212,693,0.01132131,0.025926289,0.014604979,2011,ALB
2012-02-22T00:00:00Z,856,1627,60633,771,0.012715848,0.026833572,0.014117725,2012,ALB
2013-02-15T00:00:00Z,967,1705,63807,738,0.011566129,0.026721206,0.015155077,2013,ALB
2014-02-25T00:00:00Z,900,1589,61281,689,0.011243289,0.025929734,0.014686444,2014,ALB
2015-03-02T00:00:00Z,1149,1815,73316,666,0.009083965,0.024755851,0.015671886,2015,ALB
2016-02-29T00:00:00Z,1171,1840,74131,669,0.009024565,0.024820925,0.01579636,2016,ALB
2017-02-28T00:00:00Z,1220,1860,74272,640,0.008616975,0.025043085,0.016426109,2017,ALB
2018-02-28T00:00:00Z,1196,1877,75769,681,0.008987845,0.024772664,0.01578482,2018,ALB
2019-02-27T00:00:00Z,1161,1806,73829,645,0.008736404,0.024461932,0.015725528,2019,ALB
2010-03-01T00:00:00Z,969,1293,59712,324,0.005426045,0.021653939,0.016227894,2010,ARE
2011-03-01T00:00:00Z,1125,1381,68790,256,0.003721471,0.020075592,0.016354121,2011,ARE
2012-02-21T00:00:00Z,1314,1555,76990,241,0.003130277,0.020197428,0.017067152,2012,ARE
2013-02-26T00:00:00Z,1409,1708,87883,299,0.003402251,0.019434931,0.01603268,2013,ARE
2014-03-03T00:00:00Z,1320,1599,80450,279,0.003467993,0.019875699,0.016407707,2014,ARE
2015-02-24T00:00:00Z,1405,1663,85360,258,0.003022493,0.019482193,0.0164597,2015,ARE
2016-02-03T00:00:00Z,1459,1817,89149,358,0.004015749,0.020381608,0.016365859,2016,ARE
2017-01-31T00:00:00Z,1640,1920,92755,280,0.003018705,0.020699693,0.017680988,2017,ARE
2018-01-30T00:00:00Z,1715,2230,100928,515,0.005102647,0.022094959,0.016992311,2018,ARE
2019-02-05T00:00:00Z,1838,2302,106320,464,0.004364184,0.021651618,0.017287434,2019,ARE
2012-02-17T00:00:00Z,1370,1431,61147,61,0.000997596,0.02340262,0.022405024,2012,ALXN
2013-02-19T00:00:00Z,1451,1486,65388,35,0.000535266,0.022725882,0.022190616,2013,ALXN
2014-02-10T00:00:00Z,1562,1731,72871,169,0.002319167,0.023754306,0.021435139,2014,ALXN
2015-02-06T00:00:00Z,1659,1778,78674,119,0.001512571,0.022599588,0.021087017,2015,ALXN
2016-02-08T00:00:00Z,1542,1715,76851,173,0.002251109,0.02231591,0.020064801,2016,ALXN
2017-02-16T00:00:00Z,1614,1769,78305,155,0.001979439,0.02259115,0.020611711,2017,ALXN
2018-02-08T00:00:00Z,1558,1871,80907,313,0.003868639,0.023125317,0.019256677,2018,ALXN
2019-02-06T00:00:00Z,1768,2170,91466,402,0.004395076,0.023724663,0.019329587,2019,ALXN
2010-02-26T00:00:00Z,842,1064,50049,222,0.004435653,0.021259166,0.016823513,2010,ALGN
2011-02-24T00:00:00Z,883,1050,47842,167,0.003490657,0.021947243,0.018456586,2011,ALGN
2012-02-29T00:00:00Z,875,1124,51584,249,0.004827078,0.021789702,0.016962624,2012,ALGN
2013-03-01T00:00:00Z,903,1285,54328,382,0.007031365,0.023652628,0.016621263,2013,ALGN
2014-02-28T00:00:00Z,936,1370,56139,434,0.007730811,0.024403712,0.016672901,2014,ALGN
2015-02-26T00:00:00Z,895,1378,58512,483,0.008254717,0.023550725,0.015296008,2015,ALGN
2016-02-25T00:00:00Z,864,1198,52410,334,0.00637283,0.022858233,0.016485404,2016,ALGN
2017-02-28T00:00:00Z,910,1242,52892,332,0.006276942,0.023481812,0.01720487,2017,ALGN
2018-02-28T00:00:00Z,923,1293,54356,370,0.006806976,0.023787622,0.016980646,2018,ALGN
2019-02-28T00:00:00Z,1020,1336,55818,316,0.005661256,0.023934931,0.018273675,2019,ALGN
2014-03-10T00:00:00Z,736,1475,54419,739,0.013579816,0.027104504,0.013524688,2014,ALLE
2015-02-27T00:00:00Z,766,1375,53299,609,0.011426106,0.025797857,0.014371752,2015,ALLE
2016-02-26T00:00:00Z,733,1318,51102,585,0.011447693,0.025791554,0.014343861,2016,ALLE
2017-02-17T00:00:00Z,756,1329,51608,573,0.01110293,0.025751821,0.014648892,2017,ALLE
2018-02-20T00:00:00Z,699,1342,49910,643,0.01288319,0.026888399,0.014005209,2018,ALLE
2019-02-19T00:00:00Z,696,1425,52210,729,0.013962842,0.027293622,0.01333078,2019,ALLE
2014-02-25T00:00:00Z,1747,2178,110669,431,0.003894496,0.019680308,0.015785812,2014,AGN
2015-02-18T00:00:00Z,2481,2688,144605,207,0.001431486,0.018588569,0.017157083,2015,AGN
2016-02-26T00:00:00Z,2550,2806,141116,256,0.00181411,0.01988435,0.01807024,2016,AGN
2017-02-24T00:00:00Z,2262,2526,130591,264,0.002021579,0.019342834,0.017321255,2017,AGN
2018-02-16T00:00:00Z,2502,2681,135179,179,0.00132417,0.019832962,0.018508792,2018,AGN
2019-02-15T00:00:00Z,2041,2237,108903,196,0.001799767,0.020541216,0.018741449,2019,AGN
2010-03-01T00:00:00Z,819,1705,68218,886,0.012987774,0.024993404,0.012005629,2010,ADS
2011-02-28T00:00:00Z,979,1795,73949,816,0.011034632,0.024273486,0.013238854,2011,ADS
2012-02-27T00:00:00Z,903,1721,71218,818,0.01148586,0.024165239,0.012679379,2012,ADS
2013-02-28T00:00:00Z,868,1616,66748,748,0.011206328,0.024210463,0.013004135,2013,ADS
2014-02-28T00:00:00Z,825,1558,63429,733,0.011556228,0.024562897,0.013006669,2014,ADS
2015-02-27T00:00:00Z,860,1481,62189,621,0.009985689,0.023814501,0.013828812,2015,ADS
2016-02-25T00:00:00Z,863,1494,62885,631,0.010034189,0.023757653,0.013723463,2016,ADS
2017-02-27T00:00:00Z,915,1640,66284,725,0.010937783,0.024742019,0.013804236,2017,ADS
2018-02-27T00:00:00Z,861,1515,61958,654,0.010555538,0.024452048,0.013896511,2018,ADS
2019-02-26T00:00:00Z,926,1540,63212,614,0.009713346,0.024362463,0.014649117,2019,ADS
2010-02-26T00:00:00Z,1440,2338,119500,898,0.007514644,0.019564854,0.012050209,2010,LNT
2011-02-28T00:00:00Z,1460,2359,127632,899,0.007043688,0.018482826,0.011439138,2011,LNT
2012-02-27T00:00:00Z,1462,2425,132955,963,0.007243052,0.018239254,0.010996202,2012,LNT
2013-02-26T00:00:00Z,1186,2258,119933,1072,0.008938324,0.018827179,0.009888855,2013,LNT
2014-02-25T00:00:00Z,1078,2004,109460,926,0.008459711,0.018308058,0.009848346,2014,LNT
2015-02-25T00:00:00Z,1061,1804,101327,743,0.007332695,0.017803744,0.010471049,2015,LNT
2016-02-24T00:00:00Z,1019,1670,94188,651,0.006911708,0.017730496,0.010818788,2016,LNT
2017-02-24T00:00:00Z,908,1495,80709,587,0.007273043,0.018523337,0.011250294,2017,LNT
2018-02-23T00:00:00Z,828,1473,75025,645,0.008597134,0.019633456,0.011036321,2018,LNT
2019-02-22T00:00:00Z,746,1229,64110,483,0.007533926,0.019170176,0.01163625,2019,LNT
2010-02-25T00:00:00Z,3619,3065,127160,-554,-0.004356716,0.024103492,0.028460208,2010,ALL
2011-02-24T00:00:00Z,3747,3216,129117,-531,-0.004112549,0.024907642,0.029020191,2011,ALL
2012-02-22T00:00:00Z,3378,3062,122830,-316,-0.002572661,0.024928763,0.027501425,2012,ALL
2013-02-20T00:00:00Z,3185,2946,118419,-239,-0.002018257,0.024877765,0.026896022,2013,ALL
2014-02-20T00:00:00Z,3296,3074,124149,-222,-0.001788174,0.02476057,0.026548744,2014,ALL
2015-02-19T00:00:00Z,3329,3120,125810,-209,-0.001661235,0.024799301,0.026460536,2015,ALL
2016-02-19T00:00:00Z,3461,3150,129005,-311,-0.002410759,0.024417658,0.026828418,2016,ALL
2017-02-17T00:00:00Z,3763,3334,139407,-429,-0.00307732,0.023915585,0.026992906,2017,ALL
2018-02-26T00:00:00Z,3565,3246,134742,-319,-0.002367487,0.024090484,0.026457972,2018,ALL
2019-02-15T00:00:00Z,3655,3403,137409,-252,-0.001833941,0.024765481,0.026599422,2019,ALL
2016-02-11T00:00:00Z,910,1130,57192,220,0.003846692,0.019758008,0.015911316,2016,GOOGL
2017-02-03T00:00:00Z,821,1004,48691,183,0.003758395,0.020619827,0.016861432,2017,GOOGL
2018-02-06T00:00:00Z,843,1035,49168,192,0.003904979,0.021050277,0.017145298,2018,GOOGL
2019-02-05T00:00:00Z,897,1061,49066,164,0.003342437,0.021623935,0.018281498,2019,GOOGL
2016-02-11T00:00:00Z,910,1130,57192,220,0.003846692,0.019758008,0.015911316,2016,GOOG
2017-02-03T00:00:00Z,821,1004,48691,183,0.003758395,0.020619827,0.016861432,2017,GOOG
2018-02-06T00:00:00Z,843,1035,49168,192,0.003904979,0.021050277,0.017145298,2018,GOOG
2019-02-05T00:00:00Z,897,1061,49066,164,0.003342437,0.021623935,0.018281498,2019,GOOG
2014-02-26T00:00:00Z,1363,1574,77940,211,0.002707211,0.020195022,0.017487811,2014,MO
2015-02-25T00:00:00Z,1400,1522,74993,122,0.001626819,0.020295228,0.018668409,2015,MO
2016-02-25T00:00:00Z,1567,1698,80888,131,0.001619523,0.020991989,0.019372466,2016,MO
2017-02-27T00:00:00Z,1631,1745,84008,114,0.001357014,0.020771831,0.019414818,2017,MO
2018-02-27T00:00:00Z,1461,1674,78050,213,0.00272902,0.02144779,0.01871877,2018,MO
2019-02-26T00:00:00Z,1039,1435,69925,396,0.005663211,0.020521988,0.014858777,2019,MO
2011-01-28T00:00:00Z,668,786,33187,118,0.003555609,0.023683973,0.020128364,2011,AMZN
2012-02-01T00:00:00Z,734,825,36294,91,0.002507301,0.02273103,0.020223728,2012,AMZN
2013-01-30T00:00:00Z,827,851,37766,24,0.000635492,0.022533496,0.021898003,2013,AMZN
2014-01-31T00:00:00Z,815,837,37278,22,0.00059016,0.022452921,0.021862761,2014,AMZN
2015-01-30T00:00:00Z,833,901,40031,68,0.001698684,0.022507557,0.020808873,2015,AMZN
2016-01-29T00:00:00Z,745,886,39359,141,0.003582408,0.022510735,0.018928326,2016,AMZN
2017-02-10T00:00:00Z,746,878,39441,132,0.003346771,0.022261099,0.018914328,2017,AMZN
2018-02-02T00:00:00Z,709,940,41657,231,0.005545287,0.022565235,0.017019949,2018,AMZN
2019-02-01T00:00:00Z,704,873,38890,169,0.00434559,0.02244793,0.01810234,2019,AMZN
2010-02-26T00:00:00Z,1746,2513,132977,767,0.005767915,0.018898005,0.01313009,2010,AEE
2011-02-24T00:00:00Z,1756,2347,126956,591,0.004655156,0.01848672,0.013831564,2011,AEE
2012-02-28T00:00:00Z,1760,2311,126095,551,0.004369721,0.018327452,0.01395773,2012,AEE
2013-03-01T00:00:00Z,1706,2434,125743,728,0.005789587,0.019356942,0.013567356,2013,AEE
2014-03-03T00:00:00Z,1622,2224,108290,602,0.005559147,0.020537446,0.014978299,2014,AEE
2015-03-02T00:00:00Z,1495,2024,100979,529,0.005238713,0.020043771,0.014805058,2015,AEE
2016-02-26T00:00:00Z,1409,1989,97077,580,0.005974639,0.02048889,0.014514252,2016,AEE
2017-02-28T00:00:00Z,1214,1875,93998,661,0.007032065,0.019947233,0.012915168,2017,AEE
2018-02-28T00:00:00Z,1284,1864,97550,580,0.005945669,0.01910815,0.013162481,2018,AEE
2019-02-26T00:00:00Z,1295,1907,98537,612,0.006210865,0.019353136,0.013142271,2019,AEE
2011-02-16T00:00:00Z,860,1186,58249,326,0.005596663,0.020360865,0.014764202,2011,AAL
2012-02-15T00:00:00Z,1160,2109,91781,949,0.010339831,0.022978612,0.012638781,2012,AAL
2013-02-20T00:00:00Z,1183,1549,77475,366,0.004724105,0.019993546,0.015269442,2013,AAL
2014-02-28T00:00:00Z,2019,3029,136851,1010,0.00738029,0.022133561,0.014753272,2014,AAL
2015-02-25T00:00:00Z,2112,3042,144256,930,0.006446872,0.021087511,0.014640639,2015,AAL
2016-02-24T00:00:00Z,1947,2879,137011,932,0.006802374,0.021012911,0.014210538,2016,AAL
2017-02-22T00:00:00Z,1377,2425,103195,1048,0.010155531,0.023499201,0.01334367,2017,AAL
2018-02-21T00:00:00Z,1311,2472,106723,1161,0.01087863,0.023162767,0.012284137,2018,AAL
2019-02-25T00:00:00Z,1293,2440,107509,1147,0.010668874,0.022695774,0.0120269,2019,AAL
2010-02-26T00:00:00Z,475,633,40953,158,0.003858081,0.015456743,0.011598662,2010,AEP
2011-02-25T00:00:00Z,492,685,43124,193,0.004475466,0.015884426,0.01140896,2011,AEP
2012-02-28T00:00:00Z,513,595,38353,82,0.002138034,0.01551378,0.013375746,2012,AEP
2013-02-26T00:00:00Z,510,630,39506,120,0.003037513,0.015946945,0.012909431,2013,AEP
2014-02-25T00:00:00Z,537,697,42095,160,0.003800926,0.016557786,0.012756859,2014,AEP
2015-02-20T00:00:00Z,483,619,37996,136,0.003579324,0.016291189,0.012711864,2015,AEP
2016-02-24T00:00:00Z,473,659,37704,186,0.004933164,0.017478252,0.012545088,2016,AEP
2017-02-28T00:00:00Z,488,678,38670,190,0.00491337,0.017532971,0.012619602,2017,AEP
2018-02-23T00:00:00Z,515,656,40775,141,0.003458001,0.016088289,0.012630288,2018,AEP
2019-02-21T00:00:00Z,480,653,39463,173,0.004383853,0.016547145,0.012163292,2019,AEP
2011-02-28T00:00:00Z,1201,1427,69368,226,0.003257986,0.020571445,0.017313459,2011,AXP
2012-02-24T00:00:00Z,1354,1500,72339,146,0.002018275,0.020735703,0.018717428,2012,AXP
2013-02-22T00:00:00Z,1304,1485,68920,181,0.002626233,0.021546721,0.018920488,2013,AXP
2014-02-25T00:00:00Z,1234,1411,67692,177,0.002614785,0.020844413,0.018229628,2014,AXP
2015-02-24T00:00:00Z,1266,1386,65861,120,0.001822019,0.021044321,0.019222302,2015,AXP
2016-02-19T00:00:00Z,2221,2323,107682,102,0.000947234,0.021572779,0.020625546,2016,AXP
2017-02-17T00:00:00Z,511,525,33149,14,0.000422336,0.015837582,0.015415246,2017,AXP
2018-02-16T00:00:00Z,1985,1975,92231,-10,-0.000108423,0.021413624,0.021522048,2018,AXP
2019-02-13T00:00:00Z,1222,1347,63904,125,0.001956059,0.021078493,0.019122434,2019,AXP
2013-02-21T00:00:00Z,4847,4353,179158,-494,-0.002757343,0.024296989,0.027054332,2013,AIG
2014-02-20T00:00:00Z,5223,4422,183278,-801,-0.00437041,0.024127282,0.028497692,2014,AIG
2015-02-20T00:00:00Z,5156,4136,173083,-1020,-0.005893126,0.02389605,0.029789176,2015,AIG
2016-02-19T00:00:00Z,5278,3926,171760,-1352,-0.007871449,0.022857476,0.030728924,2016,AIG
2017-02-23T00:00:00Z,5272,3751,168493,-1521,-0.009027081,0.022262052,0.031289134,2017,AIG
2018-02-16T00:00:00Z,5453,3889,174489,-1564,-0.008963316,0.022287938,0.031251254,2018,AIG
2019-02-15T00:00:00Z,5708,4111,181088,-1597,-0.008818917,0.02270167,0.031520587,2019,AIG
2010-03-01T00:00:00Z,792,1104,61626,312,0.005062798,0.017914517,0.012851718,2010,AMT
2011-02-28T00:00:00Z,781,1042,62026,261,0.004207913,0.016799407,0.012591494,2011,AMT
2012-02-29T00:00:00Z,891,1402,76448,511,0.006684282,0.018339263,0.011654981,2012,AMT
2013-02-27T00:00:00Z,928,1412,78549,484,0.006161759,0.01797604,0.011814282,2013,AMT
2014-02-26T00:00:00Z,945,1329,79661,384,0.004820427,0.016683195,0.011862768,2014,AMT
2015-02-24T00:00:00Z,945,1335,80023,390,0.004873599,0.016682704,0.011809105,2015,AMT
2016-02-26T00:00:00Z,827,1170,70340,343,0.004876315,0.016633494,0.011757179,2016,AMT
2017-02-27T00:00:00Z,845,1205,70004,360,0.005142563,0.017213302,0.012070739,2017,AMT
2018-02-28T00:00:00Z,854,1230,72584,376,0.005180205,0.016945883,0.011765678,2018,AMT
2019-02-27T00:00:00Z,902,1313,75307,411,0.00545766,0.017435298,0.011977638,2019,AMT
2011-02-28T00:00:00Z,1244,1847,76848,603,0.007846658,0.024034458,0.016187799,2011,AWK
2012-02-28T00:00:00Z,1248,1874,77673,626,0.008059429,0.024126788,0.016067359,2012,AWK
2013-03-01T00:00:00Z,1181,1788,74348,607,0.008164308,0.024049067,0.015884758,2013,AWK
2014-02-27T00:00:00Z,1270,1903,79307,633,0.007981641,0.02399536,0.016013719,2014,AWK
2015-02-25T00:00:00Z,1286,1930,77178,644,0.008344347,0.025007126,0.01666278,2015,AWK
2016-02-25T00:00:00Z,1254,1797,70675,543,0.007683056,0.025426247,0.017743191,2016,AWK
2017-02-21T00:00:00Z,1249,1933,73981,684,0.009245617,0.02612833,0.016882713,2017,AWK
2018-02-20T00:00:00Z,1460,2221,85840,761,0.008865331,0.025873719,0.017008388,2018,AWK
2019-02-19T00:00:00Z,1456,2345,89030,889,0.009985398,0.026339436,0.016354038,2019,AWK
2010-02-24T00:00:00Z,1866,2470,102982,604,0.005865103,0.023984774,0.018119671,2010,AMP
2011-02-28T00:00:00Z,2033,2724,113415,691,0.006092669,0.024017987,0.017925319,2011,AMP
2012-02-24T00:00:00Z,2156,2771,116390,615,0.005283959,0.023807887,0.018523928,2012,AMP
2013-02-27T00:00:00Z,2171,2839,116820,668,0.005718199,0.024302345,0.018584147,2013,AMP
2014-02-27T00:00:00Z,2296,2900,119232,604,0.005065754,0.02432233,0.019256575,2014,AMP
2015-02-24T00:00:00Z,2361,2893,120842,532,0.004402443,0.023940352,0.019537909,2015,AMP
2016-02-25T00:00:00Z,2181,2663,112687,482,0.004277335,0.02363183,0.019354495,2016,AMP
2017-02-23T00:00:00Z,2279,2795,117403,516,0.004395118,0.023806887,0.01941177,2017,AMP
2018-02-23T00:00:00Z,2274,2885,120197,611,0.005083322,0.024002263,0.018918941,2018,AMP
2019-02-27T00:00:00Z,2240,2791,125304,551,0.004397306,0.02227383,0.017876524,2019,AMP
2009-11-25T00:00:00Z,781,1035,54841,254,0.004631571,0.018872741,0.01424117,2009,ABC
2010-11-23T00:00:00Z,713,960,49406,247,0.004999393,0.019430838,0.014431446,2010,ABC
2011-11-22T00:00:00Z,625,936,46219,311,0.006728834,0.020251412,0.013522577,2011,ABC
2012-11-27T00:00:00Z,665,907,46196,242,0.005238549,0.019633735,0.014395186,2012,ABC
2013-11-26T00:00:00Z,785,1001,49236,216,0.004387034,0.020330652,0.015943618,2013,ABC
2014-11-25T00:00:00Z,821,988,50076,167,0.003334931,0.01973001,0.016395079,2014,ABC
2015-11-24T00:00:00Z,865,1020,53892,155,0.002876123,0.018926742,0.01605062,2015,ABC
2016-11-22T00:00:00Z,862,1069,56106,207,0.003689445,0.019053221,0.015363776,2016,ABC
2017-11-21T00:00:00Z,861,1080,54784,219,0.003997518,0.019713785,0.015716268,2017,ABC
2018-11-20T00:00:00Z,910,1178,58912,268,0.004549158,0.019995926,0.015446768,2018,ABC
2010-02-25T00:00:00Z,543,1101,44869,558,0.012436203,0.0245381,0.012101897,2010,AME
2011-02-24T00:00:00Z,504,948,40417,444,0.010985476,0.023455477,0.01247,2011,AME
2012-02-23T00:00:00Z,473,956,39435,483,0.012248003,0.024242424,0.011994421,2012,AME
2013-02-21T00:00:00Z,500,957,39313,457,0.011624653,0.024343093,0.012718439,2013,AME
2014-02-26T00:00:00Z,493,938,38642,445,0.011515967,0.024274106,0.012758139,2014,AME
2015-02-24T00:00:00Z,524,946,40741,422,0.010358116,0.023219852,0.012861736,2015,AME
2016-02-25T00:00:00Z,568,1010,43867,442,0.010075911,0.023024141,0.01294823,2016,AME
2017-02-23T00:00:00Z,618,1100,46993,482,0.010256847,0.023407742,0.013150895,2017,AME
2018-02-22T00:00:00Z,590,1135,47745,545,0.011414808,0.023772123,0.012357315,2018,AME
2019-02-21T00:00:00Z,627,1202,51763,575,0.011108321,0.02322122,0.012112899,2019,AME
2011-02-25T00:00:00Z,1480,1580,86922,100,0.001150457,0.018177216,0.01702676,2011,AMGN
2012-02-29T00:00:00Z,1520,1713,90884,193,0.002123586,0.018848202,0.016724616,2012,AMGN
2013-02-27T00:00:00Z,1489,1785,90139,296,0.003283817,0.019802749,0.016518932,2013,AMGN
2014-02-24T00:00:00Z,1129,1372,70819,243,0.003431283,0.019373332,0.015942049,2014,AMGN
2015-02-19T00:00:00Z,1181,1467,72824,286,0.003927277,0.020144458,0.016217181,2015,AMGN
2016-02-16T00:00:00Z,1121,1393,70841,272,0.003839584,0.019663754,0.01582417,2016,AMGN
2017-02-14T00:00:00Z,1175,1398,68911,223,0.003236058,0.020287037,0.017050979,2017,AMGN
2018-02-13T00:00:00Z,1287,1488,74728,201,0.002689755,0.019912215,0.01722246,2018,AMGN
2019-02-13T00:00:00Z,1351,1507,76712,156,0.00203358,0.019644906,0.017611325,2019,AMGN
2011-02-28T00:00:00Z,318,735,31780,417,0.01312146,0.023127753,0.010006293,2011,APH
2012-02-24T00:00:00Z,337,753,33005,416,0.012604151,0.022814725,0.010210574,2012,APH
2013-02-22T00:00:00Z,352,761,33895,409,0.012066677,0.022451689,0.010385013,2013,APH
2014-02-21T00:00:00Z,378,791,35351,413,0.011682838,0.022375605,0.010692767,2014,APH
2015-02-20T00:00:00Z,374,757,33396,383,0.011468439,0.022667385,0.011198946,2015,APH
2016-02-19T00:00:00Z,401,807,35331,406,0.011491325,0.022841131,0.011349806,2016,APH
2017-02-17T00:00:00Z,449,907,39751,458,0.011521723,0.022817036,0.011295313,2017,APH
2018-02-21T00:00:00Z,476,954,43522,478,0.010982951,0.021919949,0.010936997,2018,APH
2019-02-13T00:00:00Z,543,1044,49260,501,0.010170524,0.021193666,0.011023143,2019,APH
2010-02-23T00:00:00Z,1072,1333,66317,261,0.003935642,0.020100427,0.016164784,2010,APC
2011-02-23T00:00:00Z,1692,1700,87272,8,9.17E-05,0.019479329,0.019387662,2011,APC
2012-02-21T00:00:00Z,1455,1632,80967,177,0.002186076,0.02015636,0.017970284,2012,APC
2013-02-19T00:00:00Z,1460,1590,77901,130,0.001668785,0.020410521,0.018741736,2013,APC
2014-02-28T00:00:00Z,1495,1607,80715,112,0.001387598,0.019909558,0.01852196,2014,APC
2015-02-20T00:00:00Z,1295,1449,75193,154,0.002048063,0.019270411,0.017222348,2015,APC
2016-02-17T00:00:00Z,1285,1479,75005,194,0.002586494,0.019718685,0.017132191,2016,APC
2017-02-17T00:00:00Z,1235,1482,74576,247,0.003312057,0.019872345,0.016560287,2017,APC
2018-02-15T00:00:00Z,1238,1557,76865,319,0.004150133,0.020256294,0.01610616,2018,APC
2019-02-14T00:00:00Z,1297,1490,75517,193,0.002555716,0.019730657,0.017174941,2019,APC
2009-11-24T00:00:00Z,777,1084,50425,307,0.00608825,0.021497273,0.015409023,2009,ADI
2010-11-22T00:00:00Z,749,1048,49845,299,0.005998596,0.021025178,0.015026582,2010,ADI
2011-11-22T00:00:00Z,771,1176,51715,405,0.007831384,0.022740017,0.014908634,2011,ADI
2012-11-27T00:00:00Z,712,1121,49713,409,0.008227224,0.022549434,0.014322209,2012,ADI
2013-11-26T00:00:00Z,723,1147,49771,424,0.008519017,0.023045549,0.014526532,2013,ADI
2014-12-10T00:00:00Z,825,1289,55013,464,0.00843437,0.023430825,0.014996455,2014,ADI
2015-11-24T00:00:00Z,797,1212,52090,415,0.00796698,0.023267422,0.015300442,2015,ADI
2016-11-22T00:00:00Z,861,1330,57586,469,0.008144341,0.023095891,0.014951551,2016,ADI
2017-11-22T00:00:00Z,889,1375,57946,486,0.008387119,0.023728989,0.01534187,2017,ADI
2018-11-27T00:00:00Z,853,1389,59336,536,0.009033302,0.02340906,0.014375758,2018,ADI
2011-02-25T00:00:00Z,491,884,42469,393,0.009253809,0.020815183,0.011561374,2011,ANSS
2012-02-23T00:00:00Z,528,958,44813,430,0.00959543,0.021377725,0.011782295,2012,ANSS
2013-02-28T00:00:00Z,575,1034,47016,459,0.009762634,0.021992513,0.012229879,2013,ANSS
2014-02-27T00:00:00Z,499,934,42246,435,0.010296833,0.022108602,0.011811769,2014,ANSS
2015-02-26T00:00:00Z,528,963,43304,435,0.010045261,0.02223813,0.012192869,2015,ANSS
2016-02-25T00:00:00Z,531,953,42663,422,0.009891475,0.022337857,0.012446382,2016,ANSS
2017-02-23T00:00:00Z,541,1020,44084,479,0.01086562,0.023137646,0.012272026,2017,ANSS
2018-02-22T00:00:00Z,570,1064,46077,494,0.010721184,0.023091781,0.012370597,2018,ANSS
2019-02-28T00:00:00Z,587,1160,50455,573,0.011356654,0.022990784,0.011634129,2019,ANSS
2010-02-18T00:00:00Z,1366,2381,88166,1015,0.011512374,0.027005875,0.015493501,2010,ANTM
2011-02-17T00:00:00Z,1448,2460,91382,1012,0.011074391,0.026919962,0.015845571,2011,ANTM
2012-02-22T00:00:00Z,1279,2261,79203,982,0.01239852,0.028546898,0.016148378,2012,ANTM
2013-02-22T00:00:00Z,1326,2381,83835,1055,0.012584243,0.028401026,0.015816783,2013,ANTM
2014-02-20T00:00:00Z,1382,2447,85861,1065,0.012403769,0.028499552,0.016095783,2014,ANTM
2015-02-24T00:00:00Z,1461,2504,88093,1043,0.01183976,0.028424506,0.016584746,2015,ANTM
2016-02-19T00:00:00Z,1526,2561,92063,1035,0.011242301,0.027817907,0.016575606,2016,ANTM
2017-02-22T00:00:00Z,1548,2651,94803,1103,0.011634653,0.02796325,0.016328597,2017,ANTM
2018-02-21T00:00:00Z,1480,2575,93141,1095,0.011756369,0.027646257,0.015889887,2018,ANTM
2019-02-20T00:00:00Z,1473,2500,89483,1027,0.01147704,0.027938268,0.016461227,2019,ANTM
2010-02-26T00:00:00Z,1005,1470,57829,465,0.008040948,0.025419772,0.017378824,2010,AON
2011-02-25T00:00:00Z,1186,1659,65873,473,0.007180484,0.025184825,0.018004342,2011,AON
2012-02-24T00:00:00Z,1227,1771,71411,544,0.007617874,0.024800101,0.017182227,2012,AON
2013-02-22T00:00:00Z,1215,1716,69585,501,0.007199828,0.024660487,0.01746066,2013,AON
2014-02-18T00:00:00Z,1227,1683,67565,456,0.006749056,0.024909347,0.01816029,2014,AON
2015-02-24T00:00:00Z,1152,1549,62663,397,0.006335477,0.024719531,0.018384054,2015,AON
2016-02-22T00:00:00Z,1069,1445,60180,376,0.006247923,0.024011299,0.017763377,2016,AON
2017-02-23T00:00:00Z,1146,1534,63534,388,0.006106966,0.024144553,0.018037586,2017,AON
2018-02-20T00:00:00Z,1174,1701,66725,527,0.007898089,0.025492694,0.017594605,2018,AON
2019-02-19T00:00:00Z,1163,1760,67391,597,0.00885875,0.026116247,0.017257497,2019,AON
2010-02-26T00:00:00Z,465,685,30566,220,0.00719754,0.022410521,0.015212982,2010,AOS
2011-02-24T00:00:00Z,544,694,32407,150,0.00462863,0.021415126,0.016786497,2011,AOS
2012-02-27T00:00:00Z,524,716,34933,192,0.005496236,0.020496379,0.015000143,2012,AOS
2013-02-27T00:00:00Z,549,701,33456,152,0.004543281,0.020952893,0.016409613,2013,AOS
2014-02-20T00:00:00Z,173,170,9206,-3,-0.000325874,0.018466218,0.018792092,2014,AOS
2015-02-17T00:00:00Z,156,158,8901,2,0.000224694,0.017750815,0.017526121,2015,AOS
2016-02-17T00:00:00Z,138,137,8129,-1,-0.000123016,0.016853241,0.016976258,2016,AOS
2017-02-17T00:00:00Z,139,147,8556,8,0.000935016,0.017180926,0.016245909,2017,AOS
2018-02-16T00:00:00Z,136,158,8846,22,0.002487,0.01786118,0.01537418,2018,AOS
2019-02-15T00:00:00Z,458,699,31176,241,0.007730305,0.022421093,0.014690788,2019,AOS
2012-02-29T00:00:00Z,1203,1202,75315,-1,-1.33E-05,0.015959636,0.015972914,2012,APA
2013-03-01T00:00:00Z,1220,1226,80512,6,7.45E-05,0.015227544,0.015153021,2013,APA
2014-02-28T00:00:00Z,657,661,46097,4,8.68E-05,0.014339328,0.014252554,2014,APA
2015-02-27T00:00:00Z,697,665,46307,-32,-0.00069104,0.01436068,0.01505172,2015,APA
2016-02-26T00:00:00Z,419,297,28735,-122,-0.004245693,0.010335827,0.014581521,2016,APA
2017-02-24T00:00:00Z,1227,1141,66304,-86,-0.001297056,0.017208615,0.018505671,2017,APA
2018-02-23T00:00:00Z,1086,1064,61538,-22,-0.000357503,0.01729013,0.017647632,2018,APA
2019-03-01T00:00:00Z,1113,1093,64256,-20,-0.000311255,0.017010085,0.01732134,2019,APA
2010-02-26T00:00:00Z,1065,1245,68492,180,0.002628044,0.018177305,0.015549261,2010,AIV
2011-02-25T00:00:00Z,1048,1284,68638,236,0.003438329,0.018706839,0.01526851,2011,AIV
2012-02-23T00:00:00Z,1027,1200,61628,173,0.002807166,0.019471669,0.016664503,2012,AIV
2013-02-25T00:00:00Z,989,1220,57753,231,0.003999792,0.021124444,0.017124652,2013,AIV
2014-02-21T00:00:00Z,917,1140,54289,223,0.004107646,0.020998729,0.016891083,2014,AIV
2015-02-27T00:00:00Z,893,1171,56997,278,0.00487745,0.020544941,0.015667491,2015,AIV
2016-02-29T00:00:00Z,865,1180,56573,315,0.005568027,0.020858006,0.015289979,2016,AIV
2017-02-24T00:00:00Z,822,1191,54710,369,0.006744654,0.021769329,0.015024676,2017,AIV
2018-03-01T00:00:00Z,848,1212,56862,364,0.006401463,0.021314762,0.014913299,2018,AIV
2019-02-20T00:00:00Z,822,1203,55803,381,0.00682759,0.021557981,0.014730391,2019,AIV
2010-10-27T00:00:00Z,710,1099,47986,389,0.008106531,0.022902513,0.014795982,2010,AAPL
2011-10-26T00:00:00Z,665,969,42965,304,0.007075527,0.022553241,0.015477714,2011,AAPL
2012-10-31T00:00:00Z,656,955,43287,299,0.006907386,0.022062051,0.015154665,2012,AAPL
2013-10-30T00:00:00Z,709,955,44958,246,0.005471774,0.021242048,0.015770274,2013,AAPL
2014-10-27T00:00:00Z,98,130,8327,32,0.003842921,0.015611865,0.011768944,2014,AAPL
2015-10-28T00:00:00Z,116,131,8744,15,0.001715462,0.014981702,0.01326624,2015,AAPL
2016-10-26T00:00:00Z,737,959,43544,222,0.005098291,0.0220237,0.016925409,2016,AAPL
2017-11-03T00:00:00Z,762,967,44546,205,0.004601984,0.021707897,0.017105913,2017,AAPL
2018-11-05T00:00:00Z,727,911,41917,184,0.004389627,0.021733426,0.017343798,2018,AAPL
2010-12-10T00:00:00Z,825,1379,55769,554,0.009933834,0.024726999,0.014793165,2010,AMAT
2011-12-06T00:00:00Z,859,1486,60739,627,0.010322857,0.024465335,0.014142478,2011,AMAT
2012-12-05T00:00:00Z,784,1478,58978,694,0.0117671,0.025060192,0.013293092,2012,AMAT
2013-12-04T00:00:00Z,761,1392,54609,631,0.011554872,0.025490304,0.013935432,2013,AMAT
2014-12-17T00:00:00Z,734,1339,52854,605,0.011446627,0.025333939,0.013887312,2014,AMAT
2015-12-09T00:00:00Z,702,1246,48734,544,0.011162638,0.025567366,0.014404728,2015,AMAT
2016-12-15T00:00:00Z,752,1165,46747,413,0.008834792,0.024921385,0.016086594,2016,AMAT
2017-12-15T00:00:00Z,740,1188,45076,448,0.00993877,0.026355489,0.016416718,2017,AMAT
2018-12-13T00:00:00Z,708,1186,44640,478,0.010707885,0.0265681,0.015860215,2018,AMAT
2012-02-17T00:00:00Z,1229,2010,81371,781,0.009598014,0.024701675,0.015103661,2012,APTV
2013-02-11T00:00:00Z,947,1839,69135,892,0.012902293,0.02660013,0.013697838,2013,APTV
2014-02-10T00:00:00Z,915,1712,68003,797,0.011720071,0.02517536,0.013455289,2014,APTV
2015-02-09T00:00:00Z,958,1697,70277,739,0.010515531,0.024147303,0.013631771,2015,APTV
2016-02-08T00:00:00Z,1197,1891,81844,694,0.008479546,0.023104931,0.014625385,2016,APTV
2017-02-06T00:00:00Z,1209,2075,87576,866,0.009888554,0.023693706,0.013805152,2017,APTV
2018-02-05T00:00:00Z,1225,2234,90155,1009,0.011191836,0.024779546,0.01358771,2018,APTV
2019-02-04T00:00:00Z,1179,2130,85008,951,0.011187182,0.025056465,0.013869283,2019,APTV
2011-08-25T00:00:00Z,583,890,41509,307,0.007395986,0.021441133,0.014045147,2011,ADM
2012-08-27T00:00:00Z,634,953,45290,319,0.007043497,0.021042173,0.013998675,2012,ADM
2014-02-26T00:00:00Z,758,1089,52633,331,0.00628883,0.020690441,0.014401611,2014,ADM
2015-02-20T00:00:00Z,806,1109,52558,303,0.00576506,0.021100498,0.015335439,2015,ADM
2016-02-19T00:00:00Z,877,1124,51206,247,0.004823653,0.021950553,0.017126899,2016,ADM
2017-02-17T00:00:00Z,877,1200,52092,323,0.006200568,0.023036167,0.016835599,2017,ADM
2018-02-16T00:00:00Z,888,1226,53214,338,0.006351712,0.02303905,0.016687338,2018,ADM
2019-02-19T00:00:00Z,902,1228,53812,326,0.006058128,0.022820189,0.016762061,2019,ADM
2012-02-16T00:00:00Z,1509,2269,96580,760,0.007869124,0.023493477,0.015624353,2012,ARNC
2013-02-15T00:00:00Z,1542,2229,100340,687,0.006846721,0.022214471,0.01536775,2013,ARNC
2014-02-13T00:00:00Z,1652,2279,102735,627,0.006103081,0.022183287,0.016080206,2014,ARNC
2015-02-19T00:00:00Z,1601,2182,104841,581,0.005541725,0.020812468,0.015270743,2015,ARNC
2016-02-19T00:00:00Z,1599,2262,111080,663,0.005968671,0.020363702,0.014395031,2016,ARNC
2017-02-28T00:00:00Z,1254,1799,77139,545,0.007065168,0.023321536,0.016256368,2017,ARNC
2018-02-26T00:00:00Z,1268,1926,77413,658,0.008499864,0.024879542,0.016379678,2018,ARNC
2019-02-21T00:00:00Z,1248,1836,75554,588,0.007782513,0.0243005,0.016517987,2019,ARNC
2015-03-12T00:00:00Z,1420,1257,62593,-163,-0.002604125,0.020082118,0.022686243,2015,ANET
2016-02-25T00:00:00Z,1558,1337,64085,-221,-0.003448545,0.020862916,0.024311461,2016,ANET
2017-02-17T00:00:00Z,1612,1384,67080,-228,-0.003398927,0.020632081,0.024031008,2017,ANET
2018-02-20T00:00:00Z,1810,1520,73442,-290,-0.003948694,0.020696604,0.024645298,2018,ANET
2019-02-15T00:00:00Z,1580,1431,68973,-149,-0.002160266,0.020747249,0.022907515,2019,ANET
2010-02-05T00:00:00Z,972,1098,55442,126,0.002272645,0.01980448,0.017531835,2010,AJG
2011-02-07T00:00:00Z,944,1208,55973,264,0.00471656,0.021581834,0.016865274,2011,AJG
2012-02-14T00:00:00Z,975,1200,57301,225,0.003926633,0.020942043,0.01701541,2012,AJG
2013-02-08T00:00:00Z,1006,1283,59544,277,0.004652022,0.021547091,0.016895069,2013,AJG
2014-02-07T00:00:00Z,1071,1290,60857,219,0.0035986,0.021197233,0.017598633,2014,AJG
2015-02-13T00:00:00Z,1264,1428,69065,164,0.002374575,0.020676175,0.0183016,2015,AJG
2016-02-10T00:00:00Z,1271,1455,68730,184,0.002677142,0.021169795,0.018492652,2016,AJG
2017-02-13T00:00:00Z,1288,1499,70613,211,0.002988118,0.021228386,0.018240267,2017,AJG
2018-02-12T00:00:00Z,1385,1644,74980,259,0.003454254,0.021925847,0.018471592,2018,AJG
2019-02-08T00:00:00Z,1426,1792,77804,366,0.004704128,0.023032235,0.018328107,2019,AJG
2011-02-23T00:00:00Z,1807,2516,91040,709,0.007787786,0.027636204,0.019848418,2011,AIZ
2012-02-23T00:00:00Z,1852,2575,93566,723,0.007727166,0.027520681,0.019793515,2012,AIZ
2013-02-20T00:00:00Z,1799,2400,89408,601,0.006721994,0.026843236,0.020121242,2013,AIZ
2014-02-19T00:00:00Z,1815,2357,90418,542,0.005994382,0.026067818,0.020073437,2014,AIZ
2015-02-19T00:00:00Z,1888,2383,91119,495,0.005432456,0.026152614,0.020720157,2015,AIZ
2016-02-16T00:00:00Z,1858,2329,88766,471,0.005306086,0.026237523,0.020931438,2016,AIZ
2017-02-14T00:00:00Z,1835,2416,87387,581,0.006648586,0.027647133,0.020998547,2017,AIZ
2018-02-14T00:00:00Z,1879,2464,95039,585,0.006155368,0.025926199,0.019770831,2018,AIZ
2019-02-22T00:00:00Z,2168,2580,104051,412,0.003959597,0.024795533,0.020835936,2019,AIZ
2009-11-16T00:00:00Z,949,1183,62493,234,0.003744419,0.01893012,0.015185701,2009,ATO
2010-11-12T00:00:00Z,980,1314,65152,334,0.005126473,0.020168222,0.015041749,2010,ATO
2011-11-22T00:00:00Z,1050,1289,66388,239,0.003600048,0.01941616,0.015816111,2011,ATO
2012-11-13T00:00:00Z,981,1180,61244,199,0.003249298,0.019267194,0.016017896,2012,ATO
2013-11-13T00:00:00Z,849,1078,54715,229,0.004185324,0.019702093,0.015516769,2013,ATO
2014-11-06T00:00:00Z,860,1112,54034,252,0.00466373,0.020579635,0.015915905,2014,ATO
2015-11-06T00:00:00Z,792,1048,50033,256,0.005116623,0.020946176,0.015829552,2015,ATO
2016-11-14T00:00:00Z,798,1064,50210,266,0.005297749,0.021190998,0.015893248,2016,ATO
2017-11-13T00:00:00Z,750,987,46935,237,0.005049537,0.021029083,0.015979546,2017,ATO
2018-11-13T00:00:00Z,738,1083,49686,345,0.006943606,0.021796884,0.014853279,2018,ATO
2010-02-25T00:00:00Z,78,199,11821,121,0.010236021,0.016834447,0.006598427,2010,T
2011-03-01T00:00:00Z,76,187,10903,111,0.010180684,0.017151243,0.006970559,2011,T
2012-02-24T00:00:00Z,72,200,11436,128,0.011192725,0.017488632,0.006295908,2012,T
2013-02-22T00:00:00Z,87,207,12636,120,0.009496676,0.016381766,0.00688509,2013,T
2014-02-21T00:00:00Z,87,201,12443,114,0.009161778,0.016153661,0.006991883,2014,T
2015-02-20T00:00:00Z,80,200,12444,120,0.009643202,0.016072003,0.006428801,2015,T
2016-02-18T00:00:00Z,85,242,13899,157,0.011295777,0.017411325,0.006115548,2016,T
2017-02-17T00:00:00Z,88,243,13878,155,0.011168756,0.017509728,0.006340971,2017,T
2018-02-20T00:00:00Z,88,246,13635,158,0.011587825,0.018041804,0.006453979,2018,T
2019-02-20T00:00:00Z,106,257,15559,151,0.009704994,0.016517771,0.006812777,2019,T
2010-03-19T00:00:00Z,778,1243,52521,465,0.008853601,0.023666724,0.014813122,2010,ADSK
2011-03-18T00:00:00Z,757,1204,51648,447,0.00865474,0.023311648,0.014656908,2011,ADSK
2012-03-15T00:00:00Z,754,1237,50640,483,0.009537915,0.02442733,0.014889415,2012,ADSK
2013-03-18T00:00:00Z,866,1309,54390,443,0.00814488,0.024066924,0.015922044,2013,ADSK
2014-03-10T00:00:00Z,875,1349,56240,474,0.008428165,0.023986486,0.015558321,2014,ADSK
2015-03-18T00:00:00Z,905,1438,58512,533,0.009109243,0.024576155,0.015466913,2015,ADSK
2016-03-23T00:00:00Z,1091,1608,64854,517,0.007971752,0.024794153,0.016822401,2016,ADSK
2017-03-21T00:00:00Z,1108,1532,63320,424,0.006696147,0.024194567,0.017498421,2017,ADSK
2018-03-22T00:00:00Z,1096,1498,63012,402,0.006379737,0.02377325,0.017393512,2018,ADSK
2019-03-25T00:00:00Z,1115,1455,63962,340,0.005315656,0.022747882,0.017432225,2019,ADSK
2009-08-28T00:00:00Z,464,840,41898,376,0.008974175,0.02004869,0.011074514,2009,ADP
2010-08-25T00:00:00Z,440,774,39649,334,0.00842392,0.019521299,0.01109738,2010,ADP
2011-08-24T00:00:00Z,508,860,42091,352,0.008362833,0.020431921,0.012069088,2011,ADP
2012-08-20T00:00:00Z,473,872,40368,399,0.009884067,0.021601268,0.011717202,2012,ADP
2013-08-19T00:00:00Z,473,970,40642,497,0.012228729,0.023866936,0.011638207,2013,ADP
2014-08-08T00:00:00Z,513,1009,42659,496,0.011627089,0.023652688,0.012025598,2014,ADP
2015-08-07T00:00:00Z,618,966,41301,348,0.008425946,0.023389264,0.014963318,2015,ADP
2016-08-05T00:00:00Z,638,1035,44259,397,0.008969927,0.023385074,0.014415147,2016,ADP
2017-08-04T00:00:00Z,630,1107,45224,477,0.010547497,0.024478153,0.013930656,2017,ADP
2018-08-03T00:00:00Z,683,1155,46910,472,0.010061821,0.024621616,0.014559795,2018,ADP
2010-10-25T00:00:00Z,672,690,36714,18,0.000490276,0.018793921,0.018303644,2010,AZO
2011-10-24T00:00:00Z,691,750,38266,59,0.001541839,0.019599645,0.018057806,2011,AZO
2012-10-22T00:00:00Z,647,692,36680,45,0.001226827,0.018865867,0.01763904,2012,AZO
2013-10-28T00:00:00Z,106,127,9625,21,0.002181818,0.013194805,0.011012987,2013,AZO
2014-10-27T00:00:00Z,126,141,10117,15,0.001482653,0.013936938,0.012454285,2014,AZO
2015-10-26T00:00:00Z,134,135,10503,1,9.52E-05,0.01285347,0.01275826,2015,AZO
2016-10-24T00:00:00Z,131,142,10429,11,0.001054751,0.013615879,0.012561128,2016,AZO
2017-10-25T00:00:00Z,133,156,10347,23,0.002222867,0.015076834,0.012853967,2017,AZO
2018-10-24T00:00:00Z,127,145,10490,18,0.00171592,0.013822688,0.012106768,2018,AZO
2011-02-23T00:00:00Z,864,1220,63610,356,0.005596604,0.019179374,0.01358277,2011,AVB
2012-02-27T00:00:00Z,868,1209,64100,341,0.005319813,0.018861154,0.013541342,2012,AVB
2013-02-22T00:00:00Z,946,1226,67959,280,0.004120131,0.018040289,0.013920158,2013,AVB
2014-03-03T00:00:00Z,962,1282,72899,320,0.004389635,0.017585975,0.01319634,2014,AVB
2015-02-19T00:00:00Z,1024,1186,70041,162,0.002312931,0.016932939,0.014620008,2015,AVB
2016-02-26T00:00:00Z,1082,1325,72103,243,0.003370179,0.018376489,0.01500631,2016,AVB
2017-02-24T00:00:00Z,1171,1369,70115,198,0.002823932,0.019525066,0.016701134,2017,AVB
2018-02-23T00:00:00Z,1206,1340,69587,134,0.001925647,0.01925647,0.017330823,2018,AVB
2019-02-22T00:00:00Z,1208,1361,68887,153,0.002221029,0.019756993,0.017535965,2019,AVB
2010-03-01T00:00:00Z,265,247,14826,-18,-0.001214083,0.016659922,0.017874005,2010,AVY
2011-02-28T00:00:00Z,260,259,14941,-1,-6.69E-05,0.01733485,0.01740178,2011,AVY
2012-02-27T00:00:00Z,281,269,14549,-12,-0.000824799,0.018489243,0.019314042,2012,AVY
2013-02-27T00:00:00Z,296,293,14972,-3,-0.000200374,0.019569864,0.019770238,2013,AVY
2014-02-26T00:00:00Z,277,269,14268,-8,-0.000560695,0.018853378,0.019414073,2014,AVY
2015-02-25T00:00:00Z,380,301,15800,-79,-0.005,0.019050633,0.024050633,2015,AVY
2016-02-24T00:00:00Z,400,319,15800,-81,-0.005126582,0.020189873,0.025316456,2016,AVY
2017-02-23T00:00:00Z,422,336,16751,-86,-0.005134022,0.020058504,0.025192526,2017,AVY
2018-02-21T00:00:00Z,411,327,17249,-84,-0.004869848,0.018957621,0.023827468,2018,AVY
2019-02-27T00:00:00Z,422,361,17502,-61,-0.003485316,0.020626214,0.02411153,2019,AVY
2018-02-23T00:00:00Z,976,1363,61784,387,0.006263758,0.022060728,0.01579697,2018,BHGE
2019-02-19T00:00:00Z,1008,1393,63429,385,0.006069779,0.021961563,0.015891785,2019,BHGE
2010-02-25T00:00:00Z,678,1067,50419,389,0.007715345,0.021162657,0.013447312,2010,BLL
2011-02-28T00:00:00Z,695,1034,50312,339,0.006737955,0.020551757,0.013813802,2011,BLL
2012-02-22T00:00:00Z,695,1063,50230,368,0.007326299,0.021162652,0.013836353,2012,BLL
2013-02-22T00:00:00Z,684,1061,50385,377,0.007482386,0.021057855,0.013575469,2013,BLL
2014-02-24T00:00:00Z,685,1060,48880,375,0.007671849,0.021685761,0.014013912,2014,BLL
2015-02-20T00:00:00Z,740,1155,51777,415,0.008015142,0.022307202,0.01429206,2015,BLL
2016-02-16T00:00:00Z,870,1301,56386,431,0.007643741,0.023073103,0.015429362,2016,BLL
2017-03-02T00:00:00Z,906,1402,63288,496,0.007837189,0.022152699,0.01431551,2017,BLL
2018-03-01T00:00:00Z,812,1393,60687,581,0.009573714,0.022953845,0.013380131,2018,BLL
2019-02-22T00:00:00Z,774,1287,58885,513,0.008711896,0.02185616,0.013144264,2019,BLL
2010-02-26T00:00:00Z,4128,3865,186366,-263,-0.001411202,0.020738761,0.022149963,2010,BAC
2011-02-25T00:00:00Z,4832,4668,214985,-164,-0.000762844,0.021713143,0.022475987,2011,BAC
2012-02-23T00:00:00Z,5006,4533,218662,-473,-0.002163156,0.020730625,0.022893781,2012,BAC
2013-02-28T00:00:00Z,4914,4476,214261,-438,-0.002044236,0.020890409,0.022934645,2013,BAC
2014-02-25T00:00:00Z,4740,4372,207180,-368,-0.001776233,0.021102423,0.022878656,2014,BAC
2015-02-25T00:00:00Z,4287,3888,190180,-399,-0.002098012,0.02044379,0.022541803,2015,BAC
2016-02-24T00:00:00Z,4089,3595,174943,-494,-0.002823777,0.02054955,0.023373327,2016,BAC
2017-02-23T00:00:00Z,3602,3201,155298,-401,-0.002582132,0.020611985,0.023194117,2017,BAC
2018-02-22T00:00:00Z,3271,2942,143190,-329,-0.002297646,0.020546128,0.022843774,2018,BAC
2019-02-26T00:00:00Z,3129,2680,143354,-449,-0.003132107,0.018694979,0.021827085,2019,BAC
2011-02-28T00:00:00Z,526,452,30199,-74,-0.002450412,0.014967383,0.017417795,2011,BK
2012-02-28T00:00:00Z,725,601,35117,-124,-0.003531053,0.017114218,0.020645272,2012,BK
2013-02-28T00:00:00Z,137,156,13969,19,0.001360155,0.011167585,0.009807431,2013,BK
2014-02-28T00:00:00Z,128,153,13042,25,0.001916884,0.01173133,0.009814446,2014,BK
2015-02-27T00:00:00Z,111,110,11864,-1,-8.43E-05,0.009271746,0.009356035,2015,BK
2016-02-26T00:00:00Z,142,117,11856,-25,-0.002108637,0.009868421,0.011977058,2016,BK
2017-02-28T00:00:00Z,138,114,11355,-24,-0.002113606,0.01003963,0.012153236,2017,BK
2018-02-28T00:00:00Z,119,115,11458,-4,-0.000349101,0.010036656,0.010385757,2018,BK
2019-02-27T00:00:00Z,121,114,11027,-7,-0.000634805,0.010338261,0.010973066,2019,BK
2010-02-23T00:00:00Z,806,1255,54184,449,0.008286579,0.023161819,0.01487524,2010,BAX
2011-02-23T00:00:00Z,838,1195,53182,357,0.006712798,0.022470009,0.015757211,2011,BAX
2012-02-23T00:00:00Z,794,1220,53118,426,0.00801988,0.022967732,0.014947852,2012,BAX
2013-02-21T00:00:00Z,849,1248,56018,399,0.007122711,0.022278553,0.015155843,2013,BAX
2014-02-21T00:00:00Z,858,1275,56455,417,0.007386414,0.022584359,0.015197945,2014,BAX
2015-02-26T00:00:00Z,893,1289,55764,396,0.007101356,0.023115272,0.016013916,2015,BAX
2016-02-26T00:00:00Z,894,1296,55197,402,0.007283005,0.023479537,0.016196532,2016,BAX
2017-02-23T00:00:00Z,914,1313,53767,399,0.007420909,0.024420183,0.016999275,2017,BAX
2018-02-23T00:00:00Z,1001,1380,58235,379,0.006508114,0.023697089,0.017188976,2018,BAX
2019-02-21T00:00:00Z,996,1411,60571,415,0.006851464,0.023294976,0.016443513,2019,BAX
2010-02-26T00:00:00Z,1534,2029,89627,495,0.005522889,0.022638267,0.017115378,2010,BBT
2011-02-25T00:00:00Z,1737,2016,94049,279,0.002966539,0.021435635,0.018469096,2011,BBT
2012-02-27T00:00:00Z,1613,1943,86915,330,0.003796813,0.022355175,0.018558362,2012,BBT
2013-03-01T00:00:00Z,375,478,27079,103,0.003803686,0.017652055,0.01384837,2013,BBT
2014-02-26T00:00:00Z,430,434,28446,4,0.000140617,0.015256978,0.015116361,2014,BBT
2015-02-25T00:00:00Z,433,423,27532,-10,-0.000363214,0.01536394,0.015727154,2015,BBT
2016-02-25T00:00:00Z,431,428,27128,-3,-0.000110587,0.015777057,0.015887644,2016,BBT
2017-02-21T00:00:00Z,1548,1626,78195,78,0.000997506,0.020794168,0.019796662,2017,BBT
2018-02-21T00:00:00Z,1455,1516,71558,61,0.000852455,0.021185612,0.020333156,2018,BBT
2019-02-26T00:00:00Z,1494,1536,72216,42,0.000581589,0.021269525,0.020687936,2019,BBT
2010-11-24T00:00:00Z,691,841,38988,150,0.003847338,0.02157074,0.017723402,2010,BDX
2011-11-23T00:00:00Z,723,906,41226,183,0.004438946,0.021976423,0.017537476,2011,BDX
2012-11-21T00:00:00Z,780,977,43998,197,0.004477476,0.022205555,0.017728079,2012,BDX
2013-11-27T00:00:00Z,769,979,45338,210,0.004631876,0.021593365,0.016961489,2013,BDX
2014-11-26T00:00:00Z,784,1024,46892,240,0.005118144,0.021837414,0.01671927,2014,BDX
2015-11-25T00:00:00Z,755,1020,48084,265,0.005511189,0.021212877,0.015701689,2015,BDX
2016-11-23T00:00:00Z,691,956,45226,265,0.005859461,0.021138283,0.015278822,2016,BDX
2017-11-22T00:00:00Z,732,969,48242,237,0.004912732,0.020086232,0.0151735,2017,BDX
2018-11-21T00:00:00Z,773,1022,51342,249,0.004849831,0.01990573,0.0150559,2018,BDX
2010-04-28T00:00:00Z,843,1833,63217,990,0.015660345,0.028995365,0.013335021,2010,BBY
2011-04-25T00:00:00Z,862,1808,64895,946,0.014577394,0.02786039,0.013282996,2011,BBY
2012-05-01T00:00:00Z,983,1935,66309,952,0.014357025,0.029181559,0.014824534,2012,BBY
2014-03-28T00:00:00Z,917,1586,57398,669,0.011655458,0.027631625,0.015976166,2014,BBY
2015-03-31T00:00:00Z,839,1461,54191,622,0.011477921,0.026960196,0.015482276,2015,BBY
2016-03-23T00:00:00Z,803,1409,52263,606,0.011595201,0.026959799,0.015364598,2016,BBY
2017-03-24T00:00:00Z,767,1300,50692,533,0.01051448,0.025645072,0.015130593,2017,BBY
2018-04-02T00:00:00Z,789,1320,51940,531,0.010223335,0.025413939,0.015190605,2018,BBY
2019-03-28T00:00:00Z,741,1308,51523,567,0.011004794,0.02538672,0.014381927,2019,BBY
2010-02-09T00:00:00Z,1011,1513,74388,502,0.0067484,0.020339302,0.013590902,2010,BIIB
2011-02-04T00:00:00Z,1115,1675,81415,560,0.006878339,0.020573604,0.013695265,2011,BIIB
2012-02-03T00:00:00Z,1225,1848,87745,623,0.00710012,0.021061029,0.013960909,2012,BIIB
2013-02-05T00:00:00Z,1200,1846,85631,646,0.007543997,0.021557613,0.014013617,2013,BIIB
2014-02-06T00:00:00Z,1243,1880,90280,637,0.007055826,0.020824103,0.013768276,2014,BIIB
2015-02-04T00:00:00Z,1117,1633,78971,516,0.006534044,0.020678477,0.014144433,2015,BIIB
2016-02-03T00:00:00Z,1142,1751,82480,609,0.007383608,0.021229389,0.013845781,2016,BIIB
2017-02-02T00:00:00Z,1242,1817,87521,575,0.006569852,0.020760732,0.01419088,2017,BIIB
2018-02-01T00:00:00Z,1333,1974,95889,641,0.006684813,0.020586303,0.01390149,2018,BIIB
2019-02-06T00:00:00Z,1443,2047,105571,604,0.005721268,0.019389795,0.013668526,2019,BIIB
2010-03-10T00:00:00Z,1088,1851,91513,763,0.008337613,0.020226634,0.011889021,2010,BLK
2011-02-28T00:00:00Z,1187,1921,96927,734,0.007572709,0.019819039,0.01224633,2011,BLK
2012-02-28T00:00:00Z,1195,1809,87735,614,0.006998347,0.020618909,0.013620562,2012,BLK
2013-03-01T00:00:00Z,1109,1704,83497,595,0.007126005,0.020407919,0.013281914,2013,BLK
2014-02-28T00:00:00Z,1108,1652,76331,544,0.007126855,0.021642583,0.014515728,2014,BLK
2015-02-27T00:00:00Z,1062,1540,70933,478,0.006738753,0.021710628,0.014971875,2015,BLK
2016-02-26T00:00:00Z,1173,1685,75383,512,0.006791982,0.02235252,0.015560538,2016,BLK
2017-02-28T00:00:00Z,1215,1603,73870,388,0.005252471,0.021700284,0.016447814,2017,BLK
2018-02-28T00:00:00Z,1248,1614,74217,366,0.004931485,0.021747039,0.016815554,2018,BLK
2019-02-28T00:00:00Z,1244,1672,77820,428,0.005499871,0.021485479,0.015985608,2019,BLK
2009-06-29T00:00:00Z,1151,999,54981,-152,-0.002764591,0.018169913,0.020934505,2009,HRB
2010-06-29T00:00:00Z,1102,979,52085,-123,-0.002361524,0.018796199,0.021157723,2010,HRB
2011-06-23T00:00:00Z,1105,1031,55186,-74,-0.00134092,0.018682274,0.020023194,2011,HRB
2012-06-26T00:00:00Z,1220,1099,56933,-121,-0.002125305,0.019303392,0.021428697,2012,HRB
2013-06-26T00:00:00Z,1294,1189,60216,-105,-0.001743723,0.019745583,0.021489305,2013,HRB
2014-06-19T00:00:00Z,1173,1047,54766,-126,-0.002300698,0.019117701,0.021418398,2014,HRB
2015-06-17T00:00:00Z,1181,1078,55690,-103,-0.001849524,0.019357156,0.02120668,2015,HRB
2016-06-17T00:00:00Z,1055,911,48246,-144,-0.002984703,0.018882394,0.021867098,2016,HRB
2017-06-16T00:00:00Z,968,863,44053,-105,-0.002383493,0.019590039,0.021973532,2017,HRB
2018-06-15T00:00:00Z,967,889,45619,-78,-0.001709814,0.019487494,0.021197308,2018,HRB
2011-02-09T00:00:00Z,876,1191,56342,315,0.005590856,0.02113876,0.015547904,2011,BA
2012-02-09T00:00:00Z,852,1193,56535,341,0.006031662,0.021101972,0.01507031,2012,BA
2013-02-11T00:00:00Z,815,1179,54118,364,0.006726043,0.021785727,0.015059684,2013,BA
2014-02-14T00:00:00Z,792,1180,53529,388,0.007248407,0.022044126,0.014795718,2014,BA
2015-02-12T00:00:00Z,806,1179,53768,373,0.006937212,0.021927541,0.014990329,2015,BA
2016-02-10T00:00:00Z,821,1185,53642,364,0.006785728,0.022090899,0.015305171,2016,BA
2017-02-08T00:00:00Z,832,1145,53424,313,0.00585879,0.021432315,0.015573525,2017,BA
2018-02-12T00:00:00Z,759,1117,50771,358,0.007051269,0.022000748,0.014949479,2018,BA
2019-02-08T00:00:00Z,799,1157,56626,358,0.006322184,0.02043231,0.014110126,2019,BA
2011-02-25T00:00:00Z,1237,1377,71788,140,0.001950187,0.019181479,0.017231292,2011,BKNG
2012-02-27T00:00:00Z,1108,1381,67846,273,0.004023819,0.020354921,0.016331103,2012,BKNG
2013-02-27T00:00:00Z,1226,1539,73170,313,0.004277709,0.02103321,0.016755501,2013,BKNG
2014-02-20T00:00:00Z,1283,1740,76891,457,0.005943478,0.022629436,0.016685958,2014,BKNG
2015-02-19T00:00:00Z,1358,1559,76511,201,0.002627073,0.020376155,0.017749082,2015,BKNG
2016-02-17T00:00:00Z,1376,1536,76713,160,0.002085696,0.020022682,0.017936986,2016,BKNG
2017-02-27T00:00:00Z,1248,1421,71977,173,0.002403546,0.019742418,0.017338872,2017,BKNG
2018-02-27T00:00:00Z,1287,1545,76901,258,0.003354963,0.020090766,0.016735803,2018,BKNG
2019-02-27T00:00:00Z,1216,1458,74443,242,0.003250809,0.019585455,0.016334645,2019,BKNG
2012-02-14T00:00:00Z,696,999,45591,303,0.006646049,0.02191222,0.015266171,2012,BWA
2013-02-14T00:00:00Z,674,916,44159,242,0.005480197,0.020743223,0.015263027,2013,BWA
2014-02-13T00:00:00Z,694,922,43504,228,0.005240897,0.021193453,0.015952556,2014,BWA
2015-02-12T00:00:00Z,715,1025,45314,310,0.006841153,0.022619941,0.015778788,2015,BWA
2016-02-11T00:00:00Z,761,1117,47541,356,0.007488273,0.023495509,0.016007236,2016,BWA
2017-02-09T00:00:00Z,807,1249,52692,442,0.00838837,0.023703788,0.015315418,2017,BWA
2018-02-08T00:00:00Z,764,1168,51098,404,0.007906376,0.022858037,0.014951662,2018,BWA
2019-02-19T00:00:00Z,797,1273,55062,476,0.0086448,0.023119393,0.014474592,2019,BWA
2010-02-25T00:00:00Z,1333,1658,88433,325,0.003675099,0.018748657,0.015073559,2010,BXP
2011-02-25T00:00:00Z,1284,1766,89247,482,0.005400742,0.01978778,0.014387038,2011,BXP
2012-02-28T00:00:00Z,1321,1719,91094,398,0.004369113,0.018870617,0.014501504,2012,BXP
2013-02-28T00:00:00Z,1359,1785,92365,426,0.004612137,0.019325502,0.014713365,2013,BXP
2014-02-28T00:00:00Z,1435,1961,101294,526,0.005192805,0.019359488,0.014166683,2014,BXP
2015-03-02T00:00:00Z,1416,2010,104144,594,0.005703641,0.0193002,0.013596559,2015,BXP
2016-02-29T00:00:00Z,1689,2119,108839,430,0.00395079,0.019469124,0.015518334,2016,BXP
2017-02-28T00:00:00Z,1681,2130,111635,449,0.004022036,0.019080038,0.015058002,2017,BXP
2018-02-28T00:00:00Z,1660,2065,107889,405,0.003753858,0.019140042,0.015386184,2018,BXP
2019-02-28T00:00:00Z,1634,2126,111542,492,0.004410895,0.019060085,0.01464919,2019,BXP
2012-02-17T00:00:00Z,1400,2281,87932,881,0.010019106,0.025940499,0.015921394,2012,BSX
2013-02-22T00:00:00Z,1399,2286,86792,887,0.010219836,0.026338833,0.016118997,2013,BSX
2014-02-26T00:00:00Z,1367,2369,85526,1002,0.011715736,0.027699179,0.015983444,2014,BSX
2015-02-25T00:00:00Z,1308,2146,79535,838,0.010536242,0.026981832,0.01644559,2015,BSX
2016-02-24T00:00:00Z,1283,2038,75337,755,0.010021636,0.027051781,0.017030145,2016,BSX
2017-02-23T00:00:00Z,1273,1988,76955,715,0.009291144,0.025833279,0.016542135,2017,BSX
2018-02-20T00:00:00Z,1241,1868,71696,627,0.008745258,0.026054452,0.017309194,2018,BSX
2019-02-19T00:00:00Z,1320,1830,73575,510,0.006931702,0.024872579,0.017940877,2019,BSX
2011-02-18T00:00:00Z,1404,1848,88287,444,0.005029053,0.020931734,0.015902681,2011,BMY
2012-02-17T00:00:00Z,1212,1529,74351,317,0.004263561,0.020564619,0.016301058,2012,BMY
2013-02-15T00:00:00Z,1204,1558,76564,354,0.004623583,0.020348989,0.015725406,2013,BMY
2014-02-14T00:00:00Z,1141,1501,75191,360,0.004787807,0.019962496,0.015174688,2014,BMY
2015-02-13T00:00:00Z,1036,1477,70408,441,0.006263493,0.02097773,0.014714237,2015,BMY
2016-02-12T00:00:00Z,1070,1535,71064,465,0.006543398,0.021600248,0.01505685,2016,BMY
2017-02-21T00:00:00Z,958,1416,64449,458,0.007106394,0.021970861,0.014864466,2017,BMY
2018-02-13T00:00:00Z,988,1460,65014,472,0.007259975,0.022456702,0.015196727,2018,BMY
2019-02-25T00:00:00Z,1062,1546,67741,484,0.007144861,0.02282222,0.015677359,2019,BMY
2018-12-21T00:00:00Z,1376,1809,73076,433,0.005925338,0.02475505,0.018829712,2018,AVGO
2011-08-12T00:00:00Z,561,826,45108,265,0.005874789,0.018311608,0.012436818,2011,BR
2012-08-09T00:00:00Z,593,967,50078,374,0.007468349,0.019309877,0.011841527,2012,BR
2013-08-08T00:00:00Z,541,952,47215,411,0.008704861,0.020163084,0.011458223,2013,BR
2014-08-07T00:00:00Z,574,1057,49765,483,0.009705616,0.021239827,0.011534211,2014,BR
2015-08-07T00:00:00Z,555,1047,47709,492,0.01031252,0.021945545,0.011633025,2015,BR
2016-08-09T00:00:00Z,593,1089,50448,496,0.009831906,0.021586584,0.011754678,2016,BR
2017-08-10T00:00:00Z,630,1140,51927,510,0.00982148,0.021953897,0.012132417,2017,BR
2018-08-07T00:00:00Z,641,1220,53225,579,0.010878347,0.022921559,0.012043213,2018,BR
2010-03-01T00:00:00Z,403,614,29964,211,0.007041783,0.020491256,0.013449473,2010,CHRW
2011-03-01T00:00:00Z,367,598,28607,231,0.008074947,0.020903975,0.012829028,2011,CHRW
2012-02-29T00:00:00Z,355,570,27889,215,0.007709133,0.020438166,0.012729033,2012,CHRW
2013-03-01T00:00:00Z,366,600,29463,234,0.007942165,0.020364525,0.01242236,2013,CHRW
2014-03-03T00:00:00Z,383,659,31642,276,0.008722584,0.020826749,0.012104165,2014,CHRW
2015-03-02T00:00:00Z,384,652,31978,268,0.008380762,0.020389017,0.012008256,2015,CHRW
2016-02-29T00:00:00Z,378,627,31415,249,0.00792615,0.019958618,0.012032469,2016,CHRW
2017-03-01T00:00:00Z,420,776,35831,356,0.009935531,0.021657224,0.011721694,2017,CHRW
2018-02-28T00:00:00Z,421,748,35480,327,0.00921646,0.0210823,0.01186584,2018,CHRW
2019-02-25T00:00:00Z,414,740,36537,326,0.008922462,0.020253442,0.01133098,2019,CHRW
2011-02-28T00:00:00Z,1003,1225,57555,222,0.00385718,0.021283989,0.017426809,2011,COG
2012-02-28T00:00:00Z,976,1251,55087,275,0.004992103,0.022709532,0.017717429,2012,COG
2013-02-28T00:00:00Z,958,1128,51807,170,0.00328141,0.021773119,0.01849171,2013,COG
2014-02-28T00:00:00Z,984,1152,51715,168,0.003248574,0.022275935,0.019027362,2014,COG
2015-02-27T00:00:00Z,1063,1144,53253,81,0.001521041,0.021482358,0.019961317,2015,COG
2016-02-22T00:00:00Z,1137,1224,56051,87,0.001552158,0.021837255,0.020285098,2016,COG
2017-02-27T00:00:00Z,1204,1259,57655,55,0.00095395,0.021836788,0.020882838,2017,COG
2018-03-01T00:00:00Z,1138,1208,56777,70,0.001232894,0.021276221,0.020043327,2018,COG
2019-02-26T00:00:00Z,1080,1151,55596,71,0.00127707,0.020702928,0.019425858,2019,COG
2011-02-24T00:00:00Z,1123,1452,67353,329,0.004884712,0.02155806,0.016673348,2011,CDNS
2012-02-24T00:00:00Z,917,1211,57867,294,0.005080616,0.020927299,0.015846683,2012,CDNS
2013-02-21T00:00:00Z,828,1224,56726,396,0.006980926,0.021577407,0.014596481,2013,CDNS
2014-02-20T00:00:00Z,779,1170,53355,391,0.007328273,0.021928592,0.014600319,2014,CDNS
2015-02-20T00:00:00Z,783,1127,51239,344,0.006713636,0.021994965,0.015281329,2015,CDNS
2016-02-18T00:00:00Z,722,1029,46903,307,0.006545424,0.021938895,0.015393472,2016,CDNS
2017-02-10T00:00:00Z,690,1066,48365,376,0.007774217,0.022040732,0.014266515,2017,CDNS
2018-02-20T00:00:00Z,704,1071,50000,367,0.00734,0.02142,0.01408,2018,CDNS
2019-02-27T00:00:00Z,723,1052,48722,329,0.006752596,0.021591889,0.014839292,2019,CDNS
2009-09-30T00:00:00Z,507,972,41442,465,0.011220501,0.023454466,0.012233966,2009,CPB
2010-09-29T00:00:00Z,518,984,40090,466,0.011623846,0.024544774,0.012920928,2010,CPB
2011-09-28T00:00:00Z,527,1041,40898,514,0.012567852,0.025453567,0.012885716,2011,CPB
2012-09-27T00:00:00Z,511,995,38891,484,0.012445039,0.025584325,0.013139287,2012,CPB
2013-09-26T00:00:00Z,641,1049,43300,408,0.009422633,0.024226328,0.014803695,2013,CPB
2014-09-24T00:00:00Z,690,1065,44274,375,0.008469982,0.02405475,0.015584768,2014,CPB
2015-09-29T00:00:00Z,708,1200,46027,492,0.010689378,0.026071654,0.015382276,2015,CPB
2016-09-22T00:00:00Z,747,1283,43844,536,0.012225162,0.029262841,0.017037679,2016,CPB
2017-09-27T00:00:00Z,724,1371,44791,647,0.014444866,0.030608828,0.016163962,2017,CPB
2018-09-27T00:00:00Z,754,1460,50826,706,0.013890528,0.028725455,0.014834927,2018,CPB
2011-03-01T00:00:00Z,2548,2656,122144,108,0.000884202,0.021744826,0.020860624,2011,COF
2012-02-29T00:00:00Z,2871,2766,136800,-105,-0.000767544,0.020219298,0.020986842,2012,COF
2013-02-28T00:00:00Z,2823,2915,142154,92,0.000647185,0.02050593,0.019858745,2013,COF
2014-02-27T00:00:00Z,980,764,51985,-216,-0.004155045,0.014696547,0.018851592,2014,COF
2015-02-24T00:00:00Z,2631,2714,129108,83,0.000642873,0.021021161,0.020378288,2015,COF
2016-02-25T00:00:00Z,2633,2617,125865,-16,-0.00012712,0.020792119,0.020919239,2016,COF
2017-02-23T00:00:00Z,2639,2581,124144,-58,-0.000467199,0.020790372,0.021257572,2017,COF
2018-02-21T00:00:00Z,2473,2519,118368,46,0.000388619,0.021281089,0.020892471,2018,COF
2019-02-20T00:00:00Z,2385,2338,116899,-47,-0.000402056,0.020000171,0.020402228,2019,COF
2013-05-29T00:00:00Z,651,860,41282,209,0.005062739,0.020832324,0.015769585,2013,CPRI
2014-05-28T00:00:00Z,696,882,43204,186,0.004305157,0.020414776,0.016109619,2014,CPRI
2015-05-27T00:00:00Z,177,159,10009,-18,-0.001798381,0.015885703,0.017684084,2015,CPRI
2016-06-01T00:00:00Z,771,1068,50062,297,0.005932644,0.021333546,0.015400903,2016,CPRI
2017-05-31T00:00:00Z,819,1122,51590,303,0.005873231,0.021748401,0.01587517,2017,CPRI
2018-05-30T00:00:00Z,928,1345,60615,417,0.006879485,0.022189227,0.015309742,2018,CPRI
2010-08-26T00:00:00Z,687,917,49818,230,0.004616805,0.018407001,0.013790196,2010,CAH
2011-08-26T00:00:00Z,579,800,43669,221,0.005060798,0.018319632,0.013258833,2011,CAH
2012-08-22T00:00:00Z,519,806,42521,287,0.006749606,0.01895534,0.012205734,2012,CAH
2013-08-20T00:00:00Z,541,864,44539,323,0.007252071,0.019398729,0.012146658,2013,CAH
2014-08-13T00:00:00Z,539,833,42450,294,0.006925795,0.019623086,0.012697291,2014,CAH
2015-08-13T00:00:00Z,626,917,44643,291,0.006518379,0.020540734,0.014022355,2015,CAH
2016-08-12T00:00:00Z,617,920,43499,303,0.006965677,0.021149911,0.014184234,2016,CAH
2017-08-10T00:00:00Z,663,1038,45047,375,0.008324639,0.0230426,0.014717961,2017,CAH
2018-08-22T00:00:00Z,732,1170,48738,438,0.008986828,0.024005909,0.015019082,2018,CAH
2012-04-25T00:00:00Z,697,917,45531,220,0.004831873,0.020140124,0.015308252,2012,KMX
2013-04-26T00:00:00Z,664,820,41820,156,0.003730273,0.019607843,0.015877571,2013,KMX
2014-04-25T00:00:00Z,765,890,44190,125,0.002828694,0.020140303,0.017311609,2014,KMX
2015-04-24T00:00:00Z,746,792,42506,46,0.0010822,0.018632664,0.017550463,2015,KMX
2016-04-22T00:00:00Z,710,777,41470,67,0.001615626,0.018736436,0.01712081,2016,KMX
2017-04-21T00:00:00Z,771,833,44228,62,0.001401827,0.018834223,0.017432396,2017,KMX
2018-04-24T00:00:00Z,786,854,45006,68,0.00151091,0.018975248,0.017464338,2018,KMX
2019-04-19T00:00:00Z,781,841,45323,60,0.001323831,0.0185557,0.017231869,2019,KMX
2010-01-29T00:00:00Z,391,584,32210,193,0.005991928,0.018131015,0.012139087,2010,CCL
2011-01-31T00:00:00Z,409,618,32723,209,0.006386945,0.018885799,0.012498854,2011,CCL
2012-01-30T00:00:00Z,492,687,33945,195,0.005744587,0.020238621,0.014494034,2012,CCL
2013-01-29T00:00:00Z,594,732,36165,138,0.003815844,0.020240564,0.01642472,2013,CCL
2014-01-29T00:00:00Z,550,874,38220,324,0.008477237,0.022867609,0.014390372,2014,CCL
2015-01-29T00:00:00Z,502,1065,40734,563,0.013821378,0.026145235,0.012323857,2015,CCL
2016-01-29T00:00:00Z,501,894,35464,393,0.01108166,0.025208662,0.014127002,2016,CCL
2017-01-30T00:00:00Z,510,860,32550,350,0.010752688,0.026420891,0.015668203,2017,CCL
2018-01-29T00:00:00Z,351,753,27453,402,0.014643208,0.027428696,0.012785488,2018,CCL
2019-01-28T00:00:00Z,237,718,24815,481,0.019383437,0.028934112,0.009550675,2019,CCL
2010-02-19T00:00:00Z,302,354,18354,52,0.00283317,0.019287349,0.016454179,2010,CAT
2011-02-22T00:00:00Z,358,391,20006,33,0.001649505,0.019544137,0.017894632,2011,CAT
2012-02-21T00:00:00Z,344,372,20491,28,0.001366454,0.018154312,0.016787858,2012,CAT
2013-02-19T00:00:00Z,346,378,20525,32,0.001559074,0.018416565,0.016857491,2013,CAT
2014-02-18T00:00:00Z,386,405,21017,19,0.00090403,0.019270115,0.018366085,2014,CAT
2015-02-17T00:00:00Z,412,405,21795,-7,-0.000321175,0.018582244,0.018903418,2015,CAT
2016-02-16T00:00:00Z,1365,1944,75262,579,0.007693125,0.025829768,0.018136643,2016,CAT
2017-02-15T00:00:00Z,1487,2076,78651,589,0.00748878,0.026395087,0.018906308,2017,CAT
2018-02-15T00:00:00Z,1303,2053,77195,750,0.009715655,0.026594987,0.016879332,2018,CAT
2019-02-14T00:00:00Z,1202,1992,76209,790,0.01036623,0.026138645,0.015772415,2019,CAT
2011-03-16T00:00:00Z,663,1019,57176,356,0.006226389,0.017822163,0.011595774,2011,CBOE
2012-02-28T00:00:00Z,611,909,50801,298,0.005866026,0.017893349,0.012027322,2012,CBOE
2013-02-28T00:00:00Z,642,824,48622,182,0.003743162,0.016947061,0.013203899,2013,CBOE
2014-02-21T00:00:00Z,644,785,46395,141,0.003039121,0.016919927,0.013880806,2014,CBOE
2015-02-20T00:00:00Z,669,790,45799,121,0.002641979,0.017249285,0.014607306,2015,CBOE
2016-02-19T00:00:00Z,694,880,48958,186,0.003799175,0.01797459,0.014175416,2016,CBOE
2017-02-21T00:00:00Z,851,1131,59461,280,0.004708969,0.019020871,0.014311902,2017,CBOE
2018-02-22T00:00:00Z,1125,1481,74715,356,0.004764773,0.01982199,0.015057217,2018,CBOE
2019-02-22T00:00:00Z,1112,1447,75758,335,0.004421975,0.019100293,0.014678318,2019,CBOE
2011-03-01T00:00:00Z,1224,1641,79119,417,0.005270542,0.020740909,0.015470367,2011,CBRE
2012-02-29T00:00:00Z,1201,1688,83431,487,0.005837159,0.020232288,0.014395129,2012,CBRE
2013-03-01T00:00:00Z,1285,1679,82533,394,0.004773848,0.020343378,0.01556953,2013,CBRE
2014-03-03T00:00:00Z,1302,1754,82951,452,0.005449,0.021145013,0.015696013,2014,CBRE
2015-03-02T00:00:00Z,1264,1789,82809,525,0.006339891,0.021603932,0.015264041,2015,CBRE
2016-02-29T00:00:00Z,990,1365,65817,375,0.005697616,0.020739323,0.015041707,2016,CBRE
2017-03-01T00:00:00Z,966,1321,63962,355,0.00555017,0.020652888,0.015102717,2017,CBRE
2018-03-01T00:00:00Z,979,1353,65548,374,0.005705742,0.020641362,0.01493562,2018,CBRE
2019-03-01T00:00:00Z,1052,1506,70144,454,0.0064724,0.021470119,0.014997719,2019,CBRE
2010-02-25T00:00:00Z,1011,1436,71513,425,0.005942975,0.020080265,0.01413729,2010,CBS
2011-02-25T00:00:00Z,978,1368,70187,390,0.005556585,0.019490789,0.013934204,2011,CBS
2012-02-23T00:00:00Z,927,1365,70209,438,0.006238516,0.019441952,0.013203435,2012,CBS
2013-02-15T00:00:00Z,872,1250,68978,378,0.005480008,0.01812172,0.012641712,2013,CBS
2014-02-14T00:00:00Z,873,1288,70403,415,0.005894635,0.018294675,0.01240004,2014,CBS
2015-02-13T00:00:00Z,890,1201,64377,311,0.004830918,0.018655731,0.013824813,2015,CBS
2016-02-16T00:00:00Z,847,1261,65382,414,0.006332018,0.019286654,0.012954636,2016,CBS
2017-02-17T00:00:00Z,918,1334,67810,416,0.006134788,0.019672615,0.013537826,2017,CBS
2018-02-20T00:00:00Z,947,1409,69677,462,0.006630595,0.020221881,0.013591286,2018,CBS
2019-02-15T00:00:00Z,1003,1496,77478,493,0.006363097,0.019308707,0.01294561,2019,CBS
2011-02-11T00:00:00Z,1280,1775,79332,495,0.006239601,0.022374326,0.016134725,2011,CE
2012-02-10T00:00:00Z,1206,1677,73394,471,0.006417418,0.022849279,0.016431861,2012,CE
2013-02-08T00:00:00Z,1244,1656,71682,412,0.005747607,0.023102034,0.017354426,2013,CE
2014-02-07T00:00:00Z,1291,1768,75800,477,0.006292876,0.023324538,0.017031662,2014,CE
2015-02-06T00:00:00Z,1106,1527,66845,421,0.006298152,0.022843893,0.01654574,2015,CE
2016-02-05T00:00:00Z,1119,1504,66415,385,0.005796883,0.022645487,0.016848603,2016,CE
2017-02-10T00:00:00Z,1107,1497,65716,390,0.005934628,0.022779841,0.016845213,2017,CE
2018-02-09T00:00:00Z,1110,1465,67198,355,0.005282895,0.021801244,0.016518349,2018,CE
2019-02-07T00:00:00Z,1088,1469,65874,381,0.005783769,0.022300149,0.01651638,2019,CE
2011-03-01T00:00:00Z,1156,1581,73290,425,0.005798881,0.021571838,0.015772957,2011,CELG
2012-02-22T00:00:00Z,1086,1598,70444,512,0.007268185,0.022684686,0.015416501,2012,CELG
2013-02-15T00:00:00Z,1195,1622,72576,427,0.005883488,0.022348986,0.016465498,2013,CELG
2014-02-13T00:00:00Z,1072,1421,65216,349,0.005351447,0.021789132,0.016437684,2014,CELG
2015-02-20T00:00:00Z,1197,1481,70173,284,0.004047141,0.021104983,0.017057843,2015,CELG
2016-02-11T00:00:00Z,1254,1624,76643,370,0.004827577,0.02118915,0.016361572,2016,CELG
2017-02-10T00:00:00Z,1211,1629,76371,418,0.005473282,0.021330086,0.015856804,2017,CELG
2018-02-07T00:00:00Z,1366,1827,86751,461,0.00531406,0.021060276,0.015746216,2018,CELG
2019-02-26T00:00:00Z,1628,2035,94554,407,0.004304419,0.021522093,0.017217675,2019,CELG
2010-02-22T00:00:00Z,893,1000,47779,107,0.002239478,0.020929697,0.01869022,2010,CNC
2011-02-22T00:00:00Z,875,1068,48496,193,0.00397971,0.022022435,0.018042725,2011,CNC
2012-02-21T00:00:00Z,863,1106,47968,243,0.005065877,0.023057038,0.017991161,2012,CNC
2013-02-19T00:00:00Z,906,1178,49973,272,0.005442939,0.023572729,0.01812979,2013,CNC
2014-02-21T00:00:00Z,823,1028,46573,205,0.004401692,0.022072875,0.017671183,2014,CNC
2015-02-23T00:00:00Z,852,1049,48237,197,0.004084002,0.021746792,0.01766279,2015,CNC
2016-02-22T00:00:00Z,969,1164,54069,195,0.003606503,0.021528047,0.017921545,2016,CNC
2017-02-21T00:00:00Z,1076,1468,61947,392,0.00632799,0.023697677,0.017369687,2017,CNC
2018-02-20T00:00:00Z,1193,1555,65706,362,0.00550939,0.023666027,0.018156637,2018,CNC
2019-02-19T00:00:00Z,1072,1445,61668,373,0.006048518,0.023431926,0.017383408,2019,CNC
2011-03-01T00:00:00Z,980,1577,77040,597,0.007749221,0.020469886,0.012720665,2011,CNP
2012-02-29T00:00:00Z,911,1368,68086,457,0.006712099,0.020092236,0.013380137,2012,CNP
2013-02-27T00:00:00Z,902,1256,64554,354,0.005483781,0.019456579,0.013972798,2013,CNP
2014-02-26T00:00:00Z,1233,1480,78756,247,0.003136269,0.018792219,0.01565595,2014,CNP
2015-02-26T00:00:00Z,1311,1568,82094,257,0.003130558,0.019100056,0.015969498,2015,CNP
2016-02-26T00:00:00Z,1485,1635,85769,150,0.001748884,0.019062832,0.017313948,2016,CNP
2017-02-28T00:00:00Z,1434,1522,78598,88,0.001119621,0.01936436,0.018244739,2017,CNP
2018-02-22T00:00:00Z,1495,1637,80021,142,0.001774534,0.02045713,0.018682596,2018,CNP
2019-02-28T00:00:00Z,1615,1847,98205,232,0.002362405,0.018807596,0.016445191,2019,CNP
2011-03-01T00:00:00Z,920,1389,60739,469,0.007721563,0.022868338,0.015146776,2011,CTL
2012-02-28T00:00:00Z,1112,1631,76174,519,0.006813348,0.021411505,0.014598157,2012,CTL
2013-03-01T00:00:00Z,1219,1619,83030,400,0.004817536,0.019498976,0.01468144,2013,CTL
2014-02-27T00:00:00Z,1298,1618,82994,320,0.0038557,0.019495385,0.015639685,2014,CTL
2015-02-24T00:00:00Z,1311,1605,78770,294,0.003732385,0.020375778,0.016643392,2015,CTL
2016-02-25T00:00:00Z,1327,1684,81033,357,0.004405613,0.020781657,0.016376044,2016,CTL
2017-02-23T00:00:00Z,1443,1876,86166,433,0.005025184,0.021771929,0.016746745,2017,CTL
2018-03-01T00:00:00Z,1586,2107,95360,521,0.005463507,0.022095218,0.016631711,2018,CTL
2019-03-11T00:00:00Z,1663,2017,89350,354,0.003961947,0.022574147,0.018612199,2019,CTL
2010-02-22T00:00:00Z,491,829,37747,338,0.008954354,0.02196201,0.013007656,2010,CERN
2011-02-16T00:00:00Z,524,917,37470,393,0.010488391,0.024472912,0.013984521,2011,CERN
2012-02-15T00:00:00Z,504,857,36649,353,0.009631914,0.023383994,0.013752081,2012,CERN
2013-02-08T00:00:00Z,553,868,37667,315,0.008362758,0.023044044,0.014681286,2013,CERN
2014-02-05T00:00:00Z,582,872,38443,290,0.007543636,0.022682933,0.015139297,2014,CERN
2015-02-11T00:00:00Z,604,880,39598,276,0.006970049,0.022223345,0.015253296,2015,CERN
2016-02-17T00:00:00Z,639,971,43290,332,0.007669208,0.022430122,0.014760915,2016,CERN
2017-02-10T00:00:00Z,655,1003,44454,348,0.007828317,0.022562649,0.014734332,2017,CERN
2018-02-12T00:00:00Z,682,1057,45193,375,0.008297745,0.023388578,0.015090833,2018,CERN
2019-02-08T00:00:00Z,716,1046,43969,330,0.007505288,0.023789488,0.0162842,2019,CERN
2010-02-25T00:00:00Z,1046,1180,68548,134,0.001954835,0.017214215,0.01525938,2010,CF
2011-02-25T00:00:00Z,1057,1260,73411,203,0.002765253,0.01716364,0.014398387,2011,CF
2012-02-27T00:00:00Z,1054,1301,72689,247,0.003398038,0.017898169,0.014500131,2012,CF
2013-02-27T00:00:00Z,1063,1331,77941,268,0.003438498,0.01707702,0.013638521,2013,CF
2014-02-27T00:00:00Z,1034,1180,72604,146,0.002010908,0.016252548,0.01424164,2014,CF
2015-02-26T00:00:00Z,994,1112,72085,118,0.001636956,0.015426233,0.013789277,2015,CF
2016-02-25T00:00:00Z,1304,1297,88904,-7,-7.87E-05,0.01458877,0.014667507,2016,CF
2017-02-23T00:00:00Z,1516,1480,92080,-36,-0.000390964,0.01607298,0.016463944,2017,CF
2018-02-22T00:00:00Z,1422,1429,83805,7,8.35E-05,0.017051489,0.016967961,2018,CF
2019-02-22T00:00:00Z,1344,1383,81729,39,0.000477187,0.016921778,0.016444591,2019,CF
2010-02-25T00:00:00Z,984,1226,52870,242,0.004577265,0.023188954,0.018611689,2010,SCHW
2011-02-25T00:00:00Z,1008,1175,54810,167,0.003046889,0.021437694,0.018390805,2011,SCHW
2012-02-24T00:00:00Z,972,1205,56452,233,0.0041274,0.021345568,0.017218168,2012,SCHW
2013-02-22T00:00:00Z,1019,1209,59552,190,0.003190489,0.020301585,0.017111096,2013,SCHW
2014-02-24T00:00:00Z,1086,1215,58534,129,0.002203847,0.020757167,0.018553319,2014,SCHW
2015-02-23T00:00:00Z,1085,1179,56973,94,0.001649904,0.020694013,0.019044109,2015,SCHW
2016-02-24T00:00:00Z,1142,1273,59910,131,0.002186613,0.021248539,0.019061926,2016,SCHW
2017-02-23T00:00:00Z,1064,1234,59203,170,0.002871476,0.020843538,0.017972062,2017,SCHW
2018-02-22T00:00:00Z,932,1117,53308,185,0.003470398,0.020953703,0.017483305,2018,SCHW
2019-02-22T00:00:00Z,974,1125,54409,151,0.002775276,0.020676726,0.01790145,2019,SCHW
2010-02-26T00:00:00Z,1319,2091,97756,772,0.007897213,0.021389991,0.013492778,2010,CHTR
2011-03-01T00:00:00Z,1099,1411,72833,312,0.004283772,0.019373086,0.015089314,2011,CHTR
2012-02-27T00:00:00Z,1065,1356,69307,291,0.00419871,0.019565123,0.015366413,2012,CHTR
2013-02-22T00:00:00Z,1033,1133,62092,100,0.001610513,0.018247117,0.016636604,2013,CHTR
2014-02-21T00:00:00Z,1072,1262,65931,190,0.002881801,0.019141223,0.016259423,2014,CHTR
2015-02-24T00:00:00Z,1138,1357,70145,219,0.003122104,0.019345641,0.016223537,2015,CHTR
2016-02-10T00:00:00Z,1214,1759,79515,545,0.006854053,0.022121612,0.01526756,2016,CHTR
2017-02-16T00:00:00Z,1079,1699,78949,620,0.007853171,0.021520222,0.013667051,2017,CHTR
2018-02-02T00:00:00Z,919,1548,73764,629,0.008527195,0.020985847,0.012458652,2018,CHTR
2019-01-31T00:00:00Z,872,1516,75776,644,0.008498733,0.020006334,0.011507601,2019,CHTR
2010-02-25T00:00:00Z,1011,1196,72716,185,0.002544144,0.016447549,0.013903405,2010,CVX
2011-02-24T00:00:00Z,1101,1279,79477,178,0.002239642,0.016092706,0.013853064,2011,CVX
2012-02-23T00:00:00Z,968,1187,70629,219,0.003100709,0.016806128,0.013705418,2012,CVX
2013-02-22T00:00:00Z,924,1117,66572,193,0.002899117,0.016778826,0.013879709,2013,CVX
2014-02-21T00:00:00Z,950,1047,64481,97,0.001504319,0.016237341,0.014733022,2014,CVX
2015-02-20T00:00:00Z,910,980,61056,70,0.001146488,0.016050839,0.01490435,2015,CVX
2016-02-25T00:00:00Z,948,961,59807,13,0.000217366,0.016068353,0.015850987,2016,CVX
2017-02-23T00:00:00Z,1048,991,61914,-57,-0.000920632,0.016006073,0.016926705,2017,CVX
2018-02-22T00:00:00Z,1061,1025,61140,-36,-0.000588813,0.016764802,0.017353615,2018,CVX
2019-02-22T00:00:00Z,1022,1002,60824,-20,-0.000328818,0.01647376,0.016802578,2019,CVX
2010-02-19T00:00:00Z,416,675,30250,259,0.008561983,0.02231405,0.013752066,2010,CMG
2011-02-17T00:00:00Z,459,760,32187,301,0.009351602,0.023612017,0.014260416,2011,CMG
2012-02-10T00:00:00Z,474,772,32393,298,0.009199518,0.023832309,0.014632791,2012,CMG
2013-02-08T00:00:00Z,541,810,33882,269,0.007939319,0.023906499,0.01596718,2013,CMG
2014-02-05T00:00:00Z,550,828,34538,278,0.008049105,0.023973594,0.015924489,2014,CMG
2015-02-04T00:00:00Z,566,840,35466,274,0.007725709,0.023684656,0.015958947,2015,CMG
2016-02-05T00:00:00Z,681,989,39185,308,0.007860151,0.02523925,0.017379099,2016,CMG
2017-02-07T00:00:00Z,689,1001,38563,312,0.008090657,0.025957524,0.017866867,2017,CMG
2018-02-08T00:00:00Z,764,1036,40420,272,0.006729342,0.025630876,0.018901534,2018,CMG
2019-02-08T00:00:00Z,831,1101,42948,270,0.006286672,0.025635652,0.01934898,2019,CMG
2010-02-25T00:00:00Z,3576,2417,114590,-1159,-0.010114321,0.021092591,0.031206912,2010,CB
2011-02-25T00:00:00Z,3430,2250,108545,-1180,-0.010871067,0.02072873,0.031599797,2011,CB
2012-02-24T00:00:00Z,3650,2289,111580,-1361,-0.012197526,0.020514429,0.032711956,2012,CB
2013-02-28T00:00:00Z,3568,2327,111283,-1241,-0.011151748,0.020910651,0.032062399,2013,CB
2014-02-28T00:00:00Z,3342,2118,103183,-1224,-0.011862419,0.020526637,0.032389056,2014,CB
2015-02-27T00:00:00Z,3255,2038,99691,-1217,-0.012207722,0.020443169,0.032650891,2015,CB
2016-02-26T00:00:00Z,3392,2143,105849,-1249,-0.011799828,0.020245822,0.03204565,2016,CB
2017-02-28T00:00:00Z,3645,2495,119639,-1150,-0.00961225,0.020854404,0.030466654,2017,CB
2018-02-23T00:00:00Z,3823,2544,120964,-1279,-0.010573394,0.021031051,0.031604444,2018,CB
2019-02-28T00:00:00Z,3922,2535,119619,-1387,-0.011595148,0.021192286,0.032787433,2019,CB
2010-02-24T00:00:00Z,583,894,44668,311,0.006962479,0.020014328,0.013051849,2010,CHD
2011-02-24T00:00:00Z,586,891,45582,305,0.006691238,0.01954719,0.012855952,2011,CHD
2012-02-24T00:00:00Z,756,961,52782,205,0.0038839,0.018206964,0.014323065,2012,CHD
2013-02-22T00:00:00Z,827,1105,53196,278,0.005225957,0.020772239,0.015546282,2013,CHD
2014-02-21T00:00:00Z,862,1110,54658,248,0.004537305,0.020308098,0.015770793,2014,CHD
2015-02-20T00:00:00Z,800,1152,53979,352,0.006521054,0.021341633,0.014820578,2015,CHD
2016-02-19T00:00:00Z,865,1149,52824,284,0.005376344,0.021751477,0.016375133,2016,CHD
2017-02-24T00:00:00Z,856,1056,50655,200,0.003948278,0.020846906,0.016898628,2017,CHD
2018-02-23T00:00:00Z,797,977,48043,180,0.003746644,0.020335949,0.016589305,2018,CHD
2019-02-21T00:00:00Z,850,1023,49362,173,0.00350472,0.020724444,0.017219724,2019,CHD
2019-02-28T00:00:00Z,1588,2512,95354,924,0.009690207,0.026343939,0.016653732,2019,CI
2012-02-22T00:00:00Z,790,814,44143,24,0.000543688,0.01844007,0.017896382,2012,XEC
2013-02-26T00:00:00Z,762,725,41866,-37,-0.000883772,0.017317155,0.018200927,2013,XEC
2014-02-26T00:00:00Z,763,703,40357,-60,-0.001486731,0.017419531,0.018906262,2014,XEC
2015-02-25T00:00:00Z,792,748,42279,-44,-0.001040706,0.017691998,0.018732704,2015,XEC
2016-02-23T00:00:00Z,906,794,46445,-112,-0.002411454,0.017095489,0.019506944,2016,XEC
2017-02-24T00:00:00Z,944,819,46430,-125,-0.002692225,0.017639457,0.020331682,2017,XEC
2018-02-23T00:00:00Z,968,842,48866,-126,-0.00257848,0.017230794,0.019809274,2018,XEC
2019-02-20T00:00:00Z,1017,957,52362,-60,-0.001145869,0.018276613,0.019422482,2019,XEC
2010-02-26T00:00:00Z,2694,1968,82024,-726,-0.008851068,0.023992978,0.032844046,2010,CINF
2011-02-25T00:00:00Z,2914,2036,86610,-878,-0.010137398,0.023507678,0.033645076,2011,CINF
2012-02-29T00:00:00Z,3178,2113,89845,-1065,-0.011853748,0.023518281,0.03537203,2012,CINF
2013-02-27T00:00:00Z,3093,2163,88974,-930,-0.010452492,0.024310473,0.034762964,2013,CINF
2014-02-27T00:00:00Z,2972,2098,85677,-874,-0.010201104,0.024487319,0.034688423,2014,CINF
2015-02-27T00:00:00Z,2738,2048,85353,-690,-0.008084074,0.02399447,0.032078544,2015,CINF
2016-02-26T00:00:00Z,2744,1929,83362,-815,-0.009776637,0.02314004,0.032916677,2016,CINF
2017-02-24T00:00:00Z,2676,1900,84436,-776,-0.009190393,0.02250225,0.031692643,2017,CINF
2018-02-23T00:00:00Z,2675,1939,84458,-736,-0.008714391,0.022958157,0.031672547,2018,CINF
2019-02-22T00:00:00Z,2741,2013,85820,-728,-0.008482871,0.023456071,0.031938942,2019,CINF
2010-07-30T00:00:00Z,388,622,29186,234,0.008017543,0.021311588,0.013294045,2010,CTAS
2011-07-29T00:00:00Z,370,578,30029,208,0.006926638,0.01924806,0.012321423,2011,CTAS
2012-07-30T00:00:00Z,354,627,30383,273,0.008985288,0.02063654,0.011651252,2012,CTAS
2013-07-30T00:00:00Z,372,630,31009,258,0.008320165,0.020316682,0.011996517,2013,CTAS
2014-07-30T00:00:00Z,441,676,34108,235,0.006889879,0.019819397,0.012929518,2014,CTAS
2015-07-30T00:00:00Z,460,702,35868,242,0.006746961,0.019571763,0.012824802,2015,CTAS
2016-07-29T00:00:00Z,460,746,36841,286,0.00776309,0.020249179,0.012486089,2016,CTAS
2017-07-31T00:00:00Z,576,924,43415,348,0.008015663,0.021282967,0.013267304,2017,CTAS
2018-07-27T00:00:00Z,566,912,41374,346,0.00836274,0.022042829,0.013680089,2018,CTAS
2009-09-11T00:00:00Z,506,514,23836,8,0.000335627,0.021564021,0.021228394,2009,CSCO
2010-09-21T00:00:00Z,549,542,25111,-7,-0.000278762,0.021584166,0.021862929,2010,CSCO
2011-09-14T00:00:00Z,1307,1529,73802,222,0.003008049,0.020717596,0.017709547,2011,CSCO
2012-09-12T00:00:00Z,1300,1562,74088,262,0.003536335,0.021083036,0.017546701,2012,CSCO
2013-09-10T00:00:00Z,1369,1606,75641,237,0.003133221,0.021231872,0.01809865,2013,CSCO
2014-09-09T00:00:00Z,1373,1612,74834,239,0.003193735,0.021541011,0.018347275,2014,CSCO
2015-09-08T00:00:00Z,1359,1571,74649,212,0.002839958,0.021045158,0.0182052,2015,CSCO
2016-09-08T00:00:00Z,1391,1601,76014,210,0.002762649,0.02106191,0.018299261,2016,CSCO
2017-09-07T00:00:00Z,1410,1590,74440,180,0.002418055,0.021359484,0.018941429,2017,CSCO
2018-09-06T00:00:00Z,1374,1525,70133,151,0.002153052,0.0217444,0.019591348,2018,CSCO
2010-02-26T00:00:00Z,3480,3783,163843,303,0.001849331,0.023089177,0.021239845,2010,C
2011-02-25T00:00:00Z,3676,3810,172241,134,0.00077798,0.022120169,0.021342189,2011,C
2012-02-24T00:00:00Z,3899,3856,179573,-43,-0.000239457,0.021473161,0.021712618,2012,C
2013-03-01T00:00:00Z,4125,4019,187728,-106,-0.000564647,0.021408634,0.02197328,2013,C
2014-03-03T00:00:00Z,3984,4058,182797,74,0.000404821,0.022199489,0.021794668,2014,C
2015-02-25T00:00:00Z,3700,3720,167840,20,0.000119161,0.022163966,0.022044805,2015,C
2016-02-26T00:00:00Z,3495,3657,164457,162,0.00098506,0.022236816,0.021251756,2016,C
2017-02-24T00:00:00Z,3374,3554,160279,180,0.001123042,0.022173834,0.021050793,2017,C
2018-02-23T00:00:00Z,3359,3687,156386,328,0.002097374,0.023576279,0.021478905,2018,C
2019-02-22T00:00:00Z,3360,3520,150902,160,0.001060291,0.023326397,0.022266106,2019,C
2015-03-03T00:00:00Z,2865,3209,132958,344,0.002587283,0.024135441,0.021548158,2015,CFG
2016-02-26T00:00:00Z,2402,2947,120398,545,0.004526653,0.024477151,0.019950498,2016,CFG
2017-02-24T00:00:00Z,2182,2704,112496,522,0.004640165,0.02403641,0.019396245,2017,CFG
2018-02-22T00:00:00Z,1984,2356,103147,372,0.003606503,0.022841188,0.019234684,2018,CFG
2019-02-21T00:00:00Z,1981,2285,100866,304,0.0030139,0.022653818,0.019639918,2019,CFG
2012-02-23T00:00:00Z,812,1589,61611,777,0.012611384,0.025790849,0.013179465,2012,CTXS
2013-02-21T00:00:00Z,875,1535,63557,660,0.010384379,0.024151549,0.01376717,2013,CTXS
2014-02-20T00:00:00Z,897,1485,59410,588,0.009897324,0.024995792,0.015098468,2014,CTXS
2015-02-19T00:00:00Z,920,1574,64814,654,0.010090413,0.024284877,0.014194464,2015,CTXS
2016-02-18T00:00:00Z,956,1651,67217,695,0.010339646,0.024562239,0.014222592,2016,CTXS
2017-02-16T00:00:00Z,911,1542,66107,631,0.009545131,0.02332582,0.013780689,2017,CTXS
2018-02-16T00:00:00Z,996,1529,66659,533,0.00799592,0.022937638,0.014941718,2018,CTXS
2019-02-15T00:00:00Z,1029,1562,65862,533,0.008092679,0.023716255,0.015623577,2019,CTXS
2010-08-26T00:00:00Z,345,313,15429,-32,-0.002074016,0.020286474,0.02236049,2010,CLX
2011-08-26T00:00:00Z,351,331,16597,-20,-0.001205037,0.019943363,0.0211484,2011,CLX
2012-08-24T00:00:00Z,332,330,16704,-2,-0.000119732,0.019755747,0.019875479,2012,CLX
2013-08-23T00:00:00Z,351,343,16290,-8,-0.000491099,0.021055862,0.021546961,2013,CLX
2014-08-25T00:00:00Z,357,364,17532,7,0.00039927,0.020762035,0.020362765,2014,CLX
2015-08-21T00:00:00Z,390,372,17930,-18,-0.001003904,0.020747351,0.021751255,2015,CLX
2016-08-16T00:00:00Z,407,382,18792,-25,-0.001330353,0.020327799,0.021658152,2016,CLX
2017-08-15T00:00:00Z,398,421,19246,23,0.001195054,0.021874675,0.020679622,2017,CLX
2018-08-14T00:00:00Z,440,425,20033,-15,-0.000748765,0.021214995,0.02196376,2018,CLX
2010-02-26T00:00:00Z,1190,1709,77289,519,0.006715056,0.022111814,0.015396758,2010,CME
2011-02-28T00:00:00Z,955,1370,63229,415,0.006563444,0.021667273,0.015103829,2011,CME
2012-02-28T00:00:00Z,991,1408,63376,417,0.006579778,0.022216612,0.015636834,2012,CME
2013-03-01T00:00:00Z,968,1391,62613,423,0.006755786,0.022215834,0.015460048,2013,CME
2014-03-03T00:00:00Z,885,1346,58716,461,0.007851352,0.022923905,0.015072553,2014,CME
2015-02-26T00:00:00Z,865,1338,57222,473,0.008266052,0.023382615,0.015116564,2015,CME
2016-02-26T00:00:00Z,862,1328,55920,466,0.008333333,0.023748212,0.015414878,2016,CME
2017-02-27T00:00:00Z,909,1299,55916,390,0.006974748,0.023231275,0.016256528,2017,CME
2018-03-01T00:00:00Z,884,1275,53579,391,0.007297635,0.023796637,0.016499001,2018,CME
2019-02-28T00:00:00Z,931,1348,55832,417,0.007468835,0.02414386,0.016675025,2019,CME
2010-03-01T00:00:00Z,1382,1583,78848,201,0.002549209,0.020076603,0.017527394,2010,CMS
2011-02-24T00:00:00Z,1247,1501,77082,254,0.003295192,0.019472769,0.016177577,2011,CMS
2012-02-23T00:00:00Z,1201,1423,74263,222,0.002989376,0.019161628,0.016172253,2012,CMS
2013-02-21T00:00:00Z,1151,1392,71442,241,0.003373366,0.019484337,0.016110971,2013,CMS
2014-02-06T00:00:00Z,1131,1345,69377,214,0.003084596,0.019386828,0.016302233,2014,CMS
2015-02-05T00:00:00Z,1055,1297,66768,242,0.003624491,0.019425473,0.015800983,2015,CMS
2016-02-11T00:00:00Z,1024,1333,66017,309,0.004680613,0.020191769,0.015511156,2016,CMS
2017-02-07T00:00:00Z,1086,1366,68411,280,0.004092909,0.019967549,0.01587464,2017,CMS
2018-02-14T00:00:00Z,1142,1417,72732,275,0.003781004,0.019482484,0.015701479,2018,CMS
2019-02-05T00:00:00Z,1096,1408,72015,312,0.004332431,0.019551482,0.015219052,2019,CMS
2010-02-26T00:00:00Z,1315,1984,84325,669,0.00793359,0.023528017,0.015594426,2010,KO
2011-02-28T00:00:00Z,1542,2398,104949,856,0.008156343,0.022849193,0.014692851,2011,KO
2012-02-23T00:00:00Z,1519,2456,105904,937,0.008847636,0.023190814,0.014343179,2012,KO
2013-02-27T00:00:00Z,1602,2555,111802,953,0.008523998,0.022852901,0.014328903,2013,KO
2014-02-27T00:00:00Z,1466,2339,98447,873,0.008867716,0.023758977,0.014891261,2014,KO
2015-02-25T00:00:00Z,1493,2237,97904,744,0.007599281,0.022848913,0.015249632,2015,KO
2016-02-25T00:00:00Z,1591,2297,105649,706,0.006682505,0.021741805,0.0150593,2016,KO
2017-02-24T00:00:00Z,1562,2292,106041,730,0.00688413,0.021614281,0.014730152,2017,KO
2018-02-23T00:00:00Z,1618,2319,104852,701,0.006685614,0.022116889,0.015431275,2018,KO
2019-02-21T00:00:00Z,1713,2398,106677,685,0.006421253,0.022479072,0.016057819,2019,KO
2010-02-25T00:00:00Z,863,1461,56278,598,0.010625822,0.025960411,0.015334589,2010,CTSH
2011-02-23T00:00:00Z,900,1404,55335,504,0.009108159,0.02537273,0.01626457,2011,CTSH
2012-02-27T00:00:00Z,947,1423,56504,476,0.008424182,0.025184058,0.016759875,2012,CTSH
2013-02-26T00:00:00Z,1005,1467,56545,462,0.008170484,0.025943938,0.017773455,2013,CTSH
2014-02-25T00:00:00Z,1040,1402,55790,362,0.006488618,0.025129952,0.018641334,2014,CTSH
2015-02-27T00:00:00Z,1031,1411,57764,380,0.006578492,0.024426979,0.017848487,2015,CTSH
2016-02-25T00:00:00Z,1028,1367,56326,339,0.006018535,0.024269432,0.018250897,2016,CTSH
2017-03-01T00:00:00Z,1322,1492,65253,170,0.002605244,0.022864849,0.020259605,2017,CTSH
2018-02-27T00:00:00Z,1156,1437,61731,281,0.004552008,0.023278418,0.01872641,2018,CTSH
2019-02-19T00:00:00Z,772,1166,52017,394,0.007574447,0.022415749,0.014841302,2019,CTSH
2011-02-24T00:00:00Z,470,854,36251,384,0.010592811,0.023557971,0.01296516,2011,CL
2012-02-23T00:00:00Z,507,877,39643,370,0.0093333,0.022122443,0.012789143,2012,CL
2013-02-21T00:00:00Z,581,1044,44727,463,0.010351689,0.023341606,0.012989917,2013,CL
2014-02-20T00:00:00Z,673,1110,48686,437,0.008975886,0.022799162,0.013823276,2014,CL
2015-02-19T00:00:00Z,680,1133,49482,453,0.009154844,0.022897215,0.013742371,2015,CL
2016-02-18T00:00:00Z,734,1235,52741,501,0.009499251,0.023416317,0.013917066,2016,CL
2017-02-23T00:00:00Z,714,1340,53709,626,0.011655402,0.024949264,0.013293861,2017,CL
2018-02-15T00:00:00Z,713,1336,55362,623,0.011253206,0.024132076,0.01287887,2018,CL
2019-02-21T00:00:00Z,701,1376,53749,675,0.012558373,0.025600476,0.013042103,2019,CL
2010-02-23T00:00:00Z,681,950,51619,269,0.005211259,0.018404076,0.013192817,2010,CMCSA
2011-02-25T00:00:00Z,875,1117,62960,242,0.00384371,0.017741423,0.013897713,2011,CMCSA
2012-02-23T00:00:00Z,898,1275,70730,377,0.005330129,0.018026297,0.012696169,2012,CMCSA
2013-02-21T00:00:00Z,832,1168,67485,336,0.004978884,0.01730755,0.012328666,2013,CMCSA
2014-02-12T00:00:00Z,990,1564,85480,574,0.006715021,0.018296678,0.011581657,2014,CMCSA
2015-02-27T00:00:00Z,931,1547,84308,616,0.007306543,0.018349386,0.011042843,2015,CMCSA
2016-02-05T00:00:00Z,891,1527,82691,636,0.007691284,0.018466339,0.010775054,2016,CMCSA
2017-02-03T00:00:00Z,866,1446,79575,580,0.007288721,0.018171536,0.010882815,2017,CMCSA
2018-01-31T00:00:00Z,870,1528,78804,658,0.00834983,0.019389879,0.011040049,2018,CMCSA
2019-01-31T00:00:00Z,945,1606,85576,661,0.007724128,0.018766944,0.011042816,2019,CMCSA
2010-02-25T00:00:00Z,317,328,19625,11,0.00056051,0.016713376,0.016152866,2010,CMA
2011-02-28T00:00:00Z,399,467,23124,68,0.002940668,0.020195468,0.0172548,2011,CMA
2012-02-21T00:00:00Z,1767,2058,91237,291,0.003189495,0.022556638,0.019367143,2012,CMA
2013-02-19T00:00:00Z,1751,2127,92706,376,0.004055832,0.022943499,0.018887666,2013,CMA
2014-02-14T00:00:00Z,1725,1944,87141,219,0.002513168,0.022308672,0.019795504,2014,CMA
2015-02-17T00:00:00Z,1692,1885,83670,193,0.002306681,0.022528983,0.020222302,2015,CMA
2016-02-26T00:00:00Z,1709,1921,85803,212,0.002470776,0.022388495,0.019917718,2016,CMA
2017-02-15T00:00:00Z,1663,2015,84620,352,0.004159773,0.023812338,0.019652564,2017,CMA
2018-02-15T00:00:00Z,1613,1875,81217,262,0.003225926,0.0230863,0.019860374,2018,CMA
2019-02-12T00:00:00Z,1684,1845,81688,161,0.001970914,0.022585937,0.020615023,2019,CMA
2009-07-24T00:00:00Z,705,1004,46894,299,0.006376082,0.021409988,0.015033906,2009,CAG
2010-07-22T00:00:00Z,726,1012,46041,286,0.006211855,0.021980409,0.015768554,2010,CAG
2011-07-19T00:00:00Z,750,1004,46005,254,0.005521139,0.021823715,0.016302576,2011,CAG
2012-07-20T00:00:00Z,801,1113,50359,312,0.006195516,0.022101313,0.015905796,2012,CAG
2013-07-19T00:00:00Z,951,1292,56988,341,0.005983716,0.02267144,0.016687724,2013,CAG
2014-07-16T00:00:00Z,980,1443,60201,463,0.007690902,0.023969701,0.016278799,2014,CAG
2015-07-17T00:00:00Z,1069,1351,59202,282,0.004763353,0.022820175,0.018056822,2015,CAG
2016-07-15T00:00:00Z,1061,1323,58626,262,0.004469007,0.022566779,0.018097772,2016,CAG
2017-07-21T00:00:00Z,1101,1464,61542,363,0.005898411,0.023788632,0.017890221,2017,CAG
2018-07-20T00:00:00Z,1145,1640,67648,495,0.007317289,0.024243141,0.016925851,2018,CAG
2010-02-26T00:00:00Z,1076,1215,70960,139,0.00195885,0.017122322,0.015163472,2010,CXO
2011-02-25T00:00:00Z,1073,1136,72038,63,0.000874538,0.015769455,0.014894917,2011,CXO
2012-02-24T00:00:00Z,1029,1028,69541,-1,-1.44E-05,0.014782646,0.014797026,2012,CXO
2013-02-22T00:00:00Z,979,981,66443,2,3.01E-05,0.014764535,0.014734434,2013,CXO
2014-02-21T00:00:00Z,1052,1030,68528,-22,-0.000321037,0.015030353,0.015351389,2014,CXO
2015-02-26T00:00:00Z,1136,1081,70416,-55,-0.000781072,0.015351625,0.016132697,2015,CXO
2016-02-25T00:00:00Z,1164,1122,70414,-42,-0.000596472,0.015934331,0.016530804,2016,CXO
2017-02-22T00:00:00Z,1252,1221,72292,-31,-0.000428816,0.016889836,0.017318652,2017,CXO
2018-02-21T00:00:00Z,1237,1307,73851,70,0.000947854,0.017697797,0.016749942,2018,CXO
2019-02-20T00:00:00Z,1273,1387,77010,114,0.001480327,0.018010648,0.016530321,2019,CXO
2011-02-23T00:00:00Z,1030,1618,81097,588,0.007250576,0.019951416,0.01270084,2011,COP
2012-02-21T00:00:00Z,1002,1564,81027,562,0.00693596,0.019302208,0.012366248,2012,COP
2013-02-19T00:00:00Z,1079,1421,76450,342,0.004473512,0.018587312,0.0141138,2013,COP
2014-02-25T00:00:00Z,1071,1462,77575,391,0.005040284,0.018846278,0.013805994,2014,COP
2015-02-24T00:00:00Z,412,535,31839,123,0.003863187,0.016803292,0.012940105,2015,COP
2016-02-23T00:00:00Z,430,548,30994,118,0.003807188,0.017680841,0.013873653,2016,COP
2017-02-21T00:00:00Z,455,587,32765,132,0.004028689,0.017915459,0.013886769,2017,COP
2018-02-20T00:00:00Z,451,619,33820,168,0.004967475,0.018302779,0.013335305,2018,COP
2019-02-19T00:00:00Z,447,610,34584,163,0.004713162,0.017638214,0.012925052,2019,COP
2010-02-22T00:00:00Z,911,1359,77252,448,0.005799203,0.017591778,0.011792575,2010,ED
2011-02-22T00:00:00Z,887,1366,77893,479,0.006149461,0.017536878,0.011387416,2011,ED
2012-02-21T00:00:00Z,864,1327,76004,463,0.006091785,0.017459607,0.011367823,2012,ED
2013-02-21T00:00:00Z,883,1313,78341,430,0.005488824,0.016760062,0.011271237,2013,ED
2014-02-21T00:00:00Z,909,1369,80828,460,0.005691097,0.0169372,0.011246103,2014,ED
2015-02-19T00:00:00Z,913,1355,78374,442,0.005639625,0.017288897,0.011649271,2015,ED
2016-02-18T00:00:00Z,928,1351,75836,423,0.005577826,0.017814758,0.012236932,2016,ED
2017-02-16T00:00:00Z,930,1440,78304,510,0.006513077,0.018389865,0.011876788,2017,ED
2018-02-15T00:00:00Z,940,1483,82791,543,0.006558684,0.017912575,0.011353891,2018,ED
2019-02-21T00:00:00Z,1084,1587,91094,503,0.005521769,0.017421565,0.011899796,2019,ED
2011-04-29T00:00:00Z,954,1612,70812,658,0.00929221,0.022764503,0.013472293,2011,STZ
2012-04-30T00:00:00Z,894,1526,68960,632,0.009164733,0.02212877,0.012964037,2012,STZ
2013-04-29T00:00:00Z,993,1621,73853,628,0.008503378,0.021949007,0.013445628,2013,STZ
2014-04-29T00:00:00Z,808,1395,62798,587,0.009347431,0.022214083,0.012866652,2014,STZ
2015-04-28T00:00:00Z,815,1205,56532,390,0.006898748,0.021315361,0.014416614,2015,STZ
2016-04-25T00:00:00Z,835,1276,59065,441,0.007466351,0.021603318,0.014136968,2016,STZ
2017-04-27T00:00:00Z,814,1246,57872,432,0.00746475,0.021530274,0.014065524,2017,STZ
2018-04-23T00:00:00Z,828,1338,57500,510,0.008869565,0.023269565,0.0144,2018,STZ
2019-04-23T00:00:00Z,911,1457,62752,546,0.008700918,0.023218383,0.014517466,2019,STZ
2009-12-21T00:00:00Z,975,1218,54488,243,0.004459698,0.022353546,0.017893848,2009,COO
2010-12-17T00:00:00Z,855,1198,51681,343,0.006636868,0.023180666,0.016543798,2010,COO
2011-12-16T00:00:00Z,901,1257,52607,356,0.00676716,0.023894159,0.017126998,2011,COO
2012-12-20T00:00:00Z,771,1151,48744,380,0.007795831,0.023613163,0.015817331,2012,COO
2013-12-20T00:00:00Z,784,1104,48463,320,0.006602975,0.022780265,0.01617729,2013,COO
2014-12-19T00:00:00Z,785,1147,51400,362,0.007042802,0.022315175,0.015272374,2014,COO
2015-12-18T00:00:00Z,828,1194,52832,366,0.00692762,0.022599939,0.01567232,2015,COO
2016-12-22T00:00:00Z,871,1259,56642,388,0.006850041,0.022227322,0.015377282,2016,COO
2017-12-22T00:00:00Z,878,1260,55446,382,0.006889586,0.022724813,0.015835227,2017,COO
2018-12-21T00:00:00Z,884,1212,54135,328,0.006058927,0.022388473,0.016329547,2018,COO
2011-09-28T00:00:00Z,712,850,47396,138,0.002911638,0.017934003,0.015022365,2011,CPRT
2012-10-01T00:00:00Z,682,907,48933,225,0.004598124,0.018535549,0.013937425,2012,CPRT
2013-09-30T00:00:00Z,659,878,47177,219,0.004642093,0.018610764,0.013968671,2013,CPRT
2014-09-29T00:00:00Z,786,918,49552,132,0.002663868,0.018525993,0.015862125,2014,CPRT
2015-09-25T00:00:00Z,824,912,50389,88,0.001746413,0.018099188,0.016352775,2015,CPRT
2016-09-28T00:00:00Z,848,1031,54719,183,0.003344359,0.018841719,0.015497359,2016,CPRT
2017-09-28T00:00:00Z,856,1115,56775,259,0.004561867,0.019638926,0.015077059,2017,CPRT
2018-10-01T00:00:00Z,824,1118,56864,294,0.005170231,0.019660945,0.014490715,2018,CPRT
2011-02-10T00:00:00Z,1437,2211,89048,774,0.008691941,0.024829306,0.016137364,2011,GLW
2012-02-13T00:00:00Z,1447,2210,88366,763,0.008634543,0.025009619,0.016375076,2012,GLW
2013-02-13T00:00:00Z,1584,2242,91197,658,0.00721515,0.024584142,0.017368992,2013,GLW
2014-02-10T00:00:00Z,1583,2428,102039,845,0.008281147,0.023794824,0.015513676,2014,GLW
2015-02-13T00:00:00Z,1656,2628,106056,972,0.009164969,0.024779362,0.015614392,2015,GLW
2016-02-12T00:00:00Z,1600,2677,107663,1077,0.010003437,0.024864624,0.014861187,2016,GLW
2017-02-06T00:00:00Z,969,1636,66580,667,0.010018023,0.024571944,0.01455392,2017,GLW
2018-02-15T00:00:00Z,1040,1620,66237,580,0.008756435,0.024457629,0.015701194,2018,GLW
2019-02-12T00:00:00Z,936,1349,58977,413,0.00700273,0.022873323,0.015870594,2019,GLW
2010-10-18T00:00:00Z,632,776,38667,144,0.003724106,0.020068793,0.016344687,2010,COST
2011-10-14T00:00:00Z,606,759,38327,153,0.003991964,0.019803272,0.015811308,2011,COST
2012-10-19T00:00:00Z,514,704,34730,190,0.005470775,0.020270659,0.014799885,2012,COST
2013-10-16T00:00:00Z,511,679,33711,168,0.004983537,0.020141793,0.015158257,2013,COST
2014-10-15T00:00:00Z,489,651,32102,162,0.005046415,0.02027911,0.015232696,2014,COST
2015-10-14T00:00:00Z,491,633,32272,142,0.004400099,0.019614527,0.015214427,2015,COST
2016-10-12T00:00:00Z,509,649,32527,140,0.004304117,0.019952655,0.015648538,2016,COST
2017-10-18T00:00:00Z,548,654,31996,106,0.003312914,0.020440055,0.017127141,2017,COST
2018-10-26T00:00:00Z,563,625,30194,62,0.002053388,0.020699477,0.018646089,2018,COST
2013-09-17T00:00:00Z,1165,2409,95196,1244,0.013067776,0.025305685,0.012237909,2013,COTY
2014-08-28T00:00:00Z,1057,1756,72281,699,0.009670591,0.024294075,0.014623483,2014,COTY
2015-08-17T00:00:00Z,1191,1968,81671,777,0.009513781,0.024096681,0.0145829,2015,COTY
2016-08-18T00:00:00Z,1513,2621,111228,1108,0.00996152,0.02356421,0.01360269,2016,COTY
2017-08-23T00:00:00Z,1257,2110,83996,853,0.010155245,0.025120244,0.014964998,2017,COTY
2018-08-21T00:00:00Z,1289,2307,85967,1018,0.011841753,0.026835879,0.014994126,2018,COTY
2011-02-15T00:00:00Z,868,862,48128,-6,-0.000124668,0.017910572,0.018035239,2011,CCI
2012-02-13T00:00:00Z,884,895,49027,11,0.000224366,0.018255247,0.018030881,2012,CCI
2013-02-12T00:00:00Z,929,952,53009,23,0.000433889,0.017959214,0.017525326,2013,CCI
2014-02-24T00:00:00Z,899,1012,58312,113,0.001937852,0.017354918,0.015417067,2014,CCI
2015-02-19T00:00:00Z,792,923,55576,131,0.002357133,0.016607888,0.014250756,2015,CCI
2016-02-22T00:00:00Z,854,969,54624,115,0.002105302,0.017739455,0.015634153,2016,CCI
2017-02-22T00:00:00Z,849,984,54999,135,0.00245459,0.017891234,0.015436644,2017,CCI
2018-02-26T00:00:00Z,904,1065,59595,161,0.002701569,0.017870627,0.015169058,2018,CCI
2019-02-25T00:00:00Z,815,990,56235,175,0.003111941,0.017604695,0.014492754,2019,CCI
2010-02-19T00:00:00Z,933,980,47831,47,0.000982626,0.020488804,0.019506178,2010,CSX
2011-02-18T00:00:00Z,790,908,44270,118,0.002665462,0.020510504,0.017845042,2011,CSX
2012-02-21T00:00:00Z,772,923,44383,151,0.003402204,0.020796251,0.017394047,2012,CSX
2013-02-19T00:00:00Z,738,962,43593,224,0.00513844,0.022067763,0.016929324,2013,CSX
2014-02-12T00:00:00Z,743,1006,44557,263,0.005902552,0.022577822,0.01667527,2014,CSX
2015-02-11T00:00:00Z,759,981,42874,222,0.005177963,0.022881,0.017703037,2015,CSX
2016-02-10T00:00:00Z,755,1021,42966,266,0.006190942,0.023762975,0.017572034,2016,CSX
2017-02-14T00:00:00Z,806,1093,45710,287,0.006278714,0.023911617,0.017632903,2017,CSX
2018-02-07T00:00:00Z,719,1100,46034,381,0.008276491,0.023895382,0.01561889,2018,CSX
2019-02-06T00:00:00Z,700,1090,45359,390,0.008598073,0.024030512,0.015432439,2019,CSX
2010-02-26T00:00:00Z,931,1407,60809,476,0.007827789,0.023138022,0.015310234,2010,CMI
2011-02-24T00:00:00Z,953,1512,63495,559,0.008803843,0.023812899,0.015009056,2011,CMI
2012-02-21T00:00:00Z,971,1635,65108,664,0.01019844,0.025112121,0.014913682,2012,CMI
2013-02-20T00:00:00Z,995,1526,65158,531,0.008149421,0.023419994,0.015270573,2013,CMI
2014-02-18T00:00:00Z,947,1363,63695,416,0.006531125,0.021398854,0.014867729,2014,CMI
2015-02-17T00:00:00Z,842,1181,56538,339,0.005995967,0.020888606,0.014892639,2015,CMI
2016-02-12T00:00:00Z,882,1235,58484,353,0.006035839,0.021116887,0.015081048,2016,CMI
2017-02-13T00:00:00Z,908,1234,58789,326,0.005545255,0.020990321,0.015445066,2017,CMI
2018-02-14T00:00:00Z,897,1232,62513,335,0.005358885,0.019707901,0.014349015,2018,CMI
2019-02-11T00:00:00Z,925,1249,65031,324,0.004982239,0.019206225,0.014223985,2019,CMI
2010-02-26T00:00:00Z,365,476,26651,111,0.004164947,0.017860493,0.013695546,2010,CVS
2011-02-18T00:00:00Z,424,513,28574,89,0.00311472,0.017953384,0.014838665,2011,CVS
2012-02-17T00:00:00Z,459,533,29461,74,0.002511795,0.018091714,0.015579919,2012,CVS
2013-02-15T00:00:00Z,465,549,29533,84,0.002844276,0.018589375,0.015745099,2013,CVS
2014-02-11T00:00:00Z,380,443,23811,63,0.002645836,0.018604846,0.015959011,2014,CVS
2015-02-10T00:00:00Z,310,441,21257,131,0.006162676,0.020746107,0.014583431,2015,CVS
2016-02-09T00:00:00Z,376,492,24335,116,0.004766797,0.020217793,0.015450997,2016,CVS
2017-02-09T00:00:00Z,422,537,26036,115,0.004416961,0.020625288,0.016208327,2017,CVS
2018-02-14T00:00:00Z,594,718,32496,124,0.003815854,0.022095027,0.018279173,2018,CVS
2019-02-28T00:00:00Z,1158,1393,56228,235,0.004179412,0.024774134,0.020594721,2019,CVS
2009-11-20T00:00:00Z,1147,1352,66792,205,0.00306923,0.020241945,0.017172715,2009,DHI
2010-11-17T00:00:00Z,979,1194,61865,215,0.003475309,0.019300089,0.01582478,2010,DHI
2011-11-17T00:00:00Z,897,1109,57946,212,0.003658579,0.019138508,0.01547993,2011,DHI
2012-11-16T00:00:00Z,810,1059,55779,249,0.004464046,0.01898564,0.014521594,2012,DHI
2013-11-26T00:00:00Z,786,1090,57828,304,0.005256969,0.018849,0.013592032,2013,DHI
2014-11-18T00:00:00Z,781,1116,59021,335,0.005675946,0.018908524,0.013232578,2014,DHI
2015-11-19T00:00:00Z,766,1098,57387,332,0.005785282,0.019133253,0.013347971,2015,DHI
2016-11-18T00:00:00Z,715,1049,53125,334,0.006287059,0.019745882,0.013458824,2016,DHI
2017-11-15T00:00:00Z,713,1093,52523,380,0.007234926,0.020809931,0.013575005,2017,DHI
2018-11-16T00:00:00Z,773,1187,58813,414,0.00703926,0.020182613,0.013143353,2018,DHI
2010-02-24T00:00:00Z,907,1249,57644,342,0.005932968,0.021667476,0.015734508,2010,DHR
2011-02-24T00:00:00Z,927,1316,60853,389,0.006392454,0.021625885,0.015233431,2011,DHR
2012-02-24T00:00:00Z,983,1518,68186,535,0.007846185,0.022262635,0.014416449,2012,DHR
2013-02-22T00:00:00Z,1005,1547,67101,542,0.008077376,0.023054798,0.014977422,2013,DHR
2014-02-21T00:00:00Z,984,1431,63903,447,0.006994977,0.022393315,0.015398338,2014,DHR
2015-02-25T00:00:00Z,976,1526,66630,550,0.00825454,0.022902596,0.014648056,2015,DHR
2016-02-24T00:00:00Z,1013,1631,69587,618,0.008880969,0.023438286,0.014557317,2016,DHR
2017-02-22T00:00:00Z,1074,1563,68227,489,0.007167251,0.022908819,0.015741569,2017,DHR
2018-02-21T00:00:00Z,1137,1617,71736,480,0.006691201,0.022540984,0.015849783,2018,DHR
2019-02-21T00:00:00Z,1196,1706,75053,510,0.006795198,0.022730604,0.015935406,2019,DHR
2010-07-23T00:00:00Z,379,416,19247,37,0.001922378,0.021613758,0.01969138,2010,DRI
2011-07-22T00:00:00Z,435,480,20629,45,0.002181395,0.023268215,0.02108682,2011,DRI
2012-07-20T00:00:00Z,473,615,23907,142,0.005939683,0.025724683,0.019785,2012,DRI
2013-07-19T00:00:00Z,473,599,24469,126,0.005149373,0.024479954,0.019330582,2013,DRI
2014-07-18T00:00:00Z,486,596,25301,110,0.004347654,0.023556381,0.019208727,2014,DRI
2015-07-24T00:00:00Z,474,566,23945,92,0.003842138,0.023637503,0.019795364,2015,DRI
2016-07-25T00:00:00Z,477,533,21742,56,0.00257566,0.024514764,0.021939104,2016,DRI
2017-07-21T00:00:00Z,930,1284,49986,354,0.007081983,0.025687192,0.018605209,2017,DRI
2018-07-20T00:00:00Z,938,1333,51438,395,0.007679148,0.025914693,0.018235546,2018,DRI
2012-02-24T00:00:00Z,1074,1659,73596,585,0.007948802,0.022541986,0.014593184,2012,DVA
2013-03-01T00:00:00Z,1717,2493,106311,776,0.007299339,0.023450066,0.016150728,2013,DVA
2014-02-21T00:00:00Z,1707,2455,105701,748,0.007076565,0.023225892,0.016149327,2014,DVA
2015-02-26T00:00:00Z,1762,2520,107512,758,0.007050376,0.023439244,0.016388868,2015,DVA
2016-02-26T00:00:00Z,1796,2603,107222,807,0.00752644,0.024276734,0.016750294,2016,DVA
2017-02-24T00:00:00Z,1852,2630,107159,778,0.007260239,0.024542969,0.017282729,2017,DVA
2018-02-23T00:00:00Z,1940,2546,102987,606,0.005884238,0.024721567,0.018837329,2018,DVA
2019-02-22T00:00:00Z,2039,2659,107707,620,0.005756358,0.024687346,0.018930989,2019,DVA
2010-12-17T00:00:00Z,635,877,45548,242,0.005313076,0.019254413,0.013941337,2010,DE
2011-12-19T00:00:00Z,671,938,48439,267,0.005512087,0.019364562,0.013852474,2011,DE
2012-12-17T00:00:00Z,706,905,48433,199,0.004108769,0.018685607,0.014576838,2012,DE
2013-12-16T00:00:00Z,710,889,49008,179,0.003652465,0.018139896,0.014487431,2013,DE
2014-12-19T00:00:00Z,762,932,50168,170,0.003388614,0.018577579,0.015188965,2014,DE
2015-12-18T00:00:00Z,757,947,50193,190,0.003785388,0.018867173,0.015081784,2015,DE
2016-12-19T00:00:00Z,845,1032,52633,187,0.003552904,0.019607471,0.016054567,2016,DE
2017-12-18T00:00:00Z,844,1078,53654,234,0.004361278,0.020091699,0.015730421,2017,DE
2018-12-17T00:00:00Z,837,1122,56424,285,0.005051042,0.019885155,0.014834113,2018,DE
2012-02-10T00:00:00Z,856,954,48130,98,0.002036152,0.019821317,0.017785165,2012,DAL
2013-02-13T00:00:00Z,880,1033,50835,153,0.003009737,0.020320645,0.017310908,2013,DAL
2014-02-24T00:00:00Z,842,1038,50742,196,0.003862678,0.020456427,0.016593749,2014,DAL
2015-02-11T00:00:00Z,811,1071,49972,260,0.005202914,0.021432002,0.016229088,2015,DAL
2016-02-05T00:00:00Z,875,1112,51764,237,0.004578472,0.021482111,0.01690364,2016,DAL
2017-02-13T00:00:00Z,817,1087,51691,270,0.005223346,0.021028806,0.015805459,2017,DAL
2018-02-23T00:00:00Z,783,1091,50887,308,0.006052626,0.02143966,0.015387034,2018,DAL
2019-02-15T00:00:00Z,802,1235,54534,433,0.007940001,0.022646422,0.014706422,2019,DAL
2010-02-22T00:00:00Z,613,1208,45603,595,0.013047387,0.026489485,0.013442098,2010,XRAY
2011-02-18T00:00:00Z,646,1220,46119,574,0.012446063,0.026453306,0.014007242,2011,XRAY
2012-02-24T00:00:00Z,750,1315,52516,565,0.010758626,0.025039988,0.014281362,2012,XRAY
2013-02-20T00:00:00Z,679,1292,48860,613,0.01254605,0.026442898,0.013896848,2013,XRAY
2014-02-20T00:00:00Z,754,1363,51742,609,0.011769935,0.026342236,0.014572301,2014,XRAY
2015-02-20T00:00:00Z,773,1401,52745,628,0.011906342,0.026561759,0.014655418,2015,XRAY
2016-02-12T00:00:00Z,868,1524,58390,656,0.0112348,0.02610036,0.014865559,2016,XRAY
2017-03-01T00:00:00Z,954,1750,66641,796,0.011944599,0.02626011,0.014315511,2017,XRAY
2018-03-15T00:00:00Z,1105,1900,73091,795,0.010876852,0.025994993,0.01511814,2018,XRAY
2019-03-08T00:00:00Z,1098,1839,71650,741,0.01034194,0.025666434,0.015324494,2019,XRAY
2011-02-25T00:00:00Z,867,1137,64173,270,0.004207377,0.017717732,0.013510355,2011,DVN
2012-02-24T00:00:00Z,605,839,46205,234,0.005064387,0.018158208,0.013093821,2012,DVN
2013-02-21T00:00:00Z,633,815,46362,182,0.003925629,0.017579052,0.013653423,2013,DVN
2014-02-28T00:00:00Z,670,865,48024,195,0.00406047,0.018011827,0.013951358,2014,DVN
2015-02-20T00:00:00Z,737,1033,53035,296,0.00558122,0.019477703,0.013896483,2015,DVN
2016-02-17T00:00:00Z,809,1083,54862,274,0.004994349,0.01974044,0.01474609,2016,DVN
2017-02-15T00:00:00Z,859,1279,60870,420,0.006899951,0.021011993,0.014112042,2017,DVN
2018-02-21T00:00:00Z,849,1242,57313,393,0.006857083,0.021670476,0.014813393,2018,DVN
2019-02-20T00:00:00Z,652,900,46033,248,0.005387439,0.019551192,0.014163752,2019,DVN
2013-03-01T00:00:00Z,1150,1227,69400,77,0.00110951,0.017680115,0.016570605,2013,FANG
2014-02-19T00:00:00Z,1325,1341,75147,16,0.000212916,0.017845024,0.017632108,2014,FANG
2015-02-20T00:00:00Z,1486,1437,80454,-49,-0.000609044,0.017861138,0.018470182,2015,FANG
2016-02-19T00:00:00Z,1498,1387,80392,-111,-0.001380734,0.01725296,0.018633695,2016,FANG
2017-02-15T00:00:00Z,1675,1588,87618,-87,-0.000992947,0.01812413,0.019117076,2017,FANG
2018-02-15T00:00:00Z,1581,1454,83032,-127,-0.001529531,0.017511321,0.019040852,2018,FANG
2019-02-25T00:00:00Z,1673,1739,95431,66,0.000691599,0.01822259,0.017530991,2019,FANG
2013-02-28T00:00:00Z,1246,2637,98249,1391,0.014157905,0.026839968,0.012682063,2013,DLR
2014-03-03T00:00:00Z,1271,2677,101724,1406,0.013821714,0.026316307,0.012494593,2014,DLR
2015-03-02T00:00:00Z,1328,2885,105549,1557,0.014751442,0.027333276,0.012581834,2015,DLR
2016-02-29T00:00:00Z,1341,3042,108283,1701,0.015708837,0.028093052,0.012384215,2016,DLR
2017-03-01T00:00:00Z,1372,2988,107923,1616,0.014973639,0.027686406,0.012712767,2017,DLR
2018-03-01T00:00:00Z,1401,2902,101101,1501,0.01484654,0.028703969,0.01385743,2018,DLR
2019-02-25T00:00:00Z,1410,3005,104742,1595,0.015227893,0.028689542,0.013461649,2019,DLR
2011-01-26T00:00:00Z,1861,2165,95150,304,0.003194955,0.022753547,0.019558592,2011,DFS
2012-01-26T00:00:00Z,2013,2239,99737,226,0.002265959,0.022449041,0.020183082,2012,DFS
2013-01-25T00:00:00Z,2065,2272,103116,207,0.002007448,0.022033438,0.02002599,2013,DFS
2014-02-25T00:00:00Z,2116,2257,106145,141,0.001328372,0.021263366,0.019934995,2014,DFS
2015-02-25T00:00:00Z,1940,2089,97010,149,0.001535924,0.021533862,0.019997938,2015,DFS
2016-02-24T00:00:00Z,2056,2020,93805,-36,-0.000383775,0.021534033,0.021917808,2016,DFS
2017-02-23T00:00:00Z,2114,1998,92904,-116,-0.001248601,0.021506071,0.022754671,2017,DFS
2018-02-21T00:00:00Z,2014,1965,90635,-49,-0.00054063,0.021680366,0.022220996,2018,DFS
2019-02-20T00:00:00Z,1885,1849,84949,-36,-0.000423784,0.021766001,0.022189784,2019,DFS
2011-02-18T00:00:00Z,766,1645,68104,879,0.012906731,0.024154235,0.011247504,2011,DISCA
2012-02-17T00:00:00Z,665,1457,61766,792,0.012822588,0.02358903,0.010766441,2012,DISCA
2013-02-14T00:00:00Z,593,1212,52971,619,0.011685639,0.022880444,0.011194805,2013,DISCA
2014-02-20T00:00:00Z,602,1349,57759,747,0.012933049,0.023355668,0.010422618,2014,DISCA
2015-02-19T00:00:00Z,707,1437,65197,730,0.011196834,0.022040891,0.010844057,2015,DISCA
2016-02-18T00:00:00Z,771,1572,68757,801,0.011649723,0.022863127,0.011213404,2016,DISCA
2017-02-14T00:00:00Z,830,1596,71141,766,0.010767349,0.022434321,0.011666971,2017,DISCA
2018-02-28T00:00:00Z,1055,1965,85211,910,0.010679372,0.023060403,0.012381031,2018,DISCA
2019-03-01T00:00:00Z,1089,2070,88451,981,0.011090886,0.023402788,0.012311902,2019,DISCA
2011-02-18T00:00:00Z,766,1645,68104,879,0.012906731,0.024154235,0.011247504,2011,DISCK
2012-02-17T00:00:00Z,665,1457,61766,792,0.012822588,0.02358903,0.010766441,2012,DISCK
2013-02-14T00:00:00Z,593,1212,52971,619,0.011685639,0.022880444,0.011194805,2013,DISCK
2014-02-20T00:00:00Z,602,1349,57759,747,0.012933049,0.023355668,0.010422618,2014,DISCK
2015-02-19T00:00:00Z,707,1437,65197,730,0.011196834,0.022040891,0.010844057,2015,DISCK
2016-02-18T00:00:00Z,771,1572,68757,801,0.011649723,0.022863127,0.011213404,2016,DISCK
2017-02-14T00:00:00Z,830,1596,71141,766,0.010767349,0.022434321,0.011666971,2017,DISCK
2018-02-28T00:00:00Z,1055,1965,85211,910,0.010679372,0.023060403,0.012381031,2018,DISCK
2019-03-01T00:00:00Z,1089,2070,88451,981,0.011090886,0.023402788,0.012311902,2019,DISCK
2012-02-23T00:00:00Z,1623,1774,88481,151,0.001706581,0.020049502,0.018342921,2012,DISH
2013-02-20T00:00:00Z,1904,2026,105734,122,0.001153839,0.019161292,0.018007453,2013,DISH
2014-02-21T00:00:00Z,2174,1919,111510,-255,-0.00228679,0.017209219,0.019496009,2014,DISH
2015-02-23T00:00:00Z,1976,1959,111299,-17,-0.000152742,0.017601236,0.017753978,2015,DISH
2016-02-18T00:00:00Z,1993,2022,110095,29,0.000263409,0.018365957,0.018102548,2016,DISH
2017-02-22T00:00:00Z,1977,2199,122441,222,0.001813118,0.01795967,0.016146552,2017,DISH
2018-02-21T00:00:00Z,2025,2172,119625,147,0.00122884,0.01815674,0.0169279,2018,DISH
2019-02-13T00:00:00Z,2007,2250,123697,243,0.001964478,0.018189608,0.016225131,2019,DISH
2010-03-31T00:00:00Z,902,1281,64944,379,0.005835797,0.019724686,0.013888889,2010,DG
2011-03-22T00:00:00Z,857,1199,57527,342,0.005945035,0.020842387,0.014897353,2011,DG
2012-03-22T00:00:00Z,845,1202,57701,357,0.006187068,0.020831528,0.01464446,2012,DG
2013-03-25T00:00:00Z,799,1157,55226,358,0.006482454,0.020950277,0.014467823,2013,DG
2014-03-20T00:00:00Z,786,1069,48731,283,0.005807392,0.021936755,0.016129363,2014,DG
2015-03-20T00:00:00Z,859,1125,50820,266,0.00523416,0.022136954,0.016902794,2015,DG
2016-03-22T00:00:00Z,696,1038,44296,342,0.007720787,0.023433267,0.01571248,2016,DG
2017-03-24T00:00:00Z,644,1032,43680,388,0.008882784,0.023626374,0.01474359,2017,DG
2018-03-23T00:00:00Z,668,1093,46265,425,0.00918621,0.02362477,0.01443856,2018,DG
2019-03-22T00:00:00Z,639,1047,43358,408,0.009410028,0.024147793,0.014737765,2019,DG
2012-03-15T00:00:00Z,324,521,29828,197,0.006604533,0.01746681,0.010862277,2012,DLTR
2013-03-15T00:00:00Z,342,550,30936,208,0.006723558,0.01777864,0.011055081,2013,DLTR
2014-03-14T00:00:00Z,342,513,29902,171,0.005718681,0.017156043,0.011437362,2014,DLTR
2015-03-13T00:00:00Z,477,709,38193,232,0.006074412,0.018563611,0.0124892,2015,DLTR
2016-03-28T00:00:00Z,525,836,44029,311,0.007063526,0.018987486,0.011923959,2016,DLTR
2017-03-28T00:00:00Z,599,917,49764,318,0.006390162,0.018426975,0.012036814,2017,DLTR
2018-03-16T00:00:00Z,603,939,49025,336,0.006853646,0.019153493,0.012299847,2018,DLTR
2019-03-27T00:00:00Z,633,908,42438,275,0.006480041,0.021395919,0.014915877,2019,DLTR
2010-02-26T00:00:00Z,1446,2854,129619,1408,0.010862605,0.022018377,0.011155772,2010,D
2011-02-28T00:00:00Z,1460,2720,124013,1260,0.010160225,0.021933184,0.011772959,2011,D
2012-02-28T00:00:00Z,1479,2735,125696,1256,0.009992363,0.021758847,0.011766484,2012,D
2013-02-28T00:00:00Z,1561,2747,128986,1186,0.009194796,0.021296885,0.012102089,2013,D
2014-02-28T00:00:00Z,1620,2676,128140,1056,0.008240986,0.020883409,0.012642422,2014,D
2015-02-27T00:00:00Z,1525,2252,116796,727,0.006224528,0.019281482,0.013056954,2015,D
2016-02-26T00:00:00Z,1536,2357,122385,821,0.006708338,0.019258896,0.012550558,2016,D
2017-02-28T00:00:00Z,1499,2341,122542,842,0.006871114,0.019103654,0.012232541,2017,D
2018-02-27T00:00:00Z,1633,2636,130970,1003,0.007658242,0.020126747,0.012468504,2018,D
2019-02-28T00:00:00Z,1836,2916,144697,1080,0.007463873,0.020152457,0.012688584,2019,D
2011-02-11T00:00:00Z,600,1052,43851,452,0.010307633,0.023990331,0.013682698,2011,DOV
2012-02-10T00:00:00Z,585,1113,43921,528,0.012021584,0.025340953,0.013319369,2012,DOV
2013-02-15T00:00:00Z,656,1203,47707,547,0.011465823,0.025216425,0.013750603,2013,DOV
2014-02-14T00:00:00Z,713,1369,52066,656,0.012599393,0.02629355,0.013694157,2014,DOV
2015-02-13T00:00:00Z,727,1327,50754,600,0.011821728,0.026145723,0.014323994,2015,DOV
2016-02-12T00:00:00Z,810,1380,51289,570,0.011113494,0.026906354,0.01579286,2016,DOV
2017-02-10T00:00:00Z,819,1367,52069,548,0.010524496,0.026253625,0.015729129,2017,DOV
2018-02-09T00:00:00Z,745,1462,53537,717,0.013392607,0.027308217,0.01391561,2018,DOV
2019-02-15T00:00:00Z,713,1551,59027,838,0.014196893,0.026276111,0.012079218,2019,DOV
2018-02-15T00:00:00Z,1469,3023,113751,1554,0.013661418,0.026575591,0.012914172,2018,DWDP
2019-02-11T00:00:00Z,1531,3131,119834,1600,0.013351803,0.02612781,0.012776007,2019,DWDP
2010-02-23T00:00:00Z,1093,1721,72670,628,0.008641805,0.0236824,0.015040594,2010,DTE
2011-02-18T00:00:00Z,1081,1652,72771,571,0.007846532,0.022701351,0.014854819,2011,DTE
2012-02-16T00:00:00Z,971,1518,66608,547,0.008212227,0.022790055,0.014577828,2012,DTE
2013-02-20T00:00:00Z,886,1374,62209,488,0.007844524,0.022086836,0.014242312,2013,DTE
2014-02-14T00:00:00Z,923,1386,62451,463,0.007413812,0.0221934,0.014779587,2014,DTE
2015-02-13T00:00:00Z,876,1308,59387,432,0.007274319,0.022025022,0.014750703,2015,DTE
2016-02-10T00:00:00Z,979,1539,71559,560,0.00782571,0.021506729,0.013681018,2016,DTE
2017-02-09T00:00:00Z,1019,1588,75054,569,0.007581208,0.0211581,0.013576891,2017,DTE
2018-02-16T00:00:00Z,975,1530,74279,555,0.007471829,0.020598016,0.013126186,2018,DTE
2019-02-07T00:00:00Z,1003,1557,76574,554,0.007234832,0.020333272,0.013098441,2019,DTE
2010-03-01T00:00:00Z,682,949,56770,267,0.004703188,0.016716576,0.012013387,2010,DRE
2011-02-25T00:00:00Z,716,1013,61467,297,0.004831861,0.016480388,0.011648527,2011,DRE
2012-02-24T00:00:00Z,629,907,53912,278,0.005156551,0.016823713,0.011667161,2012,DRE
2013-02-22T00:00:00Z,829,1064,60931,235,0.003856822,0.017462375,0.013605554,2013,DRE
2014-02-21T00:00:00Z,829,1010,60474,181,0.002993022,0.016701392,0.013708371,2014,DRE
2015-02-20T00:00:00Z,819,1000,61348,181,0.002950381,0.01630045,0.013350068,2015,DRE
2016-02-19T00:00:00Z,788,1010,60066,222,0.003695934,0.016814837,0.013118903,2016,DRE
2017-02-17T00:00:00Z,796,1072,61216,276,0.004508625,0.017511762,0.013003136,2017,DRE
2018-02-16T00:00:00Z,820,1083,62186,263,0.004229248,0.017415495,0.013186248,2018,DRE
2019-02-22T00:00:00Z,845,1058,60906,213,0.003497192,0.017371031,0.013873838,2019,DRE
2012-02-28T00:00:00Z,2064,3878,171243,1814,0.010593134,0.022646181,0.012053047,2012,DUK
2013-03-01T00:00:00Z,2511,6140,196859,3629,0.018434514,0.031189836,0.012755322,2013,DUK
2014-02-28T00:00:00Z,1818,3613,140812,1795,0.012747493,0.025658325,0.012910831,2014,DUK
2015-03-02T00:00:00Z,2019,3652,145875,1633,0.011194516,0.025035133,0.013840617,2015,DUK
2016-02-25T00:00:00Z,1986,3614,147197,1628,0.011060008,0.024552131,0.013492123,2016,DUK
2017-02-24T00:00:00Z,1973,3679,149327,1706,0.011424592,0.024637206,0.013212614,2017,DUK
2018-02-21T00:00:00Z,2037,3741,160852,1704,0.010593589,0.023257404,0.012663815,2018,DUK
2019-02-28T00:00:00Z,2042,3538,154756,1496,0.00966683,0.022861795,0.013194965,2019,DUK
2018-05-29T00:00:00Z,1224,1596,72675,372,0.005118679,0.021960784,0.016842105,2018,DXC
2011-02-22T00:00:00Z,2125,1929,85862,-196,-0.002282733,0.022466283,0.024749016,2011,ETFC
2012-02-23T00:00:00Z,1927,1865,83889,-62,-0.000739072,0.022231759,0.022970831,2012,ETFC
2013-02-26T00:00:00Z,2122,1961,90483,-161,-0.00177934,0.021672579,0.023451919,2013,ETFC
2014-02-25T00:00:00Z,2100,2058,92196,-42,-0.000455551,0.02232201,0.022777561,2014,ETFC
2015-02-24T00:00:00Z,2153,1988,89614,-165,-0.00184123,0.022184034,0.024025264,2015,ETFC
2016-02-24T00:00:00Z,1908,1903,82538,-5,-6.06E-05,0.023056047,0.023116625,2016,ETFC
2017-02-22T00:00:00Z,1710,1710,74679,0,0,0.022898003,0.022898003,2017,ETFC
2018-02-21T00:00:00Z,1470,1603,66615,133,0.001996547,0.024063649,0.022067102,2018,ETFC
2019-02-20T00:00:00Z,1393,1712,70064,319,0.00455298,0.024434802,0.019881822,2019,ETFC
2011-02-23T00:00:00Z,672,1232,54851,560,0.010209477,0.022460848,0.012251372,2011,EMN
2012-02-22T00:00:00Z,694,1381,58144,687,0.011815493,0.023751376,0.011935883,2012,EMN
2013-02-28T00:00:00Z,817,1856,76129,1039,0.013647887,0.024379671,0.010731784,2013,EMN
2014-02-28T00:00:00Z,714,1688,68970,974,0.014122082,0.024474409,0.010352327,2014,EMN
2015-02-27T00:00:00Z,748,1748,71689,1000,0.013949141,0.024383099,0.010433958,2015,EMN
2016-02-25T00:00:00Z,746,1703,66897,957,0.014305574,0.025457046,0.011151472,2016,EMN
2017-02-27T00:00:00Z,805,1650,64215,845,0.013158919,0.025694931,0.012536012,2017,EMN
2018-03-01T00:00:00Z,790,1679,60495,889,0.014695429,0.02775436,0.01305893,2018,EMN
2019-02-27T00:00:00Z,774,1594,59683,820,0.013739256,0.026707773,0.012968517,2019,EMN
2013-02-28T00:00:00Z,464,810,37388,346,0.009254306,0.021664705,0.012410399,2013,ETN
2014-02-26T00:00:00Z,491,823,38397,332,0.008646509,0.021433966,0.012787457,2014,ETN
2015-02-26T00:00:00Z,444,865,38236,421,0.011010566,0.022622659,0.011612093,2015,ETN
2016-02-24T00:00:00Z,465,852,35849,387,0.01079528,0.023766353,0.012971073,2016,ETN
2017-02-22T00:00:00Z,496,905,37466,409,0.010916564,0.024155234,0.01323867,2017,ETN
2018-02-28T00:00:00Z,474,882,39396,408,0.010356381,0.02238806,0.012031678,2018,ETN
2019-02-27T00:00:00Z,470,903,39598,433,0.010934896,0.022804182,0.011869286,2019,ETN
2011-01-28T00:00:00Z,1529,1520,70816,-9,-0.00012709,0.021464076,0.021591166,2011,EBAY
2012-01-31T00:00:00Z,1670,1522,76103,-148,-0.001944733,0.019999212,0.021943944,2012,EBAY
2013-02-01T00:00:00Z,1822,1645,80900,-177,-0.002187886,0.020333745,0.022521632,2013,EBAY
2014-01-31T00:00:00Z,1887,1730,85901,-157,-0.001827685,0.020139463,0.021967148,2014,EBAY
2015-02-06T00:00:00Z,1562,1507,73516,-55,-0.000748136,0.020498939,0.021247075,2015,EBAY
2016-02-01T00:00:00Z,1338,1184,57100,-154,-0.002697023,0.020735552,0.023432574,2016,EBAY
2017-02-06T00:00:00Z,1272,1207,55828,-65,-0.00116429,0.021619976,0.022784266,2017,EBAY
2018-02-05T00:00:00Z,1214,1227,56441,13,0.000230329,0.021739516,0.021509187,2018,EBAY
2019-01-30T00:00:00Z,1189,1337,58373,148,0.002535419,0.022904425,0.020369006,2019,EBAY
2011-02-25T00:00:00Z,210,289,17376,79,0.004546501,0.016632136,0.012085635,2011,ECL
2012-02-28T00:00:00Z,387,529,25935,142,0.005475227,0.020397147,0.01492192,2012,ECL
2013-02-26T00:00:00Z,390,515,26212,125,0.004768808,0.01964749,0.014878682,2013,ECL
2014-02-28T00:00:00Z,365,478,24232,113,0.004663255,0.019725982,0.015062727,2014,ECL
2015-02-27T00:00:00Z,351,460,24163,109,0.004511029,0.019037371,0.014526342,2015,ECL
2016-02-26T00:00:00Z,950,1645,67004,695,0.010372515,0.024550773,0.014178258,2016,ECL
2017-02-24T00:00:00Z,924,1564,65380,640,0.009788926,0.023921689,0.014132762,2017,ECL
2018-02-23T00:00:00Z,909,1497,62798,588,0.009363356,0.023838339,0.014474983,2018,ECL
2019-03-01T00:00:00Z,910,1561,63801,651,0.010203602,0.024466701,0.014263099,2019,ECL
2010-03-01T00:00:00Z,1677,2199,106913,522,0.004882475,0.020568125,0.015685651,2010,EIX
2011-02-28T00:00:00Z,1476,1842,93824,366,0.003900921,0.019632503,0.015731583,2011,EIX
2012-02-29T00:00:00Z,1553,1861,93938,308,0.003278758,0.019810939,0.016532181,2012,EIX
2013-02-26T00:00:00Z,1125,1514,73545,389,0.005289279,0.020586036,0.015296757,2013,EIX
2014-02-25T00:00:00Z,1114,1457,73207,343,0.004685344,0.019902468,0.015217124,2014,EIX
2015-02-24T00:00:00Z,1083,1437,69247,354,0.005112135,0.020751802,0.015639667,2015,EIX
2016-02-23T00:00:00Z,1034,1421,68151,387,0.005678567,0.020850758,0.015172191,2016,EIX
2017-02-21T00:00:00Z,1034,1442,66626,408,0.006123735,0.021643202,0.015519467,2017,EIX
2018-02-22T00:00:00Z,1219,1550,72110,331,0.004590209,0.021494938,0.016904729,2018,EIX
2019-02-28T00:00:00Z,1390,1734,78935,344,0.004358016,0.021967442,0.017609425,2019,EIX
2010-02-26T00:00:00Z,864,1234,48707,370,0.007596444,0.025335167,0.017738723,2010,EW
2011-02-28T00:00:00Z,848,1088,45494,240,0.005275421,0.023915242,0.018639821,2011,EW
2012-02-27T00:00:00Z,867,1086,45670,219,0.00479527,0.023779286,0.018984016,2012,EW
2013-02-28T00:00:00Z,810,1033,44735,223,0.004984911,0.023091539,0.018106628,2013,EW
2014-02-28T00:00:00Z,876,1013,43928,137,0.00311874,0.023060463,0.019941723,2014,EW
2015-02-20T00:00:00Z,866,1056,43954,190,0.004322701,0.024025117,0.019702416,2015,EW
2016-02-19T00:00:00Z,863,1068,43615,205,0.004700218,0.024486988,0.019786771,2016,EW
2017-02-17T00:00:00Z,877,1107,44768,230,0.005137598,0.024727484,0.019589886,2017,EW
2018-02-16T00:00:00Z,913,1213,49192,300,0.006098553,0.024658481,0.018559928,2018,EW
2019-02-15T00:00:00Z,914,1225,48469,311,0.006416472,0.025273886,0.018857414,2019,EW
2011-05-24T00:00:00Z,978,1266,59769,288,0.004818551,0.021181549,0.016362998,2011,EA
2012-05-25T00:00:00Z,1021,1372,65188,351,0.005384427,0.021046818,0.015662392,2012,EA
2013-05-22T00:00:00Z,918,1211,60453,293,0.00484674,0.020032091,0.015185351,2013,EA
2014-05-21T00:00:00Z,949,1150,58383,201,0.003442783,0.019697515,0.016254732,2014,EA
2015-05-21T00:00:00Z,911,1073,53697,162,0.003016928,0.019982494,0.016965566,2015,EA
2016-05-27T00:00:00Z,906,1004,51287,98,0.001910816,0.019576111,0.017665295,2016,EA
2017-05-24T00:00:00Z,819,908,47721,89,0.001865007,0.019027263,0.017162256,2017,EA
2018-05-23T00:00:00Z,879,1006,50326,127,0.002523546,0.019989667,0.017466121,2018,EA
2019-05-24T00:00:00Z,839,1054,49759,215,0.004320826,0.021182098,0.016861271,2019,EA
2009-11-23T00:00:00Z,121,193,10789,72,0.006673464,0.01788859,0.011215127,2009,EMR
2010-11-23T00:00:00Z,118,194,10727,76,0.007084926,0.018085206,0.01100028,2010,EMR
2011-11-22T00:00:00Z,123,210,11020,87,0.007894737,0.019056261,0.011161525,2011,EMR
2012-11-20T00:00:00Z,130,225,11423,95,0.008316554,0.019697102,0.011380548,2012,EMR
2013-11-19T00:00:00Z,125,236,11670,111,0.009511568,0.020222793,0.010711225,2013,EMR
2014-11-19T00:00:00Z,134,223,11156,89,0.00797777,0.019989243,0.012011474,2014,EMR
2015-11-18T00:00:00Z,145,264,11731,119,0.010144063,0.022504475,0.012360413,2015,EMR
2016-11-16T00:00:00Z,483,758,34592,275,0.007949815,0.021912581,0.013962766,2016,EMR
2017-11-20T00:00:00Z,490,777,33807,287,0.008489366,0.022983406,0.01449404,2017,EMR
2018-11-19T00:00:00Z,493,815,34557,322,0.009317938,0.023584223,0.014266285,2018,EMR
2011-02-28T00:00:00Z,3053,5090,246436,2037,0.008265838,0.02065445,0.012388612,2011,ETR
2012-02-28T00:00:00Z,3064,5131,252448,2067,0.008187825,0.020324978,0.012137153,2012,ETR
2013-02-27T00:00:00Z,3288,5483,268587,2195,0.008172399,0.020414242,0.012241843,2013,ETR
2014-02-27T00:00:00Z,3238,5349,262750,2111,0.008034253,0.020357755,0.012323501,2014,ETR
2015-02-26T00:00:00Z,3162,5183,265752,2021,0.007604835,0.019503146,0.011898311,2015,ETR
2016-02-26T00:00:00Z,3156,5302,263472,2146,0.008145078,0.02012358,0.011978502,2016,ETR
2017-02-24T00:00:00Z,3169,5670,262755,2501,0.009518373,0.021579038,0.012060665,2017,ETR
2018-02-26T00:00:00Z,3136,5572,258970,2436,0.009406495,0.021516006,0.012109511,2018,ETR
2019-02-26T00:00:00Z,3118,5417,255944,2299,0.008982434,0.021164786,0.012182352,2019,ETR
2010-02-25T00:00:00Z,725,912,49819,187,0.003753588,0.018306269,0.014552681,2010,EOG
2011-02-24T00:00:00Z,939,1015,58999,76,0.001288157,0.017203681,0.015915524,2011,EOG
2012-02-24T00:00:00Z,967,959,56982,-8,-0.000140395,0.016829876,0.016970271,2012,EOG
2013-02-22T00:00:00Z,1000,998,57088,-2,-3.50E-05,0.017481783,0.017516816,2013,EOG
2014-02-24T00:00:00Z,264,235,16993,-29,-0.001706585,0.013829224,0.015535809,2014,EOG
2015-02-18T00:00:00Z,1018,913,53081,-105,-0.001978109,0.017200128,0.019178237,2015,EOG
2016-02-25T00:00:00Z,1055,928,53109,-127,-0.002391308,0.017473498,0.019864806,2016,EOG
2017-02-27T00:00:00Z,1089,987,57321,-102,-0.001779453,0.01721882,0.018998273,2017,EOG
2018-02-27T00:00:00Z,1114,1053,59736,-61,-0.00102116,0.017627561,0.018648721,2018,EOG
2019-02-26T00:00:00Z,1095,981,57923,-114,-0.00196813,0.016936277,0.018904408,2019,EOG
2011-02-23T00:00:00Z,785,1377,57018,592,0.010382686,0.024150268,0.013767582,2011,EFX
2012-02-23T00:00:00Z,742,1374,56011,632,0.011283498,0.024530896,0.013247398,2012,EFX
2013-02-22T00:00:00Z,728,1362,56579,634,0.011205571,0.024072536,0.012866965,2013,EFX
2014-02-28T00:00:00Z,801,1425,59624,624,0.010465584,0.023899772,0.013434188,2014,EFX
2015-02-25T00:00:00Z,782,1436,58609,654,0.011158696,0.024501356,0.013342661,2015,EFX
2016-02-24T00:00:00Z,818,1426,58091,608,0.010466337,0.024547692,0.014081355,2016,EFX
2017-02-22T00:00:00Z,837,1450,59033,613,0.010384022,0.024562533,0.01417851,2017,EFX
2018-03-01T00:00:00Z,1072,1799,71123,727,0.010221729,0.025294209,0.01507248,2018,EFX
2019-02-21T00:00:00Z,1187,1894,73672,707,0.00959659,0.025708546,0.016111956,2019,EFX
2010-02-22T00:00:00Z,1222,1486,75829,264,0.003481518,0.019596724,0.016115207,2010,EQIX
2011-02-25T00:00:00Z,1192,1496,74446,304,0.004083497,0.020095102,0.016011606,2011,EQIX
2012-02-24T00:00:00Z,1274,1665,78456,391,0.004983685,0.021222086,0.016238401,2012,EQIX
2013-02-26T00:00:00Z,1275,1765,82636,490,0.005929619,0.02135873,0.015429111,2013,EQIX
2014-02-28T00:00:00Z,1349,1873,90047,524,0.005819183,0.020800249,0.014981065,2014,EQIX
2015-03-02T00:00:00Z,1299,1723,81697,424,0.005189909,0.021090126,0.015900217,2015,EQIX
2016-02-26T00:00:00Z,1394,1902,88558,508,0.005736354,0.02147745,0.015741096,2016,EQIX
2017-02-27T00:00:00Z,1486,2007,92194,521,0.005651127,0.021769313,0.016118186,2017,EQIX
2018-02-26T00:00:00Z,1450,1856,90845,406,0.004469151,0.020430403,0.015961253,2018,EQIX
2019-02-22T00:00:00Z,1429,1754,84940,325,0.00382623,0.02064987,0.01682364,2019,EQIX
2010-02-25T00:00:00Z,902,1375,67581,473,0.006999009,0.020345955,0.013346947,2010,EQR
2011-02-24T00:00:00Z,963,1439,70218,476,0.006778889,0.020493321,0.013714432,2011,EQR
2012-02-24T00:00:00Z,1309,1612,79791,303,0.003797421,0.02020278,0.016405359,2012,EQR
2013-02-21T00:00:00Z,1396,1684,83564,288,0.00344646,0.020152219,0.016705758,2013,EQR
2014-02-27T00:00:00Z,1403,1783,87369,380,0.004349369,0.020407696,0.016058327,2014,EQR
2015-02-26T00:00:00Z,1390,1725,84741,335,0.003953222,0.020356144,0.016402922,2015,EQR
2016-02-25T00:00:00Z,1436,1800,86606,364,0.004202942,0.020783779,0.016580837,2016,EQR
2017-02-23T00:00:00Z,1416,1816,84536,400,0.004731712,0.021481972,0.01675026,2017,EQR
2018-02-22T00:00:00Z,1420,1712,78265,292,0.003730914,0.021874401,0.018143487,2018,EQR
2019-02-21T00:00:00Z,1296,1643,74020,347,0.004687922,0.022196704,0.017508781,2019,EQR
2011-02-25T00:00:00Z,651,820,48001,169,0.00352076,0.017082977,0.013562217,2011,ESS
2012-02-27T00:00:00Z,680,855,50091,175,0.003493642,0.017068935,0.013575293,2012,ESS
2013-02-25T00:00:00Z,703,884,51742,181,0.003498125,0.017084767,0.013586641,2013,ESS
2014-02-26T00:00:00Z,807,1127,60030,320,0.005330668,0.018773946,0.013443278,2014,ESS
2015-03-02T00:00:00Z,838,1131,62533,293,0.004685526,0.01808645,0.013400924,2015,ESS
2016-02-26T00:00:00Z,869,1165,62223,296,0.004757083,0.01872298,0.013965897,2016,ESS
2017-02-24T00:00:00Z,899,1254,63461,355,0.005593987,0.019760168,0.014166181,2017,ESS
2018-02-22T00:00:00Z,1017,1291,68148,274,0.004020661,0.018944063,0.014923402,2018,ESS
2019-02-21T00:00:00Z,1059,1355,70452,296,0.004201442,0.019232953,0.015031511,2019,ESS
2009-08-19T00:00:00Z,842,1483,64739,641,0.009901296,0.022907367,0.013006071,2009,EL
2010-08-20T00:00:00Z,830,1654,67255,824,0.012251877,0.024592967,0.01234109,2010,EL
2011-08-22T00:00:00Z,780,1568,65914,788,0.011954972,0.023788573,0.011833601,2011,EL
2012-08-17T00:00:00Z,757,1579,66132,822,0.012429686,0.023876489,0.011446803,2012,EL
2013-08-23T00:00:00Z,742,1594,66809,852,0.012752773,0.023859061,0.011106288,2013,EL
2014-08-20T00:00:00Z,732,1474,64487,742,0.011506195,0.02285732,0.011351125,2014,EL
2015-08-20T00:00:00Z,692,1307,61339,615,0.010026248,0.021307814,0.011281566,2015,EL
2016-08-24T00:00:00Z,749,1526,65576,777,0.011848847,0.023270709,0.011421862,2016,EL
2017-08-25T00:00:00Z,699,1643,69243,944,0.013633147,0.02372803,0.010094883,2017,EL
2018-08-24T00:00:00Z,671,1684,67125,1013,0.015091248,0.025087523,0.009996276,2018,EL
2019-02-22T00:00:00Z,938,1641,74755,703,0.009404053,0.021951709,0.012547656,2019,EVRG
2010-02-26T00:00:00Z,1622,3078,137116,1456,0.010618746,0.022448146,0.0118294,2010,ES
2011-02-25T00:00:00Z,1512,2990,135675,1478,0.01089368,0.022037958,0.011144279,2011,ES
2012-02-24T00:00:00Z,1529,3124,141771,1595,0.011250538,0.022035536,0.010784998,2012,ES
2013-02-28T00:00:00Z,1452,2911,138345,1459,0.010546099,0.021041599,0.0104955,2013,ES
2014-02-25T00:00:00Z,1307,2662,127978,1355,0.010587757,0.02080045,0.010212693,2014,ES
2015-02-25T00:00:00Z,1370,2631,123130,1261,0.010241208,0.02136766,0.011126452,2015,ES
2016-02-26T00:00:00Z,1334,2554,120638,1220,0.0101129,0.021170775,0.011057876,2016,ES
2017-02-23T00:00:00Z,1290,2404,114245,1114,0.009750974,0.021042496,0.011291523,2017,ES
2018-02-26T00:00:00Z,1265,2249,112642,984,0.00873564,0.01996591,0.011230269,2018,ES
2019-02-26T00:00:00Z,1291,2386,117328,1095,0.009332811,0.020336152,0.011003341,2019,ES
2010-03-01T00:00:00Z,2048,1771,76393,-277,-0.003625987,0.023182752,0.026808739,2010,RE
2011-03-01T00:00:00Z,2012,1804,75913,-208,-0.002739979,0.023764046,0.026504024,2011,RE
2012-02-29T00:00:00Z,2038,1849,76326,-189,-0.00247622,0.024225035,0.026701255,2012,RE
2013-03-01T00:00:00Z,2069,1823,76470,-246,-0.003216948,0.023839414,0.027056362,2013,RE
2014-03-03T00:00:00Z,2004,1785,74592,-219,-0.002935972,0.02393018,0.026866152,2014,RE
2015-03-02T00:00:00Z,1931,1683,71618,-248,-0.003462817,0.023499679,0.026962495,2015,RE
2016-02-29T00:00:00Z,1956,1798,74593,-158,-0.002118161,0.024104138,0.0262223,2016,RE
2017-03-01T00:00:00Z,2003,1851,77366,-152,-0.001964687,0.023925238,0.025889926,2017,RE
2018-03-01T00:00:00Z,1556,1577,64719,21,0.00032448,0.024366878,0.024042399,2018,RE
2019-03-01T00:00:00Z,2099,2058,83001,-41,-0.00049397,0.024794882,0.025288852,2019,RE
2010-02-05T00:00:00Z,2921,4698,210513,1777,0.008441284,0.022316912,0.013875628,2010,EXC
2011-02-10T00:00:00Z,2747,4522,208063,1775,0.00853107,0.021733802,0.013202732,2011,EXC
2012-02-09T00:00:00Z,2920,4978,224136,2058,0.009181925,0.02220973,0.013027805,2012,EXC
2013-02-22T00:00:00Z,3036,4599,223909,1563,0.006980514,0.020539594,0.01355908,2013,EXC
2014-02-14T00:00:00Z,3077,4755,232630,1678,0.007213171,0.020440184,0.013227013,2014,EXC
2015-02-13T00:00:00Z,3088,4978,243275,1890,0.007768986,0.02046244,0.012693454,2015,EXC
2016-02-10T00:00:00Z,2978,4766,229567,1788,0.007788576,0.020760824,0.012972248,2016,EXC
2017-02-13T00:00:00Z,1248,1550,112477,302,0.002684993,0.013780595,0.011095602,2017,EXC
2018-02-09T00:00:00Z,3299,5281,267780,1982,0.007401598,0.019721413,0.012319815,2018,EXC
2019-02-08T00:00:00Z,2915,4417,229891,1502,0.006533531,0.019213453,0.012679922,2019,EXC
2013-02-06T00:00:00Z,1265,1511,68513,246,0.003590559,0.022054209,0.018463649,2013,EXPE
2014-02-07T00:00:00Z,1196,1570,70710,374,0.005289209,0.022203366,0.016914156,2014,EXPE
2015-02-06T00:00:00Z,1173,1617,72180,444,0.006151288,0.022402328,0.016251039,2015,EXPE
2016-02-11T00:00:00Z,1116,1730,78454,614,0.007826242,0.022051138,0.014224896,2016,EXPE
2017-02-10T00:00:00Z,1269,1887,81371,618,0.007594843,0.02319008,0.015595237,2017,EXPE
2018-02-09T00:00:00Z,1332,1931,82438,599,0.007266067,0.023423664,0.016157597,2018,EXPE
2019-02-08T00:00:00Z,1238,1840,76225,602,0.007897671,0.024139062,0.016241391,2019,EXPE
2010-02-26T00:00:00Z,453,597,32498,144,0.004431042,0.018370361,0.013939319,2010,EXPD
2011-02-28T00:00:00Z,463,578,32554,115,0.003532592,0.017755115,0.014222523,2011,EXPD
2012-02-28T00:00:00Z,487,606,32133,119,0.003703358,0.018859117,0.015155759,2012,EXPD
2013-02-27T00:00:00Z,443,550,28389,107,0.003769065,0.019373701,0.015604636,2013,EXPD
2014-02-27T00:00:00Z,469,576,30468,107,0.003511881,0.018905081,0.015393199,2014,EXPD
2015-02-26T00:00:00Z,474,605,31644,131,0.004139805,0.019118948,0.014979143,2015,EXPD
2016-02-25T00:00:00Z,471,651,32505,180,0.00553761,0.020027688,0.014490078,2016,EXPD
2017-02-23T00:00:00Z,479,671,32889,192,0.005837818,0.020401958,0.01456414,2017,EXPD
2018-02-23T00:00:00Z,497,708,34014,211,0.006203328,0.020814959,0.014611631,2018,EXPD
2019-02-22T00:00:00Z,490,712,33781,222,0.006571742,0.021076937,0.014505195,2019,EXPD
2010-02-26T00:00:00Z,754,1074,55136,320,0.005803831,0.019479106,0.013675276,2010,EXR
2011-02-25T00:00:00Z,735,984,53796,249,0.004628597,0.018291323,0.013662726,2011,EXR
2012-02-29T00:00:00Z,698,963,53230,265,0.004978396,0.018091302,0.013112906,2012,EXR
2013-02-28T00:00:00Z,709,936,54499,227,0.004165214,0.017174627,0.013009413,2013,EXR
2014-03-03T00:00:00Z,748,1084,59977,336,0.005602147,0.018073595,0.012471447,2014,EXR
2015-03-02T00:00:00Z,256,293,24894,37,0.001486302,0.011769904,0.010283602,2015,EXR
2016-02-29T00:00:00Z,270,305,28234,35,0.00123964,0.010802578,0.009562938,2016,EXR
2017-02-27T00:00:00Z,766,1077,65960,311,0.004714979,0.016328078,0.011613099,2017,EXR
2018-03-01T00:00:00Z,622,929,46516,307,0.00659988,0.019971623,0.013371743,2018,EXR
2019-02-26T00:00:00Z,599,905,44628,306,0.006856682,0.020278749,0.013422067,2019,EXR
2011-02-25T00:00:00Z,709,1101,56818,392,0.006899222,0.019377662,0.01247844,2011,XOM
2012-02-24T00:00:00Z,693,1053,55044,360,0.006540222,0.01913015,0.012589928,2012,XOM
2013-02-27T00:00:00Z,659,1061,51801,402,0.007760468,0.02048223,0.012721762,2013,XOM
2014-02-26T00:00:00Z,637,1033,51493,396,0.007690366,0.020060979,0.012370613,2014,XOM
2015-02-25T00:00:00Z,665,1044,52361,379,0.007238212,0.019938504,0.012700292,2015,XOM
2016-02-24T00:00:00Z,689,1054,53956,365,0.006764771,0.019534435,0.012769664,2016,XOM
2017-02-22T00:00:00Z,698,1106,56321,408,0.00724419,0.019637435,0.012393246,2017,XOM
2018-02-28T00:00:00Z,740,1198,58392,458,0.00784354,0.020516509,0.012672969,2018,XOM
2019-02-27T00:00:00Z,738,1184,56677,446,0.007869153,0.020890308,0.013021155,2019,XOM
2009-11-20T00:00:00Z,681,1038,45247,357,0.007890026,0.022940747,0.015050722,2009,FFIV
2010-11-23T00:00:00Z,635,1000,42336,365,0.008621504,0.023620559,0.014999055,2010,FFIV
2011-11-22T00:00:00Z,610,1006,40959,396,0.009668205,0.024561147,0.014892942,2011,FFIV
2012-11-21T00:00:00Z,662,1049,43697,387,0.008856443,0.024006225,0.015149781,2012,FFIV
2013-11-22T00:00:00Z,714,1087,44467,373,0.008388243,0.024445094,0.016056851,2013,FFIV
2014-11-26T00:00:00Z,738,1107,45149,369,0.008172938,0.024518815,0.016345877,2014,FFIV
2015-11-06T00:00:00Z,791,1057,44467,266,0.005981964,0.023770437,0.017788472,2015,FFIV
2016-11-04T00:00:00Z,788,1091,45264,303,0.006694062,0.02410304,0.017408978,2016,FFIV
2017-11-03T00:00:00Z,860,1191,48144,331,0.006875208,0.024738285,0.017863077,2017,FFIV
2018-11-21T00:00:00Z,887,1213,48661,326,0.00669941,0.02492756,0.01822815,2018,FFIV
2013-02-01T00:00:00Z,735,1162,53216,427,0.008023903,0.021835538,0.013811636,2013,FB
2014-01-31T00:00:00Z,671,1080,49630,409,0.008240983,0.021761032,0.013520048,2014,FB
2015-01-29T00:00:00Z,672,963,45601,291,0.006381439,0.021117958,0.014736519,2015,FB
2016-01-28T00:00:00Z,698,939,45580,241,0.005287407,0.020601141,0.015313734,2016,FB
2017-02-03T00:00:00Z,790,1051,49394,261,0.005284043,0.021277888,0.015993845,2017,FB
2018-02-01T00:00:00Z,789,1045,48221,256,0.00530889,0.021671056,0.016362166,2018,FB
2019-01-31T00:00:00Z,859,1008,49381,149,0.003017355,0.020412709,0.017395354,2019,FB
2011-02-09T00:00:00Z,389,543,30551,154,0.005040752,0.017773559,0.012732807,2011,FAST
2012-02-09T00:00:00Z,382,556,30642,174,0.005678481,0.01814503,0.012466549,2012,FAST
2013-02-07T00:00:00Z,393,575,30664,182,0.005935299,0.018751631,0.012816332,2013,FAST
2014-02-06T00:00:00Z,401,592,31289,191,0.006104382,0.018920387,0.012816006,2014,FAST
2015-02-05T00:00:00Z,398,551,31125,153,0.004915663,0.017702811,0.012787149,2015,FAST
2016-02-05T00:00:00Z,452,578,33091,126,0.003807682,0.017466985,0.013659303,2016,FAST
2017-02-06T00:00:00Z,470,663,35461,193,0.005442599,0.018696596,0.013253997,2017,FAST
2018-02-05T00:00:00Z,475,655,34916,180,0.00515523,0.018759308,0.013604078,2018,FAST
2019-02-06T00:00:00Z,471,667,35113,196,0.005581978,0.018995814,0.013413835,2019,FAST
2010-02-17T00:00:00Z,801,1145,53114,344,0.006476635,0.021557405,0.01508077,2010,FRT
2011-02-15T00:00:00Z,840,1196,53986,356,0.006594302,0.022153892,0.01555959,2011,FRT
2012-02-16T00:00:00Z,813,1161,53839,348,0.006463716,0.021564294,0.015100578,2012,FRT
2013-02-12T00:00:00Z,782,1131,51449,349,0.006783417,0.021982935,0.015199518,2013,FRT
2014-02-11T00:00:00Z,772,1087,50879,315,0.006191159,0.021364414,0.015173254,2014,FRT
2015-02-10T00:00:00Z,780,1084,51061,304,0.005953663,0.02122951,0.015275847,2015,FRT
2016-02-09T00:00:00Z,773,1100,51616,327,0.006335245,0.021311221,0.014975976,2016,FRT
2017-02-13T00:00:00Z,752,1091,51496,339,0.006583036,0.021186112,0.014603076,2017,FRT
2018-02-13T00:00:00Z,723,1081,51955,358,0.006890578,0.020806467,0.013915889,2018,FRT
2019-02-13T00:00:00Z,736,1086,51799,350,0.006756887,0.020965656,0.014208769,2019,FRT
2009-07-15T00:00:00Z,769,1331,65088,562,0.008634464,0.020449238,0.011814774,2009,FDX
2010-07-15T00:00:00Z,734,1230,61115,496,0.008115847,0.020125992,0.012010145,2010,FDX
2011-07-12T00:00:00Z,708,1247,60800,539,0.008865132,0.020509868,0.011644737,2011,FDX
2012-07-16T00:00:00Z,701,1228,61948,527,0.008507135,0.019823077,0.011315942,2012,FDX
2013-07-15T00:00:00Z,719,1285,65278,566,0.008670609,0.019685039,0.011014431,2013,FDX
2014-07-14T00:00:00Z,749,1284,64385,535,0.008309389,0.019942533,0.011633144,2014,FDX
2015-07-14T00:00:00Z,795,1376,70540,581,0.008236462,0.019506663,0.011270201,2015,FDX
2016-07-18T00:00:00Z,819,1493,75470,674,0.008930701,0.019782695,0.010851994,2016,FDX
2017-07-17T00:00:00Z,897,1521,78318,624,0.007967517,0.019420823,0.011453306,2017,FDX
2018-07-16T00:00:00Z,883,1685,81697,802,0.009816762,0.020624992,0.01080823,2018,FDX
2010-02-26T00:00:00Z,759,1265,51771,506,0.009773812,0.024434529,0.014660717,2010,FIS
2011-02-25T00:00:00Z,824,1187,53045,363,0.006843246,0.022377227,0.015533981,2011,FIS
2012-02-24T00:00:00Z,902,1222,54718,320,0.005848167,0.022332688,0.016484521,2012,FIS
2013-02-26T00:00:00Z,892,1137,52018,245,0.004709908,0.021857818,0.01714791,2013,FIS
2014-02-28T00:00:00Z,899,1105,49156,206,0.00419074,0.022479453,0.018288713,2014,FIS
2015-02-27T00:00:00Z,870,1103,47706,233,0.004884082,0.023120781,0.0182367,2015,FIS
2016-02-26T00:00:00Z,1068,1336,56704,268,0.004726298,0.023560948,0.01883465,2016,FIS
2017-02-23T00:00:00Z,1036,1366,57255,330,0.005763689,0.023858178,0.01809449,2017,FIS
2018-02-22T00:00:00Z,1035,1350,56807,315,0.005545091,0.023764677,0.018219586,2018,FIS
2019-02-21T00:00:00Z,1104,1427,58174,323,0.005552309,0.024529859,0.01897755,2019,FIS
2011-02-28T00:00:00Z,1922,2351,111039,429,0.003863507,0.021172741,0.017309234,2011,FITB
2012-02-29T00:00:00Z,2095,2466,115919,371,0.003200511,0.021273475,0.018072965,2012,FITB
2013-02-22T00:00:00Z,2267,2522,121558,255,0.002097764,0.020747298,0.018649534,2013,FITB
2014-02-24T00:00:00Z,2269,2559,125339,290,0.002313725,0.02041663,0.018102905,2014,FITB
2015-02-25T00:00:00Z,2303,2606,124942,303,0.002425125,0.020857678,0.018432553,2015,FITB
2016-02-25T00:00:00Z,2307,2630,129528,323,0.002493669,0.02030449,0.017810821,2016,FITB
2017-02-24T00:00:00Z,2509,2774,134822,265,0.001965555,0.020575277,0.018609722,2017,FITB
2018-02-28T00:00:00Z,2408,2677,128802,269,0.002088477,0.020783839,0.018695362,2018,FITB
2019-03-01T00:00:00Z,2678,2963,140215,285,0.002032593,0.021131833,0.01909924,2019,FITB
2011-02-16T00:00:00Z,2208,3007,160265,799,0.004985493,0.018762674,0.013777182,2011,FE
2012-02-28T00:00:00Z,2730,3380,184580,650,0.003521508,0.018311843,0.014790335,2012,FE
2013-02-25T00:00:00Z,2449,2823,151464,374,0.002469234,0.018638092,0.016168859,2013,FE
2014-02-27T00:00:00Z,2437,2876,151634,439,0.002895129,0.018966723,0.016071593,2014,FE
2015-02-17T00:00:00Z,2264,2693,137065,429,0.003129902,0.019647612,0.016517711,2015,FE
2016-02-16T00:00:00Z,2151,2769,135693,618,0.004554399,0.020406358,0.01585196,2016,FE
2017-02-21T00:00:00Z,2538,3153,149543,615,0.00411253,0.021084237,0.016971707,2017,FE
2018-02-20T00:00:00Z,2490,3110,144191,620,0.004299852,0.021568614,0.017268762,2018,FE
2019-02-19T00:00:00Z,1754,2433,109417,679,0.006205617,0.022236033,0.016030416,2019,FE
2010-02-26T00:00:00Z,502,593,31019,91,0.002933686,0.019117315,0.016183629,2010,FISV
2011-02-24T00:00:00Z,527,599,31945,72,0.002253874,0.018750978,0.016497104,2011,FISV
2012-02-24T00:00:00Z,508,601,31830,93,0.002921772,0.018881558,0.015959786,2012,FISV
2013-02-22T00:00:00Z,522,609,31751,87,0.002740071,0.019180498,0.016440427,2013,FISV
2014-02-20T00:00:00Z,546,646,33848,100,0.002954384,0.019085323,0.016130938,2014,FISV
2015-02-20T00:00:00Z,495,644,33414,149,0.004459209,0.019273358,0.01481415,2015,FISV
2016-02-19T00:00:00Z,468,655,31918,187,0.005858763,0.020521336,0.014662573,2016,FISV
2017-02-23T00:00:00Z,446,687,32137,241,0.007499144,0.021377229,0.013878084,2017,FISV
2018-02-22T00:00:00Z,457,762,34250,305,0.008905109,0.022248175,0.013343066,2018,FISV
2019-02-21T00:00:00Z,670,1069,47730,399,0.008359522,0.022396815,0.014037293,2019,FISV
2011-03-25T00:00:00Z,804,997,52295,193,0.003690601,0.01906492,0.015374319,2011,FLT
2012-02-29T00:00:00Z,879,1233,60046,354,0.00589548,0.020534257,0.014638777,2012,FLT
2013-03-01T00:00:00Z,859,1172,59986,313,0.005217884,0.019537892,0.014320008,2013,FLT
2014-03-03T00:00:00Z,865,1118,61103,253,0.00414055,0.018296974,0.014156424,2014,FLT
2015-03-02T00:00:00Z,1028,1258,66305,230,0.003468818,0.018972928,0.01550411,2015,FLT
2016-02-29T00:00:00Z,1037,1261,66534,224,0.0033667,0.018952716,0.015586016,2016,FLT
2017-03-01T00:00:00Z,1029,1227,66508,198,0.002977085,0.018448908,0.015471823,2017,FLT
2018-03-01T00:00:00Z,1275,1459,76515,184,0.002404757,0.019068157,0.016663399,2018,FLT
2019-03-01T00:00:00Z,1343,1599,82755,256,0.003093469,0.019322095,0.016228627,2019,FLT
2010-02-26T00:00:00Z,479,704,32696,225,0.006881576,0.021531686,0.01465011,2010,FLIR
2011-03-01T00:00:00Z,566,1074,40098,508,0.012668961,0.026784378,0.014115417,2011,FLIR
2012-02-29T00:00:00Z,531,1089,38411,558,0.014527089,0.028351254,0.013824165,2012,FLIR
2013-03-01T00:00:00Z,545,1093,38992,548,0.014054165,0.028031391,0.013977226,2013,FLIR
2014-03-03T00:00:00Z,562,1099,40629,537,0.01321716,0.027049644,0.013832484,2014,FLIR
2015-02-27T00:00:00Z,591,1105,40848,514,0.012583235,0.027051508,0.014468273,2015,FLIR
2016-02-26T00:00:00Z,664,1179,44445,515,0.011587355,0.026527168,0.014939813,2016,FLIR
2017-02-24T00:00:00Z,720,1270,48802,550,0.01127003,0.026023524,0.014753494,2017,FLIR
2018-02-23T00:00:00Z,786,1323,52084,537,0.010310268,0.025401275,0.015091007,2018,FLIR
2019-02-28T00:00:00Z,775,1308,52658,533,0.010121919,0.024839531,0.014717612,2019,FLIR
2012-02-22T00:00:00Z,869,1656,63919,787,0.012312458,0.02590779,0.013595332,2012,FLS
2013-02-21T00:00:00Z,788,1489,59649,701,0.011752083,0.024962698,0.013210615,2013,FLS
2014-02-18T00:00:00Z,825,1479,59037,654,0.011077799,0.025052086,0.013974287,2014,FLS
2015-02-17T00:00:00Z,867,1487,60100,620,0.01031614,0.024742097,0.014425957,2015,FLS
2016-02-18T00:00:00Z,926,1528,61926,602,0.00972128,0.024674612,0.014953331,2016,FLS
2017-02-16T00:00:00Z,927,1541,63243,614,0.009708584,0.024366333,0.014657749,2017,FLS
2018-02-28T00:00:00Z,881,1466,59993,585,0.009751138,0.024436184,0.014685047,2018,FLS
2019-02-20T00:00:00Z,912,1598,63544,686,0.010795669,0.025147929,0.01435226,2019,FLS
2010-02-25T00:00:00Z,857,1245,51210,388,0.007576645,0.024311658,0.016735013,2010,FLR
2011-02-23T00:00:00Z,899,1326,52967,427,0.008061623,0.025034455,0.016972832,2011,FLR
2012-02-22T00:00:00Z,931,1431,55172,500,0.009062568,0.02593707,0.016874502,2012,FLR
2013-02-20T00:00:00Z,963,1462,56275,499,0.00886717,0.025979565,0.017112394,2013,FLR
2014-02-18T00:00:00Z,987,1490,56273,503,0.008938567,0.026478062,0.017539495,2014,FLR
2015-02-18T00:00:00Z,1020,1475,56254,455,0.008088314,0.026220358,0.018132044,2015,FLR
2016-02-18T00:00:00Z,1099,1566,58838,467,0.007937047,0.026615453,0.018678405,2016,FLR
2017-02-17T00:00:00Z,1102,1644,61122,542,0.008867511,0.026897026,0.018029515,2017,FLR
2018-02-20T00:00:00Z,1084,1714,61333,630,0.010271795,0.027945804,0.017674009,2018,FLR
2019-02-21T00:00:00Z,1045,1562,61250,517,0.008440816,0.025502041,0.017061224,2019,FLR
2010-02-22T00:00:00Z,816,1354,57172,538,0.009410201,0.023682922,0.014272721,2010,FMC
2011-02-22T00:00:00Z,841,1363,57433,522,0.009088851,0.023732001,0.014643149,2011,FMC
2012-02-21T00:00:00Z,792,1299,54298,507,0.00933736,0.023923533,0.014586173,2012,FMC
2013-02-19T00:00:00Z,775,1239,51340,464,0.009037787,0.024133229,0.015095442,2013,FMC
2014-02-18T00:00:00Z,818,1222,51658,404,0.007820667,0.023655581,0.015834914,2014,FMC
2015-02-27T00:00:00Z,923,1280,54465,357,0.006554668,0.023501331,0.016946663,2015,FMC
2016-02-26T00:00:00Z,986,1379,57947,393,0.006782059,0.023797608,0.017015549,2016,FMC
2017-02-28T00:00:00Z,1006,1458,58677,452,0.007703189,0.024847896,0.017144707,2017,FMC
2018-02-28T00:00:00Z,1082,1570,62930,488,0.007754648,0.024948355,0.017193707,2018,FMC
2019-02-28T00:00:00Z,1124,1700,69633,576,0.00827194,0.024413712,0.016141772,2019,FMC
2010-03-29T00:00:00Z,587,843,38562,256,0.00663866,0.021860899,0.01522224,2010,FL
2011-03-28T00:00:00Z,592,838,37898,246,0.006491108,0.022111985,0.015620877,2011,FL
2012-03-26T00:00:00Z,515,868,37913,353,0.00931079,0.022894522,0.013583731,2012,FL
2013-04-01T00:00:00Z,515,920,38948,405,0.01039848,0.023621239,0.013222759,2013,FL
2014-03-31T00:00:00Z,551,932,40707,381,0.00935957,0.022895325,0.013535756,2014,FL
2015-03-30T00:00:00Z,533,921,39351,388,0.009859978,0.023404742,0.013544764,2015,FL
2016-03-24T00:00:00Z,562,997,40458,435,0.010751891,0.024642839,0.013890949,2016,FL
2017-03-23T00:00:00Z,575,1003,41718,428,0.01025936,0.02404238,0.013783019,2017,FL
2018-03-29T00:00:00Z,640,1036,44380,396,0.008922938,0.023343849,0.01442091,2018,FL
2019-04-02T00:00:00Z,607,1007,43755,400,0.009141812,0.023014513,0.0138727,2019,FL
2014-02-18T00:00:00Z,1588,1658,87317,70,0.000801677,0.018988284,0.018186607,2014,F
2015-02-13T00:00:00Z,1442,1428,76123,-14,-0.000183913,0.018759114,0.018943026,2015,F
2016-02-11T00:00:00Z,1342,1391,71925,49,0.000681265,0.01933959,0.018658325,2016,F
2017-02-09T00:00:00Z,1269,1370,67846,101,0.001488666,0.02019279,0.018704124,2017,F
2018-02-08T00:00:00Z,1284,1378,68365,94,0.001374973,0.020156513,0.01878154,2018,F
2019-02-21T00:00:00Z,1322,1361,67875,39,0.000574586,0.020051565,0.01947698,2019,F
2012-02-28T00:00:00Z,1048,1112,52383,64,0.00122177,0.021228261,0.020006491,2012,FTNT
2013-02-27T00:00:00Z,1074,1151,53073,77,0.001450832,0.02168711,0.020236278,2013,FTNT
2014-03-03T00:00:00Z,1071,1188,54462,117,0.002148287,0.021813374,0.019665088,2014,FTNT
2015-03-02T00:00:00Z,1072,1167,51338,95,0.001850481,0.0227317,0.020881219,2015,FTNT
2016-02-26T00:00:00Z,1144,1329,54788,185,0.003376652,0.024257137,0.020880485,2016,FTNT
2017-03-01T00:00:00Z,1189,1396,57401,207,0.003606209,0.024320134,0.020713925,2017,FTNT
2018-02-26T00:00:00Z,1224,1403,59744,179,0.002996117,0.02348353,0.020487413,2018,FTNT
2019-02-27T00:00:00Z,1265,1349,60400,84,0.001390728,0.022334437,0.020943709,2019,FTNT
2017-02-28T00:00:00Z,865,1285,56077,420,0.007489702,0.022914921,0.015425219,2017,FTV
2018-02-28T00:00:00Z,926,1341,58459,415,0.007098992,0.022939154,0.015840161,2018,FTV
2019-02-28T00:00:00Z,1022,1353,64526,331,0.005129715,0.020968292,0.015838577,2019,FTV
2012-02-22T00:00:00Z,711,1414,45071,703,0.015597613,0.031372723,0.01577511,2012,FBHS
2013-02-27T00:00:00Z,744,1338,45918,594,0.012936103,0.0291389,0.016202796,2013,FBHS
2014-02-26T00:00:00Z,690,1427,46442,737,0.015869256,0.030726498,0.014857241,2014,FBHS
2015-02-25T00:00:00Z,698,1330,42317,632,0.014934896,0.031429449,0.016494553,2015,FBHS
2016-02-25T00:00:00Z,741,1373,44272,632,0.014275389,0.03101283,0.016737441,2016,FBHS
2017-02-28T00:00:00Z,751,1442,46260,691,0.014937311,0.031171639,0.016234328,2017,FBHS
2018-02-28T00:00:00Z,743,1399,46093,656,0.014232096,0.03035168,0.016119584,2018,FBHS
2019-02-25T00:00:00Z,711,1388,48183,677,0.014050599,0.028806841,0.014756242,2019,FBHS
2009-11-24T00:00:00Z,821,1405,59379,584,0.009835127,0.023661564,0.013826437,2009,BEN
2010-11-16T00:00:00Z,832,1472,59569,640,0.010743843,0.02471084,0.013966996,2010,BEN
2011-11-15T00:00:00Z,888,1536,61265,648,0.010577002,0.025071411,0.01449441,2011,BEN
2012-11-15T00:00:00Z,915,1537,61841,622,0.010058052,0.024854061,0.014796009,2012,BEN
2013-11-12T00:00:00Z,915,1472,61247,557,0.009094323,0.02403383,0.014939507,2013,BEN
2014-11-12T00:00:00Z,839,1388,56772,549,0.00967026,0.024448672,0.014778412,2014,BEN
2015-11-12T00:00:00Z,796,1338,55050,542,0.009845595,0.024305177,0.014459582,2015,BEN
2016-11-14T00:00:00Z,825,1303,55473,478,0.008616805,0.023488905,0.0148721,2016,BEN
2017-11-13T00:00:00Z,806,1317,53291,511,0.009588861,0.024713366,0.015124505,2017,BEN
2018-11-09T00:00:00Z,815,1279,52420,464,0.008851583,0.024399084,0.015547501,2018,BEN
2012-02-27T00:00:00Z,1153,1957,98660,804,0.008149199,0.0198358,0.0116866,2012,FCX
2013-02-22T00:00:00Z,1112,1934,97071,822,0.008468029,0.019923561,0.011455533,2013,FCX
2014-02-27T00:00:00Z,1498,2333,121881,835,0.006850945,0.019141622,0.012290677,2014,FCX
2015-02-27T00:00:00Z,1443,2277,120414,834,0.006926105,0.018909761,0.011983656,2015,FCX
2016-02-26T00:00:00Z,1668,2368,130956,700,0.005345307,0.018082409,0.012737103,2016,FCX
2017-02-24T00:00:00Z,1660,2163,120236,503,0.004183439,0.01798962,0.013806181,2017,FCX
2018-02-20T00:00:00Z,1525,2073,110019,548,0.004980958,0.0188422,0.013861242,2018,FCX
2019-02-15T00:00:00Z,1561,2072,109231,511,0.004678159,0.018968974,0.014290815,2019,FCX
2010-03-26T00:00:00Z,500,684,38272,184,0.004807692,0.017872074,0.013064381,2010,GPS
2011-03-28T00:00:00Z,466,656,37568,190,0.005057496,0.01746167,0.012404174,2011,GPS
2012-03-26T00:00:00Z,567,735,40578,168,0.004140174,0.018113263,0.013973089,2012,GPS
2013-03-26T00:00:00Z,501,768,40011,267,0.006673165,0.019194721,0.012521557,2013,GPS
2014-03-24T00:00:00Z,521,764,39551,243,0.006143966,0.019316831,0.013172865,2014,GPS
2015-03-23T00:00:00Z,510,747,38513,237,0.006153766,0.019396048,0.013242282,2015,GPS
2016-03-21T00:00:00Z,522,758,38609,236,0.006112564,0.019632728,0.013520164,2016,GPS
2017-03-20T00:00:00Z,533,865,40487,332,0.008200163,0.021364883,0.01316472,2017,GPS
2018-03-20T00:00:00Z,547,865,39917,318,0.007966531,0.021669965,0.013703435,2018,GPS
2019-03-19T00:00:00Z,566,911,40463,345,0.008526308,0.022514396,0.013988088,2019,GPS
2010-02-24T00:00:00Z,667,1032,48399,365,0.007541478,0.021322755,0.013781276,2010,GRMN
2011-02-23T00:00:00Z,660,1027,48962,367,0.007495609,0.02097545,0.013479842,2011,GRMN
2012-02-29T00:00:00Z,715,1150,53796,435,0.008086103,0.021377054,0.013290951,2012,GRMN
2013-02-27T00:00:00Z,732,1111,54836,379,0.006911518,0.020260413,0.013348895,2013,GRMN
2014-02-19T00:00:00Z,850,1006,51868,156,0.003007635,0.019395388,0.016387754,2014,GRMN
2015-02-18T00:00:00Z,859,1037,49881,178,0.003568493,0.020789479,0.017220986,2015,GRMN
2016-02-17T00:00:00Z,826,1021,48808,195,0.003995247,0.020918702,0.016923455,2016,GRMN
2017-02-22T00:00:00Z,877,1118,52048,241,0.004630341,0.021480172,0.016849831,2017,GRMN
2018-02-21T00:00:00Z,774,1111,50285,337,0.0067018,0.022094064,0.015392264,2018,GRMN
2019-02-20T00:00:00Z,623,861,39221,238,0.006068178,0.021952525,0.015884348,2019,GRMN
2011-02-15T00:00:00Z,546,866,36492,320,0.008769045,0.023731229,0.014962183,2011,IT
2012-02-23T00:00:00Z,507,924,36178,417,0.011526342,0.025540384,0.014014042,2012,IT
2013-02-22T00:00:00Z,493,883,35774,390,0.010901772,0.02468273,0.013780958,2013,IT
2014-02-26T00:00:00Z,472,825,34547,353,0.010217964,0.023880511,0.013662547,2014,IT
2015-02-27T00:00:00Z,520,864,35845,344,0.009596875,0.02410378,0.014506905,2015,IT
2016-02-24T00:00:00Z,536,883,36712,347,0.00945195,0.024052081,0.014600131,2016,IT
2017-02-22T00:00:00Z,569,1021,42413,452,0.01065711,0.024072808,0.013415698,2017,IT
2018-02-22T00:00:00Z,601,1164,45200,563,0.012455752,0.025752212,0.01329646,2018,IT
2019-02-22T00:00:00Z,702,1226,49576,524,0.01056963,0.024729708,0.014160077,2019,IT
2010-02-19T00:00:00Z,520,1148,46387,628,0.013538276,0.024748313,0.011210037,2010,GD
2011-02-18T00:00:00Z,520,1183,45611,663,0.014535967,0.025936726,0.011400759,2011,GD
2012-02-17T00:00:00Z,505,1102,45762,597,0.013045758,0.024081115,0.011035357,2012,GD
2013-02-08T00:00:00Z,560,1083,43221,523,0.012100599,0.025057264,0.012956665,2013,GD
2014-02-07T00:00:00Z,532,1034,40426,502,0.012417751,0.025577599,0.013159848,2014,GD
2015-02-09T00:00:00Z,494,1003,39389,509,0.012922389,0.025463962,0.012541573,2015,GD
2016-02-08T00:00:00Z,478,1066,41067,588,0.014318066,0.025957582,0.011639516,2016,GD
2017-02-06T00:00:00Z,487,1126,44134,639,0.014478633,0.02551321,0.011034577,2017,GD
2018-02-12T00:00:00Z,498,1165,45855,667,0.014545851,0.025406172,0.010860321,2018,GD
2019-02-13T00:00:00Z,535,1286,49394,751,0.015204276,0.026035551,0.010831275,2019,GD
2010-02-19T00:00:00Z,1502,1805,88827,303,0.003411125,0.020320398,0.016909273,2010,GE
2011-02-25T00:00:00Z,1779,1972,102409,193,0.0018846,0.01925612,0.01737152,2011,GE
2012-02-24T00:00:00Z,1767,1942,100737,175,0.001737197,0.019277922,0.017540725,2012,GE
2013-02-26T00:00:00Z,1827,1953,102065,126,0.001234507,0.019134865,0.017900358,2013,GE
2014-02-27T00:00:00Z,1835,1957,102901,122,0.001185606,0.01901828,0.017832674,2014,GE
2015-02-27T00:00:00Z,1740,1934,97668,194,0.001986321,0.019801777,0.017815456,2015,GE
2016-02-26T00:00:00Z,1706,1938,94991,232,0.002442337,0.020401933,0.017959596,2016,GE
2017-02-24T00:00:00Z,1679,2073,100690,394,0.003913,0.020587943,0.016674943,2017,GE
2018-02-23T00:00:00Z,1685,2262,106212,577,0.005432531,0.021297029,0.015864497,2018,GE
2019-02-26T00:00:00Z,1737,2405,106032,668,0.006299985,0.022681832,0.016381847,2019,GE
2009-07-13T00:00:00Z,879,1392,53044,513,0.009671216,0.026242365,0.016571148,2009,GIS
2010-07-09T00:00:00Z,888,1432,52872,544,0.010289,0.027084279,0.016795279,2010,GIS
2011-07-08T00:00:00Z,818,1338,49450,520,0.010515672,0.027057634,0.016541962,2011,GIS
2012-07-03T00:00:00Z,812,1355,50369,543,0.01078044,0.026901467,0.016121027,2012,GIS
2013-07-03T00:00:00Z,807,1340,51981,533,0.010253747,0.02577865,0.015524903,2013,GIS
2014-07-03T00:00:00Z,755,1259,48339,504,0.010426364,0.026045222,0.015618858,2014,GIS
2015-07-06T00:00:00Z,725,1296,49618,571,0.011507921,0.026119553,0.014611633,2015,GIS
2016-06-30T00:00:00Z,204,367,15982,163,0.010198974,0.022963334,0.01276436,2016,GIS
2017-06-29T00:00:00Z,217,364,16721,147,0.00879134,0.021769033,0.012977693,2017,GIS
2018-06-29T00:00:00Z,823,1512,57516,689,0.011979275,0.026288337,0.014309062,2018,GIS
2010-04-07T00:00:00Z,2524,4418,182514,1894,0.010377286,0.024206362,0.013829076,2010,GM
2011-03-01T00:00:00Z,2393,3883,169538,1490,0.00878859,0.02290342,0.01411483,2011,GM
2012-02-27T00:00:00Z,1707,2693,113534,986,0.008684623,0.023719767,0.015035144,2012,GM
2013-02-15T00:00:00Z,1438,2320,99363,882,0.008876544,0.023348731,0.014472188,2013,GM
2014-02-06T00:00:00Z,1197,1819,77697,622,0.008005457,0.023411457,0.015406,2014,GM
2015-02-04T00:00:00Z,1156,1512,69954,356,0.005089059,0.021614204,0.016525145,2015,GM
2016-02-03T00:00:00Z,1032,1345,63109,313,0.004959673,0.021312333,0.01635266,2016,GM
2017-02-07T00:00:00Z,1031,1244,59405,213,0.003585557,0.020940998,0.017355441,2017,GM
2018-02-06T00:00:00Z,1103,1272,59908,169,0.002820992,0.021232557,0.018411564,2018,GM
2019-02-06T00:00:00Z,1144,1360,63675,216,0.003392226,0.021358461,0.017966235,2019,GM
2010-02-26T00:00:00Z,346,823,30678,477,0.015548602,0.026827042,0.011278441,2010,GPC
2011-02-25T00:00:00Z,334,803,30351,469,0.015452539,0.026457118,0.01100458,2011,GPC
2012-02-27T00:00:00Z,421,798,30841,377,0.012223988,0.025874647,0.01365066,2012,GPC
2013-02-26T00:00:00Z,335,811,30735,476,0.01548723,0.026386855,0.010899626,2013,GPC
2014-02-27T00:00:00Z,469,847,33784,378,0.011188728,0.02507104,0.013882311,2014,GPC
2015-02-26T00:00:00Z,364,856,33484,492,0.014693585,0.025564449,0.010870864,2015,GPC
2016-02-26T00:00:00Z,375,855,33267,480,0.014428713,0.025701145,0.011272432,2016,GPC
2017-02-27T00:00:00Z,382,828,33081,446,0.013482059,0.025029473,0.011547414,2017,GPC
2018-02-27T00:00:00Z,458,973,39177,515,0.013145468,0.024836001,0.011690533,2018,GPC
2019-02-25T00:00:00Z,532,976,39956,444,0.011112223,0.02442687,0.013314646,2019,GPC
2011-02-28T00:00:00Z,1140,1355,76888,215,0.002796275,0.017623036,0.014826761,2011,GILD
2012-02-23T00:00:00Z,1253,1487,84811,234,0.002759076,0.017533103,0.014774027,2012,GILD
2013-02-27T00:00:00Z,1278,1379,79758,101,0.001266331,0.017289802,0.016023471,2013,GILD
2014-02-25T00:00:00Z,1526,1616,89998,90,0.001000022,0.017955955,0.016955932,2014,GILD
2015-02-25T00:00:00Z,1540,1481,84823,-59,-0.000695566,0.017459887,0.018155453,2015,GILD
2016-02-24T00:00:00Z,1336,1295,73925,-41,-0.000554616,0.017517754,0.018072371,2016,GILD
2017-02-27T00:00:00Z,1337,1366,75258,29,0.000385341,0.018150894,0.017765553,2017,GILD
2018-02-27T00:00:00Z,1293,1531,76668,238,0.003104294,0.019969218,0.016864924,2018,GILD
2019-02-26T00:00:00Z,1075,1211,61673,136,0.002205179,0.019635821,0.017430642,2019,GILD
2011-07-25T00:00:00Z,664,820,48276,156,0.003231419,0.016985666,0.013754246,2011,GPN
2012-07-27T00:00:00Z,856,908,53024,52,0.000980688,0.017124321,0.016143633,2012,GPN
2013-07-25T00:00:00Z,881,887,51923,6,0.000115556,0.017082988,0.016967433,2013,GPN
2014-07-29T00:00:00Z,845,865,47740,20,0.000418936,0.018118978,0.017700042,2014,GPN
2015-07-30T00:00:00Z,881,927,50710,46,0.000907119,0.018280418,0.017373299,2015,GPN
2016-07-28T00:00:00Z,956,978,52900,22,0.000415879,0.018487713,0.018071834,2016,GPN
2018-02-23T00:00:00Z,829,1025,55838,196,0.003510154,0.018356675,0.01484652,2018,GPN
2019-02-21T00:00:00Z,819,1050,57824,231,0.003994881,0.01815855,0.014163669,2019,GPN
2011-03-01T00:00:00Z,2435,2600,118752,165,0.00138945,0.021894368,0.020504918,2011,GS
2012-02-28T00:00:00Z,2674,2669,127843,-5,-3.91E-05,0.02087717,0.02091628,2012,GS
2013-03-01T00:00:00Z,2808,2885,135723,77,0.000567332,0.02125653,0.020689198,2013,GS
2014-02-28T00:00:00Z,2796,3038,137787,242,0.001756334,0.022048524,0.02029219,2014,GS
2015-02-23T00:00:00Z,2905,3094,138766,189,0.001362005,0.022296528,0.020934523,2015,GS
2016-02-22T00:00:00Z,3100,3187,139928,87,0.000621748,0.022775999,0.022154251,2016,GS
2017-02-27T00:00:00Z,3107,3180,141601,73,0.000515533,0.022457469,0.021941935,2017,GS
2018-02-26T00:00:00Z,3138,3081,143428,-57,-0.000397412,0.021481161,0.021878573,2018,GS
2019-02-26T00:00:00Z,3374,3014,144742,-360,-0.002487184,0.020823258,0.023310442,2019,GS
2010-02-25T00:00:00Z,453,687,30785,234,0.007601104,0.022316063,0.014714959,2010,GWW
2011-02-28T00:00:00Z,444,629,30096,185,0.006146996,0.020899787,0.014752791,2011,GWW
2012-02-28T00:00:00Z,406,649,29258,243,0.008305421,0.022181967,0.013876547,2012,GWW
2013-02-28T00:00:00Z,404,663,29643,259,0.008737307,0.022366157,0.01362885,2013,GWW
2014-02-27T00:00:00Z,404,688,30752,284,0.009235172,0.022372529,0.013137357,2014,GWW
2015-02-27T00:00:00Z,420,682,31062,262,0.008434743,0.021956088,0.013521344,2015,GWW
2016-02-29T00:00:00Z,474,744,33784,270,0.007991949,0.022022259,0.01403031,2016,GWW
2017-02-28T00:00:00Z,498,784,35665,286,0.008019066,0.021982336,0.013963269,2017,GWW
2018-02-26T00:00:00Z,438,794,35278,356,0.010091275,0.022506945,0.01241567,2018,GWW
2019-02-28T00:00:00Z,458,707,32280,249,0.007713755,0.021902107,0.014188352,2019,GWW
2010-02-17T00:00:00Z,813,958,43309,145,0.003348034,0.022120114,0.01877208,2010,HAL
2011-02-17T00:00:00Z,1276,1204,52684,-72,-0.001366639,0.022853238,0.024219877,2011,HAL
2012-02-16T00:00:00Z,1684,1431,61577,-253,-0.004108677,0.023239196,0.027347873,2012,HAL
2013-02-11T00:00:00Z,1588,1314,57700,-274,-0.0047487,0.022772964,0.027521664,2013,HAL
2014-02-07T00:00:00Z,1090,1066,45917,-24,-0.000522682,0.023215802,0.023738485,2014,HAL
2015-02-24T00:00:00Z,1055,1052,48121,-3,-6.23E-05,0.021861557,0.0219239,2015,HAL
2016-02-05T00:00:00Z,971,966,47992,-5,-0.000104184,0.020128355,0.020232539,2016,HAL
2017-02-07T00:00:00Z,883,914,44209,31,0.000701215,0.020674523,0.019973309,2017,HAL
2018-02-09T00:00:00Z,798,836,39555,38,0.000960688,0.021135128,0.020174441,2018,HAL
2019-02-13T00:00:00Z,720,760,37358,40,0.001070721,0.020343701,0.01927298,2019,HAL
2011-02-16T00:00:00Z,1107,1800,83212,693,0.008328126,0.021631495,0.01330337,2011,HBI
2012-02-17T00:00:00Z,1009,1660,76679,651,0.008489939,0.021648691,0.013158753,2012,HBI
2013-02-06T00:00:00Z,811,1339,60594,528,0.008713734,0.022097897,0.013384163,2013,HBI
2014-02-06T00:00:00Z,749,1301,56186,552,0.009824511,0.023155234,0.013330723,2014,HBI
2015-02-06T00:00:00Z,784,1354,57268,570,0.009953202,0.023643221,0.013690019,2015,HBI
2016-02-05T00:00:00Z,724,1267,53853,543,0.010083004,0.023527009,0.013444005,2016,HBI
2017-02-03T00:00:00Z,850,1423,59022,573,0.009708244,0.024109654,0.01440141,2017,HBI
2018-02-09T00:00:00Z,836,1375,58841,539,0.009160279,0.02336806,0.01420778,2018,HBI
2019-02-11T00:00:00Z,852,1372,57746,520,0.009004953,0.023759221,0.014754269,2019,HBI
2011-02-24T00:00:00Z,1065,1467,64403,402,0.006241945,0.022778442,0.016536497,2011,HOG
2012-02-23T00:00:00Z,1032,1421,61488,389,0.006326438,0.0231102,0.016783763,2012,HOG
2013-02-22T00:00:00Z,921,1292,56551,371,0.00656045,0.022846634,0.016286184,2013,HOG
2014-02-20T00:00:00Z,874,1277,55135,403,0.007309332,0.023161331,0.015852,2014,HOG
2015-02-19T00:00:00Z,870,1210,54578,340,0.006229616,0.022170105,0.015940489,2015,HOG
2016-02-18T00:00:00Z,931,1176,56129,245,0.004364945,0.020951736,0.016586791,2016,HOG
2017-02-21T00:00:00Z,1018,1229,59564,211,0.003542408,0.020633268,0.01709086,2017,HOG
2018-02-21T00:00:00Z,949,1229,58595,280,0.004778565,0.020974486,0.016195921,2018,HOG
2019-02-28T00:00:00Z,974,1253,59304,279,0.004704573,0.021128423,0.01642385,2019,HOG
2009-08-31T00:00:00Z,988,1644,73509,656,0.008924077,0.022364608,0.013440531,2009,HRS
2010-08-30T00:00:00Z,1062,1663,71412,601,0.008415953,0.023287403,0.01487145,2010,HRS
2011-08-29T00:00:00Z,1037,1777,73466,740,0.010072687,0.02418806,0.014115373,2011,HRS
2012-08-27T00:00:00Z,1049,1623,69419,574,0.00826863,0.023379766,0.015111137,2012,HRS
2013-08-26T00:00:00Z,1066,1599,67924,533,0.007847005,0.023541016,0.015694011,2013,HRS
2014-08-25T00:00:00Z,1021,1523,64699,502,0.007759007,0.023539777,0.015780769,2014,HRS
2015-08-31T00:00:00Z,1387,2078,86853,691,0.007955972,0.023925483,0.015969512,2015,HRS
2016-08-29T00:00:00Z,1405,2041,84547,636,0.007522443,0.024140419,0.016617976,2016,HRS
2017-08-29T00:00:00Z,1389,2082,84229,693,0.00822757,0.024718327,0.016490757,2017,HRS
2018-08-27T00:00:00Z,1232,1844,76023,612,0.008050195,0.024255817,0.016205622,2018,HRS
2011-02-25T00:00:00Z,4559,3557,153811,-1002,-0.006514489,0.023125784,0.029640273,2011,HIG
2012-02-24T00:00:00Z,4800,3455,153094,-1345,-0.008785452,0.022567834,0.031353286,2012,HIG
2013-03-01T00:00:00Z,4645,3330,143783,-1315,-0.009145727,0.023159901,0.032305627,2013,HIG
2014-02-28T00:00:00Z,4754,3286,140549,-1468,-0.010444756,0.023379747,0.033824502,2014,HIG
2015-02-27T00:00:00Z,4605,3245,137013,-1360,-0.009926065,0.023683884,0.033609949,2015,HIG
2016-02-26T00:00:00Z,4537,3167,132231,-1370,-0.010360657,0.023950511,0.034311168,2016,HIG
2017-02-24T00:00:00Z,4254,2980,129361,-1274,-0.009848409,0.023036309,0.032884718,2017,HIG
2018-02-23T00:00:00Z,4035,2738,123501,-1297,-0.010501939,0.022169861,0.0326718,2018,HIG
2019-02-22T00:00:00Z,4053,2752,132104,-1301,-0.009848301,0.020832072,0.030680373,2019,HIG
2010-02-24T00:00:00Z,632,1134,58024,502,0.008651592,0.019543637,0.010892045,2010,HAS
2011-02-23T00:00:00Z,581,1096,55414,515,0.00929368,0.019778395,0.010484715,2011,HAS
2012-02-22T00:00:00Z,623,1149,55756,526,0.009433962,0.020607648,0.011173685,2012,HAS
2013-02-27T00:00:00Z,657,1247,57709,590,0.010223709,0.021608415,0.011384706,2013,HAS
2014-02-26T00:00:00Z,737,1420,62404,683,0.010944811,0.022754952,0.01181014,2014,HAS
2015-02-26T00:00:00Z,748,1494,64866,746,0.011500632,0.023032097,0.011531465,2015,HAS
2016-02-24T00:00:00Z,767,1438,60315,671,0.011124927,0.023841499,0.012716571,2016,HAS
2017-02-22T00:00:00Z,757,1523,61984,766,0.012358028,0.024570857,0.012212829,2017,HAS
2018-02-26T00:00:00Z,806,1526,62601,720,0.011501414,0.024376607,0.012875194,2018,HAS
2019-02-26T00:00:00Z,864,1670,66746,806,0.01207563,0.025020226,0.012944596,2019,HAS
2010-03-01T00:00:00Z,1202,1096,60299,-106,-0.001757906,0.018176089,0.019933996,2010,HCA
2011-02-17T00:00:00Z,1437,1510,76953,73,0.000948631,0.019622367,0.018673736,2011,HCA
2012-02-24T00:00:00Z,1484,1588,79822,104,0.001302899,0.019894265,0.018591366,2012,HCA
2013-02-27T00:00:00Z,1491,1652,81929,161,0.001965116,0.0201638,0.018198684,2013,HCA
2014-02-26T00:00:00Z,1457,1515,77577,58,0.000747644,0.019528984,0.01878134,2014,HCA
2015-02-26T00:00:00Z,1541,1521,78009,-20,-0.000256381,0.01949775,0.019754131,2015,HCA
2016-02-26T00:00:00Z,1567,1490,76063,-77,-0.001012319,0.019589025,0.020601344,2016,HCA
2017-02-22T00:00:00Z,1464,1399,70611,-65,-0.000920536,0.019812777,0.020733314,2017,HCA
2018-02-23T00:00:00Z,1455,1371,70255,-84,-0.001195644,0.019514625,0.02071027,2018,HCA
2019-02-21T00:00:00Z,1369,1413,71593,44,0.000614585,0.019736566,0.019121981,2019,HCA
2011-02-15T00:00:00Z,1064,1195,68845,131,0.001902825,0.017357833,0.015455008,2011,HCP
2012-02-14T00:00:00Z,1034,1269,72006,235,0.003263617,0.017623531,0.014359914,2012,HCP
2013-02-12T00:00:00Z,1048,1295,77688,247,0.003179384,0.016669241,0.013489857,2013,HCP
2014-02-11T00:00:00Z,1061,1271,74248,210,0.002828359,0.017118306,0.014289947,2014,HCP
2015-02-10T00:00:00Z,1091,1451,78200,360,0.004603581,0.018554987,0.013951407,2015,HCP
2016-02-09T00:00:00Z,1256,1569,86920,313,0.003601012,0.018051081,0.014450069,2016,HCP
2017-02-13T00:00:00Z,1338,1467,85939,129,0.001501065,0.017070248,0.015569183,2017,HCP
2018-02-13T00:00:00Z,1415,1498,84275,83,0.000984871,0.017775141,0.01679027,2018,HCP
2019-02-14T00:00:00Z,1474,1484,82659,10,0.000120979,0.017953278,0.017832299,2019,HCP
2010-11-24T00:00:00Z,220,201,15555,-19,-0.001221472,0.01292189,0.014143362,2010,HP
2011-11-23T00:00:00Z,252,209,16006,-43,-0.002686493,0.013057603,0.015744096,2011,HP
2012-11-21T00:00:00Z,275,237,17585,-38,-0.002160933,0.013477396,0.015638328,2012,HP
2013-11-27T00:00:00Z,710,804,41705,94,0.002253926,0.019278264,0.017024338,2013,HP
2014-11-26T00:00:00Z,742,800,42856,58,0.001353369,0.018667164,0.017313795,2014,HP
2015-11-25T00:00:00Z,881,893,48710,12,0.000246356,0.018332991,0.018086635,2015,HP
2016-11-23T00:00:00Z,1034,954,51373,-80,-0.001557238,0.018570066,0.020127304,2016,HP
2017-11-22T00:00:00Z,1056,971,49809,-85,-0.001706519,0.019494469,0.021200988,2017,HP
2018-11-16T00:00:00Z,1250,1421,58562,171,0.002919982,0.024264882,0.021344899,2018,HP
2010-02-23T00:00:00Z,791,1189,50867,398,0.007824326,0.023374683,0.015550357,2010,HSIC
2011-02-22T00:00:00Z,753,1151,50081,398,0.007947126,0.022982768,0.015035642,2011,HSIC
2012-02-15T00:00:00Z,849,1266,54290,417,0.007680973,0.023319212,0.015638239,2012,HSIC
2013-02-13T00:00:00Z,873,1232,54379,359,0.006601813,0.022655805,0.016053991,2013,HSIC
2014-02-11T00:00:00Z,850,1196,52629,346,0.006574322,0.022725114,0.016150791,2014,HSIC
2015-02-11T00:00:00Z,932,1238,55341,306,0.005529354,0.022370394,0.01684104,2015,HSIC
2016-02-10T00:00:00Z,1009,1358,60294,349,0.005788304,0.022522971,0.016734667,2016,HSIC
2017-02-21T00:00:00Z,1044,1400,62301,356,0.005714194,0.022471549,0.016757355,2017,HSIC
2018-02-21T00:00:00Z,1198,1541,68221,343,0.005027777,0.022588353,0.017560575,2018,HSIC
2019-02-20T00:00:00Z,1348,1648,73915,300,0.004058716,0.02229588,0.018237164,2019,HSIC
2011-02-18T00:00:00Z,622,1248,48681,626,0.012859226,0.025636285,0.012777059,2011,HSY
2012-02-17T00:00:00Z,627,1236,49665,609,0.012262156,0.024886741,0.012624585,2012,HSY
2013-02-22T00:00:00Z,673,1258,52042,585,0.011240921,0.024172784,0.012931863,2013,HSY
2014-02-21T00:00:00Z,650,1191,50187,541,0.010779684,0.023731245,0.012951561,2014,HSY
2015-02-20T00:00:00Z,568,1107,44699,539,0.012058435,0.024765655,0.012707219,2015,HSY
2016-02-26T00:00:00Z,689,1242,49760,553,0.011113344,0.024959807,0.013846463,2016,HSY
2017-02-21T00:00:00Z,632,1197,48578,565,0.011630779,0.024640784,0.013010005,2017,HSY
2018-02-27T00:00:00Z,626,1292,51015,666,0.013054984,0.025325885,0.012270901,2018,HSY
2019-02-22T00:00:00Z,611,1326,55491,715,0.012884972,0.023895767,0.011010795,2019,HSY
2011-02-25T00:00:00Z,793,968,52243,175,0.003349731,0.018528798,0.015179067,2011,HES
2012-02-27T00:00:00Z,906,1083,56376,177,0.003139634,0.019210302,0.016070668,2012,HES
2013-02-28T00:00:00Z,862,1096,57005,234,0.004104903,0.019226384,0.015121481,2013,HES
2014-02-28T00:00:00Z,924,1102,59232,178,0.003005132,0.018604808,0.015599676,2014,HES
2015-02-27T00:00:00Z,974,1030,57190,56,0.000979192,0.018010142,0.017030949,2015,HES
2016-02-26T00:00:00Z,1101,1089,58060,-12,-0.000206683,0.018756459,0.018963142,2016,HES
2017-02-23T00:00:00Z,1140,1095,57374,-45,-0.000784327,0.0190853,0.019869627,2017,HES
2018-02-21T00:00:00Z,1173,1082,58431,-91,-0.001557392,0.018517568,0.02007496,2018,HES
2019-02-21T00:00:00Z,1138,1110,57582,-28,-0.000486263,0.019276857,0.01976312,2019,HES
2015-12-17T00:00:00Z,1551,2024,84270,473,0.005612911,0.024018037,0.018405126,2015,HPE
2016-12-15T00:00:00Z,1549,2110,89829,561,0.006245199,0.023489074,0.017243874,2016,HPE
2017-12-15T00:00:00Z,1508,1952,87084,444,0.005098526,0.022415139,0.017316614,2017,HPE
2018-12-12T00:00:00Z,1502,1978,85119,476,0.005592171,0.023238055,0.017645884,2018,HPE
2014-02-27T00:00:00Z,1264,1508,71877,244,0.003394688,0.020980286,0.017585598,2014,HLT
2015-02-18T00:00:00Z,1216,1511,71314,295,0.004136635,0.021187986,0.01705135,2015,HLT
2016-02-26T00:00:00Z,1191,1523,71355,332,0.004652792,0.021343984,0.016691192,2016,HLT
2017-02-15T00:00:00Z,1222,1504,72024,282,0.003915362,0.020881928,0.016966567,2017,HLT
2018-02-14T00:00:00Z,1195,1412,65081,217,0.003334306,0.02169604,0.018361734,2018,HLT
2019-02-13T00:00:00Z,1153,1469,66578,316,0.004746313,0.022064346,0.017318033,2019,HLT
2010-02-26T00:00:00Z,1266,1291,67511,25,0.00037031,0.01912281,0.0187525,2010,HFC
2011-02-25T00:00:00Z,1292,1265,67314,-27,-0.000401105,0.018792525,0.01919363,2011,HFC
2012-02-29T00:00:00Z,1208,1236,65795,28,0.000425564,0.018785622,0.018360058,2012,HFC
2013-02-28T00:00:00Z,1032,1039,57832,7,0.00012104,0.017965832,0.017844792,2013,HFC
2014-02-26T00:00:00Z,1064,1068,57240,4,6.99E-05,0.018658281,0.0185884,2014,HFC
2015-02-25T00:00:00Z,1065,1051,55795,-14,-0.000250919,0.018836813,0.019087732,2015,HFC
2016-02-24T00:00:00Z,1109,1025,55755,-84,-0.001506591,0.018384001,0.019890593,2016,HFC
2017-02-22T00:00:00Z,1228,1143,57590,-85,-0.001475951,0.019847196,0.021323146,2017,HFC
2018-02-21T00:00:00Z,1173,1167,59054,-6,-0.000101602,0.019761574,0.019863176,2018,HFC
2019-02-20T00:00:00Z,1151,1147,59177,-4,-6.76E-05,0.01938253,0.019450124,2019,HFC
2009-11-24T00:00:00Z,1202,1924,89342,722,0.008081306,0.021535224,0.013453919,2009,HOLX
2010-11-24T00:00:00Z,1206,1999,85445,793,0.009280824,0.023395166,0.014114343,2010,HOLX
2011-11-23T00:00:00Z,1286,1952,84583,666,0.007873923,0.023077923,0.015204001,2011,HOLX
2012-11-28T00:00:00Z,1565,2296,101192,731,0.007223891,0.022689541,0.015465649,2012,HOLX
2013-11-26T00:00:00Z,1644,2295,105200,651,0.006188213,0.021815589,0.015627376,2013,HOLX
2014-11-20T00:00:00Z,1423,1952,88890,529,0.005951176,0.021959726,0.01600855,2014,HOLX
2015-11-19T00:00:00Z,1359,1852,84080,493,0.005863463,0.022026641,0.016163178,2015,HOLX
2016-11-17T00:00:00Z,1340,1795,81462,455,0.005585426,0.022034814,0.016449387,2016,HOLX
2017-11-21T00:00:00Z,1387,1932,87113,545,0.006256242,0.022178091,0.015921849,2017,HOLX
2018-11-20T00:00:00Z,1388,1870,84487,482,0.00570502,0.022133583,0.016428563,2018,HOLX
2010-03-25T00:00:00Z,378,566,30973,188,0.006069803,0.018273981,0.012204178,2010,HD
2011-03-24T00:00:00Z,365,609,31632,244,0.007713708,0.019252656,0.011538948,2011,HD
2012-03-22T00:00:00Z,330,641,31347,311,0.009921205,0.020448528,0.010527323,2012,HD
2013-03-28T00:00:00Z,323,661,30745,338,0.010993658,0.021499431,0.010505773,2013,HD
2014-03-27T00:00:00Z,342,651,31838,309,0.009705384,0.020447264,0.010741881,2014,HD
2015-03-26T00:00:00Z,515,713,36509,198,0.00542332,0.019529431,0.014106111,2015,HD
2016-03-24T00:00:00Z,550,770,39133,220,0.005621854,0.019676488,0.014054634,2016,HD
2017-03-23T00:00:00Z,486,757,37177,271,0.007289453,0.020362052,0.013072599,2017,HD
2018-03-22T00:00:00Z,460,816,34816,356,0.010225184,0.0234375,0.013212316,2018,HD
2019-03-28T00:00:00Z,515,887,37219,372,0.009994895,0.023831914,0.013837019,2019,HD
2010-02-12T00:00:00Z,760,1196,54635,436,0.007980232,0.021890729,0.013910497,2010,HON
2011-02-11T00:00:00Z,806,1219,57687,413,0.007159325,0.021131277,0.013971952,2011,HON
2012-02-17T00:00:00Z,841,1286,58819,445,0.007565583,0.021863684,0.014298101,2012,HON
2013-02-15T00:00:00Z,840,1349,61484,509,0.008278577,0.021940667,0.013662091,2013,HON
2014-02-14T00:00:00Z,851,1371,61144,520,0.008504514,0.022422478,0.013917964,2014,HON
2015-02-13T00:00:00Z,534,871,38902,337,0.008662794,0.022389594,0.013726801,2015,HON
2016-02-12T00:00:00Z,553,868,38625,315,0.00815534,0.022472492,0.014317152,2016,HON
2017-02-10T00:00:00Z,202,307,17609,105,0.00596286,0.017434267,0.011471407,2017,HON
2018-02-09T00:00:00Z,654,1039,45704,385,0.00842377,0.02273324,0.01430947,2018,HON
2019-02-08T00:00:00Z,682,1128,48146,446,0.00926349,0.023428738,0.014165247,2019,HON
2009-12-16T00:00:00Z,80,83,8010,3,0.000374532,0.010362047,0.009987516,2009,HRL
2010-12-21T00:00:00Z,82,90,7894,8,0.001013428,0.011401064,0.010387636,2010,HRL
2011-12-21T00:00:00Z,100,84,8396,-16,-0.001905669,0.010004764,0.011910434,2011,HRL
2012-12-19T00:00:00Z,68,76,7617,8,0.001050282,0.009977682,0.008927399,2012,HRL
2013-12-18T00:00:00Z,63,75,7791,12,0.001540239,0.009626492,0.008086253,2013,HRL
2014-12-17T00:00:00Z,65,79,7963,14,0.001758131,0.009920884,0.008162753,2014,HRL
2015-12-16T00:00:00Z,75,79,8045,4,0.000497203,0.009819764,0.009322561,2015,HRL
2016-12-21T00:00:00Z,74,81,7987,7,0.000876424,0.01014148,0.009265056,2016,HRL
2017-12-20T00:00:00Z,73,86,8098,13,0.001605335,0.010619906,0.009014571,2017,HRL
2018-12-07T00:00:00Z,506,974,40451,468,0.011569553,0.024078515,0.012508961,2018,HRL
2010-03-01T00:00:00Z,1438,1751,81468,313,0.003841999,0.021493102,0.017651102,2010,HST
2011-02-24T00:00:00Z,1577,2016,92667,439,0.004737393,0.021755317,0.017017924,2011,HST
2012-02-22T00:00:00Z,1606,1918,93145,312,0.003349616,0.020591551,0.017241935,2012,HST
2013-02-25T00:00:00Z,1559,1973,94281,414,0.004391129,0.020926804,0.016535675,2013,HST
2014-02-26T00:00:00Z,1485,2037,94508,552,0.005840775,0.021553731,0.015712956,2014,HST
2015-02-25T00:00:00Z,1377,1840,88307,463,0.005243072,0.0208364,0.015593328,2015,HST
2016-02-22T00:00:00Z,1345,1856,88379,511,0.005781917,0.021000464,0.015218547,2016,HST
2017-02-24T00:00:00Z,1312,1820,86058,508,0.005902996,0.021148528,0.015245532,2017,HST
2018-02-27T00:00:00Z,1234,1630,77712,396,0.005095738,0.020974882,0.015879144,2018,HST
2019-02-26T00:00:00Z,1141,1545,74402,404,0.005429962,0.020765571,0.015335609,2019,HST
2010-12-15T00:00:00Z,1379,1862,77029,483,0.006270366,0.024172714,0.017902348,2010,HPQ
2011-12-14T00:00:00Z,1395,1839,77735,444,0.005711713,0.023657297,0.017945584,2011,HPQ
2012-12-27T00:00:00Z,1591,2056,84961,465,0.005473099,0.024199339,0.018726239,2012,HPQ
2013-12-30T00:00:00Z,1688,2001,83002,313,0.003770993,0.024107853,0.020336859,2013,HPQ
2014-12-18T00:00:00Z,1700,2043,83868,343,0.00408976,0.024359708,0.020269948,2014,HPQ
2015-12-16T00:00:00Z,1667,2120,88443,453,0.005121943,0.023970241,0.018848298,2015,HPQ
2016-12-15T00:00:00Z,1437,1786,71344,349,0.004891792,0.02503364,0.020141848,2016,HPQ
2017-12-14T00:00:00Z,1303,1660,66767,357,0.005346953,0.024862582,0.019515629,2017,HPQ
2018-12-13T00:00:00Z,1245,1682,67304,437,0.006492928,0.024991085,0.018498158,2018,HPQ
2012-02-24T00:00:00Z,1122,1873,73857,751,0.010168298,0.025359817,0.015191519,2012,HUM
2013-02-22T00:00:00Z,1074,1865,74081,791,0.010677502,0.025175146,0.014497644,2013,HUM
2014-02-19T00:00:00Z,1133,1935,76835,802,0.010437951,0.025183835,0.014745884,2014,HUM
2015-02-18T00:00:00Z,1126,1850,72678,724,0.009961749,0.025454746,0.015492997,2015,HUM
2016-02-18T00:00:00Z,1357,2123,81776,766,0.009367051,0.025961162,0.016594111,2016,HUM
2017-02-17T00:00:00Z,1441,2177,82467,736,0.008924782,0.026398438,0.017473656,2017,HUM
2018-02-16T00:00:00Z,1292,2055,81319,763,0.009382801,0.025270847,0.015888046,2018,HUM
2019-02-21T00:00:00Z,1130,1800,72647,670,0.00922268,0.024777348,0.015554668,2019,HUM
2010-02-18T00:00:00Z,2103,2410,104149,307,0.0029477,0.023139925,0.020192225,2010,HBAN
2011-02-18T00:00:00Z,2058,2392,100591,334,0.003320377,0.023779463,0.020459087,2011,HBAN
2012-02-17T00:00:00Z,2054,2420,102811,366,0.00355993,0.023538337,0.019978407,2012,HBAN
2013-02-15T00:00:00Z,2010,2392,102269,382,0.003735247,0.023389297,0.01965405,2013,HBAN
2014-02-14T00:00:00Z,1939,2317,99307,378,0.003806378,0.023331689,0.01952531,2014,HBAN
2015-02-13T00:00:00Z,2005,2309,100698,304,0.003018928,0.022929949,0.019911021,2015,HBAN
2016-02-17T00:00:00Z,1971,2214,99613,243,0.002439441,0.022226015,0.019786574,2016,HBAN
2017-02-22T00:00:00Z,1879,2230,96470,351,0.003638437,0.023115995,0.019477558,2017,HBAN
2018-02-16T00:00:00Z,1947,2223,93979,276,0.002936826,0.023654221,0.020717394,2018,HBAN
2019-02-15T00:00:00Z,1865,2060,89939,195,0.002168136,0.022904413,0.020736277,2019,HBAN
2012-03-29T00:00:00Z,1252,1550,68533,298,0.00434827,0.022616842,0.018268571,2012,HII
2013-02-27T00:00:00Z,1286,1642,70014,356,0.005084697,0.023452452,0.018367755,2013,HII
2014-02-27T00:00:00Z,1231,1673,69008,442,0.006405054,0.024243566,0.017838511,2014,HII
2015-02-19T00:00:00Z,1254,1697,70015,443,0.006327216,0.024237663,0.017910448,2015,HII
2016-02-18T00:00:00Z,1230,1688,68604,458,0.006675996,0.024604979,0.017928984,2016,HII
2017-02-16T00:00:00Z,1203,1721,67981,518,0.007619776,0.025315897,0.017696121,2017,HII
2018-02-15T00:00:00Z,1166,1673,66949,507,0.007572929,0.024989171,0.017416242,2018,HII
2019-02-14T00:00:00Z,1082,1677,68329,595,0.008707869,0.02454302,0.015835151,2019,HII
2010-02-19T00:00:00Z,696,1145,55370,449,0.008109084,0.020679068,0.012569984,2010,IDXX
2011-02-22T00:00:00Z,699,1132,54988,433,0.007874445,0.02058631,0.012711864,2011,IDXX
2012-02-17T00:00:00Z,138,218,13638,80,0.005865963,0.015984748,0.010118786,2012,IDXX
2013-02-19T00:00:00Z,733,1296,58873,563,0.009562958,0.022013487,0.012450529,2013,IDXX
2014-02-18T00:00:00Z,718,1348,60040,630,0.010493005,0.022451699,0.011958694,2014,IDXX
2015-02-17T00:00:00Z,746,1394,64052,648,0.01011678,0.021763567,0.011646787,2015,IDXX
2016-02-17T00:00:00Z,858,1509,68325,651,0.009527991,0.02208562,0.012557629,2016,IDXX
2017-02-17T00:00:00Z,945,1585,72531,640,0.008823813,0.021852725,0.013028912,2017,IDXX
2018-02-16T00:00:00Z,1027,1645,73897,618,0.008362992,0.022260714,0.013897723,2018,IDXX
2019-02-15T00:00:00Z,1005,1653,73412,648,0.008826895,0.022516755,0.01368986,2019,IDXX
2017-01-27T00:00:00Z,805,1142,53272,337,0.006326025,0.021437153,0.015111128,2017,INFO
2018-01-23T00:00:00Z,839,1140,53868,301,0.005587733,0.021162843,0.01557511,2018,INFO
2019-01-18T00:00:00Z,865,1253,58113,388,0.006676647,0.021561441,0.014884793,2019,INFO
2010-02-26T00:00:00Z,485,770,32027,285,0.008898742,0.024042214,0.015143473,2010,ITW
2011-02-28T00:00:00Z,470,832,32328,362,0.011197723,0.025736204,0.014538481,2011,ITW
2012-02-17T00:00:00Z,446,825,33511,379,0.011309719,0.024618782,0.013309063,2012,ITW
2013-02-19T00:00:00Z,474,843,37235,369,0.009910031,0.022639989,0.012729958,2013,ITW
2014-02-14T00:00:00Z,481,818,38243,337,0.00881207,0.021389535,0.012577465,2014,ITW
2015-02-13T00:00:00Z,492,853,37911,361,0.009522302,0.022500066,0.012977764,2015,ITW
2016-02-12T00:00:00Z,525,966,35981,441,0.012256469,0.026847503,0.014591034,2016,ITW
2017-02-10T00:00:00Z,517,1049,36771,532,0.014467923,0.028527916,0.014059993,2017,ITW
2018-02-15T00:00:00Z,478,1097,37540,619,0.016489078,0.029222163,0.012733085,2018,ITW
2019-02-15T00:00:00Z,471,1096,38434,625,0.016261643,0.028516418,0.012254774,2019,ITW
2011-02-28T00:00:00Z,695,1087,47123,392,0.008318655,0.023067292,0.014748637,2011,ILMN
2012-02-24T00:00:00Z,743,1135,49471,392,0.007923834,0.022942734,0.0150189,2012,ILMN
2013-02-15T00:00:00Z,798,1193,50045,395,0.007892896,0.023838545,0.015945649,2013,ILMN
2014-02-18T00:00:00Z,836,1219,49795,383,0.007691535,0.02448037,0.016788834,2014,ILMN
2015-02-18T00:00:00Z,813,1105,48674,292,0.005999096,0.022702059,0.016702963,2015,ILMN
2016-03-02T00:00:00Z,818,1053,47327,235,0.004965453,0.022249456,0.017284003,2016,ILMN
2017-02-14T00:00:00Z,831,1075,47825,244,0.005101934,0.022477784,0.017375849,2017,ILMN
2018-02-13T00:00:00Z,763,1029,45472,266,0.005849754,0.02262931,0.016779557,2018,ILMN
2019-02-12T00:00:00Z,763,1014,45823,251,0.005477599,0.022128625,0.016651027,2019,ILMN
2010-02-26T00:00:00Z,1110,1565,67284,455,0.00676238,0.023259616,0.016497236,2010,IR
2011-02-22T00:00:00Z,1057,1543,64952,486,0.007482449,0.023756004,0.016273556,2011,IR
2012-02-21T00:00:00Z,866,1374,56493,508,0.008992265,0.024321597,0.015329333,2012,IR
2013-02-14T00:00:00Z,941,1481,58563,540,0.009220839,0.025289005,0.016068166,2013,IR
2014-02-14T00:00:00Z,960,1349,59938,389,0.00649004,0.02250659,0.01601655,2014,IR
2015-02-13T00:00:00Z,960,1287,58699,327,0.005570793,0.021925416,0.016354623,2015,IR
2016-02-12T00:00:00Z,860,1192,54988,332,0.006037681,0.021677457,0.015639776,2016,IR
2017-02-13T00:00:00Z,826,1134,52624,308,0.005852843,0.021549103,0.01569626,2017,IR
2018-02-12T00:00:00Z,832,1217,54781,385,0.007027984,0.022215732,0.015187748,2018,IR
2019-02-12T00:00:00Z,749,1197,51560,448,0.008688906,0.023215671,0.014526765,2019,IR
2010-02-22T00:00:00Z,1174,1605,66709,431,0.006460897,0.024059722,0.017598825,2010,INTC
2011-02-18T00:00:00Z,1168,1662,66701,494,0.007406186,0.024917168,0.017510982,2011,INTC
2012-02-23T00:00:00Z,1105,1447,61317,342,0.005577572,0.023598676,0.018021103,2012,INTC
2013-02-19T00:00:00Z,1090,1421,60643,331,0.005458173,0.023432218,0.017974045,2013,INTC
2014-02-14T00:00:00Z,1093,1525,62547,432,0.006906806,0.024381665,0.017474859,2014,INTC
2015-02-13T00:00:00Z,1165,1535,63195,370,0.005854894,0.024289896,0.018435003,2015,INTC
2016-02-12T00:00:00Z,1170,1681,66881,511,0.007640436,0.025134194,0.017493758,2016,INTC
2017-02-17T00:00:00Z,1003,1424,58707,421,0.007171206,0.024256051,0.017084845,2017,INTC
2018-02-16T00:00:00Z,918,1373,53373,455,0.00852491,0.025724617,0.017199708,2018,INTC
2019-02-01T00:00:00Z,1062,1644,61065,582,0.009530828,0.026922132,0.017391304,2019,INTC
2014-02-14T00:00:00Z,1424,2060,97362,636,0.006532323,0.021158152,0.014625829,2014,ICE
2015-02-05T00:00:00Z,1452,2018,96096,566,0.005889943,0.020999833,0.01510989,2015,ICE
2016-02-04T00:00:00Z,1449,1914,92578,465,0.005022792,0.020674458,0.015651667,2016,ICE
2017-02-07T00:00:00Z,1414,1910,90615,496,0.005473707,0.021078188,0.01560448,2017,ICE
2018-02-07T00:00:00Z,1343,1892,90489,549,0.006067036,0.020908619,0.014841583,2018,ICE
2019-02-07T00:00:00Z,1378,1767,83867,389,0.004638296,0.021069074,0.016430777,2019,ICE
2010-02-23T00:00:00Z,186,358,13323,172,0.012910005,0.026870825,0.01396082,2010,IBM
2011-02-22T00:00:00Z,197,386,13879,189,0.013617696,0.027811802,0.014194106,2011,IBM
2012-02-28T00:00:00Z,214,430,14283,216,0.015122873,0.03010572,0.014982847,2012,IBM
2013-02-26T00:00:00Z,224,469,15337,245,0.015974441,0.030579644,0.014605203,2013,IBM
2014-02-25T00:00:00Z,264,475,16047,211,0.013148875,0.029600548,0.016451673,2014,IBM
2015-02-24T00:00:00Z,281,460,16896,179,0.010594223,0.027225379,0.016631155,2015,IBM
2016-02-23T00:00:00Z,293,426,16782,133,0.007925158,0.02538434,0.017459182,2016,IBM
2017-02-28T00:00:00Z,298,403,16454,105,0.006381427,0.024492525,0.018111098,2017,IBM
2018-02-27T00:00:00Z,307,422,16809,115,0.006841573,0.025105598,0.018264025,2018,IBM
2019-02-26T00:00:00Z,303,395,16594,92,0.005544173,0.023803785,0.018259612,2019,IBM
2013-02-21T00:00:00Z,975,1264,54125,289,0.005339492,0.023353349,0.018013857,2013,INCY
2014-02-21T00:00:00Z,1115,1315,58553,200,0.003415709,0.022458286,0.019042577,2014,INCY
2015-02-17T00:00:00Z,1169,1356,62473,187,0.002993293,0.021705377,0.018712084,2015,INCY
2016-02-12T00:00:00Z,1186,1410,65513,224,0.003419169,0.021522446,0.018103277,2016,INCY
2017-02-14T00:00:00Z,1282,1691,80257,409,0.005096129,0.021069813,0.015973685,2017,INCY
2018-02-15T00:00:00Z,1354,1776,81092,422,0.005203966,0.021901051,0.016697085,2018,INCY
2019-02-14T00:00:00Z,1330,1687,79451,357,0.004493336,0.021233213,0.016739877,2019,INCY
2011-02-25T00:00:00Z,863,1499,64660,636,0.009836066,0.023182802,0.013346737,2011,IP
2012-02-27T00:00:00Z,979,1487,66783,508,0.007606726,0.022266146,0.014659419,2012,IP
2013-02-26T00:00:00Z,870,1300,62525,430,0.006877249,0.020791683,0.013914434,2013,IP
2014-02-27T00:00:00Z,939,1429,63765,490,0.007684466,0.022410413,0.014725947,2014,IP
2015-02-26T00:00:00Z,906,1358,60120,452,0.007518297,0.022588157,0.01506986,2015,IP
2016-02-25T00:00:00Z,898,1334,57050,436,0.007642419,0.023382997,0.015740578,2016,IP
2017-02-22T00:00:00Z,845,1251,55629,406,0.007298352,0.022488271,0.015189919,2017,IP
2018-02-22T00:00:00Z,808,1247,54538,439,0.008049433,0.022864792,0.014815358,2018,IP
2019-02-20T00:00:00Z,784,1175,53442,391,0.007316343,0.021986453,0.01467011,2019,IP
2010-02-26T00:00:00Z,650,1479,59498,829,0.013933241,0.024857978,0.010924737,2010,IPG
2011-02-25T00:00:00Z,573,1436,53075,863,0.016260009,0.027056053,0.010796043,2011,IPG
2012-02-24T00:00:00Z,532,1350,50545,818,0.016183599,0.026708873,0.010525275,2012,IPG
2013-02-22T00:00:00Z,548,1343,51474,795,0.015444691,0.026090842,0.010646151,2013,IPG
2014-02-24T00:00:00Z,555,1354,50459,799,0.015834638,0.026833667,0.010999029,2014,IPG
2015-02-23T00:00:00Z,564,1385,50302,821,0.016321419,0.027533696,0.011212278,2015,IPG
2016-02-22T00:00:00Z,601,1385,50543,784,0.015511545,0.02740241,0.011890865,2016,IPG
2017-02-21T00:00:00Z,547,1281,48281,734,0.015202668,0.026532176,0.011329509,2017,IPG
2018-02-26T00:00:00Z,577,1317,50684,740,0.014600268,0.025984532,0.011384263,2018,IPG
2019-02-25T00:00:00Z,598,1364,55105,766,0.013900735,0.024752745,0.01085201,2019,IPG
2010-02-25T00:00:00Z,496,976,39179,480,0.012251461,0.024911305,0.012659843,2010,IFF
2011-02-24T00:00:00Z,531,999,39770,468,0.011767664,0.025119437,0.013351773,2011,IFF
2012-02-28T00:00:00Z,593,1293,46254,700,0.015133826,0.027954339,0.012820513,2012,IFF
2013-02-26T00:00:00Z,569,1305,47299,736,0.015560583,0.027590435,0.012029853,2013,IFF
2014-02-25T00:00:00Z,637,1401,50757,764,0.015052111,0.027602104,0.012549993,2014,IFF
2015-03-02T00:00:00Z,641,1339,49155,698,0.01419998,0.027240362,0.013040382,2015,IFF
2016-03-01T00:00:00Z,743,1439,52529,696,0.013249824,0.027394392,0.014144568,2016,IFF
2017-02-28T00:00:00Z,823,1575,57154,752,0.013157434,0.027557126,0.014399692,2017,IFF
2018-02-27T00:00:00Z,865,1699,62860,834,0.013267579,0.027028317,0.013760738,2018,IFF
2019-02-26T00:00:00Z,997,1755,73921,758,0.01025419,0.023741562,0.013487372,2019,IFF
2009-09-15T00:00:00Z,862,1228,58472,366,0.006259406,0.021001505,0.014742099,2009,INTU
2010-09-16T00:00:00Z,848,1298,57370,450,0.007843821,0.022625065,0.014781245,2010,INTU
2011-09-14T00:00:00Z,826,1349,57422,523,0.009108007,0.023492738,0.014384731,2011,INTU
2012-09-13T00:00:00Z,915,1435,60162,520,0.00864333,0.023852266,0.015208936,2012,INTU
2013-09-13T00:00:00Z,981,1435,60410,454,0.007515312,0.023754345,0.016239033,2013,INTU
2014-09-12T00:00:00Z,934,1371,56889,437,0.007681626,0.024099562,0.016417937,2014,INTU
2015-09-01T00:00:00Z,989,1369,57035,380,0.006662576,0.024002805,0.01734023,2015,INTU
2016-09-01T00:00:00Z,1007,1411,57345,404,0.007045078,0.024605458,0.01756038,2016,INTU
2017-09-01T00:00:00Z,998,1365,56222,367,0.006527694,0.024278752,0.017751058,2017,INTU
2018-08-31T00:00:00Z,997,1397,57892,400,0.006909418,0.024131141,0.017221723,2018,INTU
2010-01-29T00:00:00Z,790,1128,45647,338,0.007404649,0.024711372,0.017306723,2010,ISRG
2011-02-01T00:00:00Z,817,1140,48110,323,0.006713781,0.023695697,0.016981916,2011,ISRG
2012-02-06T00:00:00Z,835,1047,47518,212,0.004461467,0.022033756,0.017572288,2012,ISRG
2013-02-04T00:00:00Z,885,1089,50748,204,0.004019863,0.021458974,0.017439111,2013,ISRG
2014-02-03T00:00:00Z,1109,1258,57355,149,0.002597855,0.021933572,0.019335716,2014,ISRG
2015-02-06T00:00:00Z,1198,1291,61370,93,0.001515398,0.021036337,0.019520939,2015,ISRG
2016-02-02T00:00:00Z,1237,1295,61187,58,0.000947914,0.021164626,0.020216713,2016,ISRG
2017-02-06T00:00:00Z,1229,1315,62384,86,0.001378559,0.021079123,0.019700564,2017,ISRG
2018-02-02T00:00:00Z,1272,1376,65517,104,0.001587374,0.021002183,0.019414808,2018,ISRG
2019-02-04T00:00:00Z,1270,1406,66884,136,0.002033371,0.02102147,0.018988099,2019,ISRG
2011-02-25T00:00:00Z,1271,2273,87398,1002,0.011464793,0.02600746,0.014542667,2011,IVZ
2012-02-24T00:00:00Z,1147,1910,78453,763,0.009725568,0.024345787,0.014620218,2012,IVZ
2013-02-22T00:00:00Z,1198,1860,76517,662,0.008651672,0.024308324,0.015656651,2013,IVZ
2014-02-21T00:00:00Z,1320,2015,82340,695,0.008440612,0.024471703,0.016031091,2014,IVZ
2015-02-20T00:00:00Z,1339,1978,80427,639,0.007945093,0.024593731,0.016648638,2015,IVZ
2016-02-19T00:00:00Z,1405,1952,80990,547,0.00675392,0.024101741,0.017347821,2016,IVZ
2017-02-23T00:00:00Z,1386,1925,79341,539,0.006793461,0.024262361,0.0174689,2017,IVZ
2018-02-23T00:00:00Z,1341,2000,80214,659,0.008215523,0.024933303,0.01671778,2018,IVZ
2019-02-22T00:00:00Z,1309,1883,76572,574,0.007496213,0.024591234,0.017095022,2019,IVZ
2010-03-15T00:00:00Z,719,929,42351,210,0.004958561,0.021935728,0.016977167,2010,IPGP
2011-03-15T00:00:00Z,701,907,42796,206,0.004813534,0.021193569,0.016380036,2011,IPGP
2012-02-27T00:00:00Z,700,948,44355,248,0.005591252,0.021373013,0.015781761,2012,IPGP
2013-02-28T00:00:00Z,697,1000,45642,303,0.006638622,0.021909645,0.015271022,2013,IPGP
2014-02-28T00:00:00Z,709,981,44585,272,0.006100707,0.022002916,0.015902209,2014,IPGP
2015-03-02T00:00:00Z,714,977,45042,263,0.005838995,0.021690866,0.015851872,2015,IPGP
2016-02-26T00:00:00Z,750,1013,46845,263,0.00561426,0.021624506,0.016010247,2016,IPGP
2017-02-27T00:00:00Z,750,1066,49648,316,0.006364808,0.021471157,0.015106349,2017,IPGP
2018-02-28T00:00:00Z,776,1127,50819,351,0.006906866,0.022176745,0.015269879,2018,IPGP
2019-02-27T00:00:00Z,820,1178,55708,358,0.006426366,0.021145975,0.014719609,2019,IPGP
2014-02-13T00:00:00Z,245,262,14753,17,0.001152308,0.0177591,0.016606792,2014,IQV
2015-02-12T00:00:00Z,245,260,14156,15,0.001059621,0.01836677,0.017307149,2015,IQV
2016-02-11T00:00:00Z,1054,1571,64601,517,0.008002972,0.024318509,0.016315537,2016,IQV
2017-02-16T00:00:00Z,320,384,19331,64,0.003310744,0.019864466,0.016553722,2017,IQV
2018-02-16T00:00:00Z,1399,1922,77601,523,0.006739604,0.024767722,0.018028118,2018,IQV
2019-02-19T00:00:00Z,1360,1908,76591,548,0.007154888,0.024911543,0.017756655,2019,IQV
2010-02-26T00:00:00Z,827,1283,57550,456,0.007923545,0.022293658,0.014370113,2010,IRM
2011-03-01T00:00:00Z,974,1395,63544,421,0.00662533,0.021953292,0.015327962,2011,IRM
2012-02-28T00:00:00Z,1263,1540,71787,277,0.003858637,0.021452352,0.017593715,2012,IRM
2013-03-01T00:00:00Z,1196,1553,70981,357,0.005029515,0.021879094,0.016849579,2013,IRM
2014-02-28T00:00:00Z,1215,1683,73801,468,0.006341377,0.022804569,0.016463192,2014,IRM
2015-02-27T00:00:00Z,1290,1647,80217,357,0.004450428,0.020531807,0.016081379,2015,IRM
2016-02-26T00:00:00Z,1290,1716,84756,426,0.005026193,0.020246354,0.015220161,2016,IRM
2017-02-23T00:00:00Z,1258,1749,92099,491,0.00533122,0.018990434,0.013659215,2017,IRM
2018-02-16T00:00:00Z,1408,1991,104192,583,0.005595439,0.019108953,0.013513514,2018,IRM
2019-02-14T00:00:00Z,1358,1794,95508,436,0.004565063,0.018783767,0.014218704,2019,IRM
2011-08-29T00:00:00Z,342,797,30943,455,0.014704457,0.025757037,0.011052581,2011,JKHY
2012-08-27T00:00:00Z,321,798,29958,477,0.015922291,0.026637292,0.010715001,2012,JKHY
2013-08-27T00:00:00Z,322,744,27989,422,0.015077352,0.026581871,0.01150452,2013,JKHY
2014-08-27T00:00:00Z,327,718,27888,391,0.014020367,0.025745841,0.011725473,2014,JKHY
2015-09-11T00:00:00Z,417,785,31170,368,0.011806224,0.025184472,0.013378248,2015,JKHY
2016-08-29T00:00:00Z,401,833,31925,432,0.013531715,0.026092404,0.012560689,2016,JKHY
2017-08-25T00:00:00Z,365,846,32344,481,0.014871383,0.02615632,0.011284937,2017,JKHY
2018-08-24T00:00:00Z,400,882,34723,482,0.013881289,0.025401031,0.011519742,2018,JKHY
2009-11-20T00:00:00Z,654,846,41385,192,0.004639362,0.020442189,0.015802827,2009,JEC
2010-11-23T00:00:00Z,675,907,43923,232,0.005281971,0.020649773,0.015367803,2010,JEC
2011-11-21T00:00:00Z,722,1041,48758,319,0.006542516,0.021350343,0.014807826,2011,JEC
2012-11-20T00:00:00Z,785,1168,51917,383,0.00737716,0.022497448,0.015120288,2012,JEC
2013-11-22T00:00:00Z,814,1167,52806,353,0.006684846,0.022099761,0.015414915,2013,JEC
2014-11-24T00:00:00Z,811,1189,52438,378,0.007208513,0.022674396,0.015465884,2014,JEC
2015-11-24T00:00:00Z,955,1312,57231,357,0.006237878,0.022924639,0.016686761,2015,JEC
2016-11-22T00:00:00Z,1032,1336,57470,304,0.005289716,0.023246911,0.017957195,2016,JEC
2017-11-21T00:00:00Z,1123,1501,64988,378,0.005816458,0.023096572,0.017280113,2017,JEC
2018-11-21T00:00:00Z,1133,1558,66396,425,0.006400988,0.023465269,0.017064281,2018,JEC
2010-02-26T00:00:00Z,353,450,24480,97,0.003962418,0.018382353,0.014419935,2010,JBHT
2011-02-25T00:00:00Z,338,429,23048,91,0.003948282,0.018613329,0.014665047,2011,JBHT
2012-02-24T00:00:00Z,330,448,23377,118,0.005047696,0.019164136,0.014116439,2012,JBHT
2013-02-22T00:00:00Z,304,392,22290,88,0.003947959,0.017586362,0.013638403,2013,JBHT
2014-02-21T00:00:00Z,313,377,22054,64,0.002901968,0.017094405,0.014192437,2014,JBHT
2015-02-24T00:00:00Z,338,381,22836,43,0.001882992,0.016684183,0.014801191,2015,JBHT
2016-02-23T00:00:00Z,356,406,23500,50,0.00212766,0.017276596,0.015148936,2016,JBHT
2017-02-23T00:00:00Z,365,425,23424,60,0.002561475,0.018143784,0.015582309,2017,JBHT
2018-02-23T00:00:00Z,372,447,24067,75,0.0031163,0.01857315,0.01545685,2018,JBHT
2019-02-22T00:00:00Z,192,236,13168,44,0.003341434,0.017922236,0.014580802,2019,JBHT
2012-02-27T00:00:00Z,1843,2794,117643,951,0.008083779,0.023749819,0.01566604,2012,JEF
2013-02-25T00:00:00Z,1909,3212,126866,1303,0.010270679,0.025318052,0.015047373,2013,JEF
2014-02-28T00:00:00Z,2099,3328,128528,1229,0.009562119,0.025893191,0.016331072,2014,JEF
2015-02-27T00:00:00Z,2097,3358,130224,1261,0.009683315,0.025786337,0.016103022,2015,JEF
2016-02-19T00:00:00Z,2154,3309,131887,1155,0.008757497,0.02508966,0.016332163,2016,JEF
2017-02-27T00:00:00Z,1602,2182,90649,580,0.006398306,0.024070867,0.017672561,2017,JEF
2018-02-27T00:00:00Z,1602,2250,93598,648,0.006923225,0.024038975,0.01711575,2018,JEF
2009-06-26T00:00:00Z,206,237,14850,31,0.002087542,0.015959596,0.013872054,2009,SJM
2010-06-24T00:00:00Z,247,247,16085,0,0,0.015355922,0.015355922,2010,SJM
2011-06-28T00:00:00Z,255,273,15947,18,0.001128739,0.017119207,0.015990468,2011,SJM
2012-06-25T00:00:00Z,274,276,16013,2,0.000124899,0.017235996,0.017111097,2012,SJM
2013-06-21T00:00:00Z,273,264,14717,-9,-0.000611538,0.017938439,0.018549976,2013,SJM
2014-06-23T00:00:00Z,77,55,5557,-22,-0.003958971,0.009897427,0.013856397,2014,SJM
2015-06-25T00:00:00Z,88,63,6512,-25,-0.003839066,0.009674447,0.013513514,2015,SJM
2016-06-21T00:00:00Z,278,263,13908,-15,-0.001078516,0.01890998,0.019988496,2016,SJM
2017-06-19T00:00:00Z,286,266,13798,-20,-0.001449485,0.019278156,0.020727642,2017,SJM
2018-06-18T00:00:00Z,337,309,15120,-28,-0.001851852,0.020436508,0.02228836,2018,SJM
2010-03-01T00:00:00Z,59,114,8672,55,0.006342251,0.013145756,0.006803506,2010,JNJ
2011-02-25T00:00:00Z,70,118,8623,48,0.005566508,0.013684333,0.008117824,2011,JNJ
2012-02-23T00:00:00Z,72,114,8575,42,0.004897959,0.013294461,0.008396501,2012,JNJ
2013-02-22T00:00:00Z,65,110,8112,45,0.005547337,0.013560158,0.008012821,2013,JNJ
2014-02-21T00:00:00Z,61,112,8267,51,0.006169106,0.013547841,0.007378735,2014,JNJ
2015-02-24T00:00:00Z,77,110,8740,33,0.003775744,0.012585812,0.008810069,2015,JNJ
2016-02-24T00:00:00Z,771,998,50431,227,0.0045012,0.019789415,0.015288216,2016,JNJ
2017-02-27T00:00:00Z,899,1163,55701,264,0.004739592,0.020879338,0.016139746,2017,JNJ
2018-02-21T00:00:00Z,867,1137,55654,270,0.004851403,0.020429798,0.015578395,2018,JNJ
2019-02-20T00:00:00Z,952,1250,61190,298,0.004870077,0.020428175,0.015558098,2019,JNJ
2009-11-17T00:00:00Z,1527,2130,85626,603,0.007042254,0.024875622,0.017833368,2009,JCI
2010-11-12T00:00:00Z,1340,1837,79066,497,0.006285888,0.023233754,0.016947866,2010,JCI
2011-11-16T00:00:00Z,1274,1831,81013,557,0.00687544,0.022601311,0.015725871,2011,JCI
2012-11-16T00:00:00Z,1411,1618,78791,207,0.002627204,0.02053534,0.017908137,2012,JCI
2013-11-14T00:00:00Z,1408,1626,77696,218,0.002805807,0.020927718,0.018121911,2013,JCI
2014-11-14T00:00:00Z,1394,1587,78484,193,0.0024591,0.020220682,0.017761582,2014,JCI
2015-11-13T00:00:00Z,1372,1708,75939,336,0.004424604,0.022491737,0.018067133,2015,JCI
2016-11-23T00:00:00Z,1408,1916,85539,508,0.005938812,0.02239914,0.016460328,2016,JCI
2017-11-21T00:00:00Z,1440,1872,84118,432,0.005135643,0.022254452,0.017118809,2017,JCI
2018-11-20T00:00:00Z,1246,1831,78552,585,0.007447296,0.0233094,0.015862104,2018,JCI
2010-02-24T00:00:00Z,4064,4103,186567,39,0.00020904,0.021992099,0.021783059,2010,JPM
2011-02-28T00:00:00Z,4251,4362,206264,111,0.000538145,0.021147655,0.02060951,2011,JPM
2012-02-29T00:00:00Z,4110,3825,190914,-285,-0.001492819,0.020035199,0.021528018,2012,JPM
2013-02-28T00:00:00Z,4656,3969,202076,-687,-0.003399711,0.019641125,0.023040836,2013,JPM
2014-02-20T00:00:00Z,4271,3972,196189,-299,-0.001524041,0.020245783,0.021769824,2014,JPM
2015-02-24T00:00:00Z,4043,3707,181037,-336,-0.001855974,0.020476477,0.022332451,2015,JPM
2016-02-23T00:00:00Z,3884,3682,175689,-202,-0.001149759,0.020957487,0.022107246,2016,JPM
2017-02-28T00:00:00Z,3835,3577,171921,-258,-0.001500689,0.020806068,0.022306757,2017,JPM
2018-02-27T00:00:00Z,4028,3531,171485,-497,-0.002898213,0.020590722,0.023488935,2018,JPM
2019-02-26T00:00:00Z,4174,3610,186846,-564,-0.003018529,0.019320724,0.022339253,2019,JPM
2010-02-26T00:00:00Z,993,1366,64218,373,0.00580834,0.021271295,0.015462954,2010,JNPR
2011-02-25T00:00:00Z,927,1241,61103,314,0.005138864,0.020309968,0.015171105,2011,JNPR
2012-02-24T00:00:00Z,981,1311,60535,330,0.005451392,0.021656893,0.016205501,2012,JNPR
2013-02-26T00:00:00Z,971,1427,61274,456,0.007441982,0.023288834,0.015846852,2013,JNPR
2014-02-26T00:00:00Z,946,1389,58787,443,0.00753568,0.023627673,0.016091993,2014,JNPR
2015-02-20T00:00:00Z,1074,1557,64488,483,0.007489766,0.024144027,0.016654261,2015,JNPR
2016-02-19T00:00:00Z,1233,1718,70762,485,0.006853961,0.024278568,0.017424606,2016,JNPR
2017-02-24T00:00:00Z,1269,1648,70233,379,0.005396324,0.023464753,0.018068429,2017,JNPR
2018-02-23T00:00:00Z,1245,1511,66110,266,0.004023597,0.022855846,0.018832249,2018,JNPR
2019-02-22T00:00:00Z,1321,1545,67020,224,0.003342286,0.02305282,0.019710534,2019,JNPR
2010-02-12T00:00:00Z,1260,1083,63392,-177,-0.00279215,0.017084175,0.019876325,2010,KSU
2011-02-09T00:00:00Z,1348,1122,65293,-226,-0.003461321,0.017184078,0.020645398,2011,KSU
2012-02-08T00:00:00Z,1281,1130,64472,-151,-0.002342102,0.017526988,0.01986909,2012,KSU
2013-02-04T00:00:00Z,1237,1079,61543,-158,-0.002567311,0.017532457,0.020099768,2013,KSU
2014-01-31T00:00:00Z,1314,1122,63556,-192,-0.003020958,0.017653723,0.020674681,2014,KSU
2015-01-30T00:00:00Z,1195,938,56072,-257,-0.004583393,0.016728492,0.021311885,2015,KSU
2016-01-29T00:00:00Z,1127,860,53304,-267,-0.005009005,0.016133874,0.021142879,2016,KSU
2017-01-27T00:00:00Z,1027,801,50451,-226,-0.004479594,0.015876791,0.020356385,2017,KSU
2018-01-26T00:00:00Z,997,870,50692,-127,-0.002505326,0.017162471,0.019667798,2018,KSU
2019-01-25T00:00:00Z,1020,939,50574,-81,-0.001601613,0.018566853,0.020168466,2019,KSU
2010-02-26T00:00:00Z,660,1084,44298,424,0.009571538,0.024470631,0.014899093,2010,K
2011-02-25T00:00:00Z,664,1082,44288,418,0.009438223,0.024430997,0.014992775,2011,K
2012-02-29T00:00:00Z,674,1054,43859,380,0.008664128,0.024031556,0.015367427,2012,K
2013-02-26T00:00:00Z,748,1121,47752,373,0.007811191,0.023475457,0.015664265,2013,K
2014-02-24T00:00:00Z,756,1255,51611,499,0.009668482,0.024316522,0.01464804,2014,K
2015-02-25T00:00:00Z,817,1296,54487,479,0.008791088,0.02378549,0.014994402,2015,K
2016-02-24T00:00:00Z,899,1491,60013,592,0.009864529,0.024844617,0.014980088,2016,K
2017-02-21T00:00:00Z,1022,1724,67744,702,0.010362541,0.025448748,0.015086207,2017,K
2018-02-20T00:00:00Z,1073,1879,73130,806,0.011021469,0.02569397,0.014672501,2018,K
2019-02-25T00:00:00Z,1055,1788,69380,733,0.010565004,0.025771116,0.015206111,2019,K
2011-02-24T00:00:00Z,2594,2808,113513,214,0.001885247,0.024737255,0.022852008,2011,KEY
2012-02-27T00:00:00Z,2454,2765,112983,311,0.002752627,0.024472708,0.021720082,2012,KEY
2013-02-26T00:00:00Z,2467,2903,116147,436,0.003753864,0.024994188,0.021240325,2013,KEY
2014-02-26T00:00:00Z,2370,2946,116903,576,0.004927162,0.02520038,0.020273218,2014,KEY
2015-03-02T00:00:00Z,1872,2355,96178,483,0.005021938,0.024485849,0.019463911,2015,KEY
2016-02-24T00:00:00Z,742,747,39658,5,0.000126078,0.018836048,0.01870997,2016,KEY
2017-02-28T00:00:00Z,2427,3037,119306,610,0.005112903,0.025455551,0.020342648,2017,KEY
2018-02-26T00:00:00Z,2202,2640,106055,438,0.004129933,0.024892744,0.020762812,2018,KEY
2019-02-25T00:00:00Z,2148,2466,105338,318,0.003018854,0.023410355,0.020391502,2019,KEY
2014-12-22T00:00:00Z,806,1455,56348,649,0.011517711,0.02582168,0.014303968,2014,KEYS
2015-12-21T00:00:00Z,816,1522,58026,706,0.01216696,0.026229621,0.014062662,2015,KEYS
2016-12-19T00:00:00Z,872,1506,59675,634,0.010624214,0.025236699,0.014612484,2016,KEYS
2017-12-20T00:00:00Z,989,1745,66739,756,0.011327709,0.026146631,0.014818921,2017,KEYS
2018-12-18T00:00:00Z,993,1752,65124,759,0.01165469,0.026902524,0.015247835,2018,KEYS
2010-02-24T00:00:00Z,631,1127,44406,496,0.011169662,0.025379453,0.014209791,2010,KMB
2011-02-23T00:00:00Z,626,1055,41301,429,0.010387158,0.025544176,0.015157018,2011,KMB
2012-02-29T00:00:00Z,532,995,36935,463,0.012535535,0.026939218,0.014403682,2012,KMB
2013-02-22T00:00:00Z,507,969,35831,462,0.012893863,0.027043621,0.014149759,2013,KMB
2014-02-14T00:00:00Z,542,952,36005,410,0.011387307,0.026440772,0.015053465,2014,KMB
2015-02-18T00:00:00Z,498,864,34308,366,0.010668066,0.025183631,0.014515565,2015,KMB
2016-02-11T00:00:00Z,502,866,34092,364,0.010676992,0.025401854,0.014724862,2016,KMB
2017-02-08T00:00:00Z,463,758,31090,295,0.009488582,0.02438083,0.014892248,2017,KMB
2018-02-08T00:00:00Z,433,798,31408,365,0.011621243,0.025407539,0.013786296,2018,KMB
2019-02-07T00:00:00Z,456,862,32720,406,0.012408313,0.026344743,0.01393643,2019,KMB
2011-02-28T00:00:00Z,846,1183,66533,337,0.005065156,0.01778065,0.012715495,2011,KIM
2012-02-27T00:00:00Z,850,1176,66166,326,0.004927002,0.017773479,0.012846477,2012,KIM
2013-02-27T00:00:00Z,769,1240,66501,471,0.0070826,0.018646336,0.011563736,2013,KIM
2014-02-26T00:00:00Z,782,1267,65950,485,0.007354056,0.019211524,0.011857468,2014,KIM
2015-02-27T00:00:00Z,826,1319,68048,493,0.007244886,0.019383376,0.01213849,2015,KIM
2016-02-26T00:00:00Z,814,1212,64054,398,0.006213507,0.018921535,0.012708028,2016,KIM
2017-02-27T00:00:00Z,770,1185,61746,415,0.006721083,0.019191527,0.012470443,2017,KIM
2018-02-23T00:00:00Z,774,1255,61431,481,0.007829923,0.020429425,0.012599502,2018,KIM
2019-02-15T00:00:00Z,421,910,44733,489,0.010931527,0.020342924,0.009411397,2019,KIM
2011-03-02T00:00:00Z,2162,2642,152147,480,0.003154844,0.017364785,0.014209942,2011,KMI
2012-02-23T00:00:00Z,2202,2763,157138,561,0.00357011,0.017583271,0.01401316,2012,KMI
2013-03-01T00:00:00Z,1950,2236,129748,286,0.002204273,0.017233406,0.015029133,2013,KMI
2014-02-24T00:00:00Z,1914,2187,122239,273,0.00223333,0.01789118,0.015657851,2014,KMI
2015-02-23T00:00:00Z,1616,1778,92510,162,0.001751162,0.019219544,0.017468382,2015,KMI
2016-02-16T00:00:00Z,1658,1761,88759,103,0.001160446,0.019840242,0.018679796,2016,KMI
2017-02-10T00:00:00Z,1592,1657,84119,65,0.000772715,0.019698285,0.01892557,2017,KMI
2018-02-09T00:00:00Z,1673,1781,89178,108,0.001211061,0.019971293,0.018760232,2018,KMI
2019-02-08T00:00:00Z,1719,1752,90293,33,0.000365477,0.019403498,0.019038021,2019,KMI
2009-08-07T00:00:00Z,1222,1502,67933,280,0.004121708,0.02211002,0.017988312,2009,KLAC
2010-08-06T00:00:00Z,1099,1595,64027,496,0.007746732,0.024911366,0.017164634,2010,KLAC
2011-08-05T00:00:00Z,1077,1373,56149,296,0.005271688,0.024452795,0.019181107,2011,KLAC
2012-08-06T00:00:00Z,1066,1300,54662,234,0.004280853,0.023782518,0.019501665,2012,KLAC
2013-08-08T00:00:00Z,1117,1323,55410,206,0.00371774,0.023876557,0.020158816,2013,KLAC
2014-08-08T00:00:00Z,1093,1301,55104,208,0.003774681,0.023609901,0.019835221,2014,KLAC
2015-08-07T00:00:00Z,1325,1591,66336,266,0.004009889,0.02398396,0.019974071,2015,KLAC
2016-08-05T00:00:00Z,1334,1644,68890,310,0.004499927,0.023864131,0.019364204,2016,KLAC
2017-08-04T00:00:00Z,1261,1577,65220,316,0.00484514,0.024179699,0.01933456,2017,KLAC
2018-08-06T00:00:00Z,1279,1531,66329,252,0.003799243,0.02308191,0.019282667,2018,KLAC
2011-03-18T00:00:00Z,357,471,26036,114,0.004378553,0.018090336,0.013711784,2011,KSS
2012-03-16T00:00:00Z,404,502,26607,98,0.003683241,0.018867215,0.015183974,2012,KSS
2013-03-22T00:00:00Z,358,473,24731,115,0.004650034,0.019125794,0.014475759,2013,KSS
2014-03-21T00:00:00Z,341,494,25081,153,0.006100235,0.019696184,0.013595949,2014,KSS
2015-03-20T00:00:00Z,338,500,24040,162,0.006738769,0.020798669,0.0140599,2015,KSS
2016-03-18T00:00:00Z,371,494,24386,123,0.005043878,0.020257525,0.015213647,2016,KSS
2017-03-17T00:00:00Z,351,452,23011,101,0.004389205,0.01964278,0.015253574,2017,KSS
2018-03-23T00:00:00Z,362,500,24303,138,0.005678311,0.020573592,0.01489528,2018,KSS
2019-03-22T00:00:00Z,414,491,25267,77,0.003047453,0.019432461,0.016385008,2019,KSS
2016-03-03T00:00:00Z,1063,1443,65350,380,0.005814843,0.022081102,0.016266259,2016,KHC
2017-02-23T00:00:00Z,1064,1526,61884,462,0.007465581,0.024659039,0.017193459,2017,KHC
2018-02-16T00:00:00Z,1099,1622,62900,523,0.008314785,0.025786963,0.017472178,2018,KHC
2012-03-27T00:00:00Z,557,1098,42814,541,0.012636054,0.025645817,0.013009763,2012,KR
2013-04-02T00:00:00Z,574,1114,46022,540,0.011733519,0.024205815,0.012472296,2013,KR
2014-04-01T00:00:00Z,563,1111,47277,548,0.01159126,0.023499799,0.011908539,2014,KR
2015-03-31T00:00:00Z,557,1134,46187,577,0.012492693,0.024552363,0.01205967,2015,KR
2016-03-29T00:00:00Z,588,1179,48898,591,0.012086384,0.024111416,0.012025032,2016,KR
2017-03-28T00:00:00Z,580,1138,45849,558,0.012170385,0.024820607,0.012650221,2017,KR
2018-04-03T00:00:00Z,608,1199,47792,591,0.012366086,0.025087881,0.012721794,2018,KR
2019-04-02T00:00:00Z,593,1159,47366,566,0.0119495,0.024469028,0.012519529,2019,KR
2010-03-26T00:00:00Z,886,1207,51051,321,0.00628783,0.023643024,0.017355194,2010,LB
2011-03-18T00:00:00Z,830,1140,49368,310,0.006279371,0.023091881,0.01681251,2011,LB
2012-03-23T00:00:00Z,781,1231,50324,450,0.008942055,0.02446149,0.015519434,2012,LB
2013-03-22T00:00:00Z,795,1262,52603,467,0.008877821,0.023991027,0.015113206,2013,LB
2014-03-21T00:00:00Z,696,1165,49772,469,0.009422969,0.023406735,0.013983766,2014,LB
2015-03-20T00:00:00Z,684,1102,48087,418,0.008692578,0.022916797,0.014224219,2015,LB
2016-03-18T00:00:00Z,679,1142,48285,463,0.009588899,0.023651237,0.014062338,2016,LB
2017-03-17T00:00:00Z,711,1129,47909,418,0.008724874,0.02356551,0.014840635,2017,LB
2018-03-23T00:00:00Z,742,1165,50128,423,0.008438398,0.023240504,0.014802107,2018,LB
2019-03-22T00:00:00Z,759,1164,51052,405,0.007933088,0.022800282,0.014867194,2019,LB
2012-02-29T00:00:00Z,819,1565,73183,746,0.010193624,0.021384748,0.011191124,2012,LLL
2013-02-27T00:00:00Z,855,1531,74364,676,0.00909042,0.020587919,0.011497499,2013,LLL
2014-02-25T00:00:00Z,261,442,24850,181,0.007283702,0.01778672,0.010503018,2014,LLL
2015-02-26T00:00:00Z,256,467,25406,211,0.008305125,0.018381485,0.01007636,2015,LLL
2016-02-26T00:00:00Z,322,457,25817,135,0.005229113,0.017701515,0.012472402,2016,LLL
2017-02-23T00:00:00Z,866,1632,74858,766,0.010232707,0.021801277,0.01156857,2017,LLL
2018-02-22T00:00:00Z,831,1652,73829,821,0.011120291,0.022376031,0.01125574,2018,LLL
2019-02-21T00:00:00Z,856,1693,78080,837,0.010719775,0.021682889,0.010963115,2019,LLL
2012-02-24T00:00:00Z,861,1217,52151,356,0.006826331,0.023336082,0.016509751,2012,LH
2013-02-26T00:00:00Z,841,1227,53690,386,0.007189421,0.022853418,0.015663997,2013,LH
2014-02-25T00:00:00Z,946,1257,56748,311,0.005480369,0.02215056,0.016670191,2014,LH
2015-02-26T00:00:00Z,1216,1589,72311,373,0.005158275,0.021974527,0.016816252,2015,LH
2016-02-29T00:00:00Z,1372,1676,82165,304,0.003699872,0.02039798,0.016698107,2016,LH
2017-02-27T00:00:00Z,1362,1722,81810,360,0.00440044,0.021048772,0.016648331,2017,LH
2018-02-27T00:00:00Z,1457,1920,87983,463,0.00526238,0.021822398,0.016560017,2018,LH
2019-02-28T00:00:00Z,1573,1975,92493,402,0.004346275,0.021352967,0.017006692,2019,LH
2009-08-27T00:00:00Z,792,1311,51061,519,0.010164313,0.025675173,0.01551086,2009,LRCX
2010-08-23T00:00:00Z,798,1273,47670,475,0.009964338,0.026704426,0.016740088,2010,LRCX
2011-08-19T00:00:00Z,804,1200,48799,396,0.00811492,0.024590668,0.016475747,2011,LRCX
2012-08-22T00:00:00Z,803,1338,54690,535,0.00978241,0.024465167,0.014682757,2012,LRCX
2013-08-27T00:00:00Z,846,1249,53351,403,0.007553748,0.023410995,0.015857247,2013,LRCX
2014-08-26T00:00:00Z,849,1195,51207,346,0.006756889,0.023336653,0.016579764,2014,LRCX
2015-08-13T00:00:00Z,190,213,11748,23,0.00195778,0.018130746,0.016172966,2015,LRCX
2016-08-17T00:00:00Z,919,1349,56019,430,0.007675967,0.024081115,0.016405148,2016,LRCX
2017-08-15T00:00:00Z,905,1261,52934,356,0.006725356,0.023822118,0.017096762,2017,LRCX
2018-08-14T00:00:00Z,932,1320,56216,388,0.00690195,0.02348086,0.01657891,2018,LRCX
2017-07-25T00:00:00Z,699,933,44522,234,0.005255829,0.020955932,0.015700103,2017,LW
2018-07-26T00:00:00Z,706,1018,46146,312,0.006761149,0.022060417,0.015299268,2018,LW
2010-02-25T00:00:00Z,742,1102,47955,360,0.007507038,0.022979877,0.015472839,2010,LEG
2011-02-24T00:00:00Z,811,1102,49089,291,0.005928008,0.022449021,0.016521013,2011,LEG
2012-02-24T00:00:00Z,822,1130,49236,308,0.006255585,0.022950686,0.016695101,2012,LEG
2013-02-28T00:00:00Z,805,1153,50272,348,0.006922342,0.022935232,0.01601289,2013,LEG
2014-02-26T00:00:00Z,863,1205,52175,342,0.006554863,0.023095352,0.016540489,2014,LEG
2015-02-26T00:00:00Z,904,1297,56354,393,0.006973773,0.023015225,0.016041452,2015,LEG
2016-02-25T00:00:00Z,903,1333,54794,430,0.007847575,0.024327481,0.016479907,2016,LEG
2017-02-22T00:00:00Z,784,1126,49653,342,0.006887801,0.022677381,0.01578958,2017,LEG
2018-02-22T00:00:00Z,770,1223,52115,453,0.008692315,0.023467332,0.014775017,2018,LEG
2019-02-27T00:00:00Z,884,1350,55896,466,0.008336911,0.024151997,0.015815085,2019,LEG
2012-01-30T00:00:00Z,1325,1454,86115,129,0.001497997,0.016884399,0.015386402,2012,LEN
2013-01-29T00:00:00Z,1205,1590,87763,385,0.004386814,0.018116974,0.01373016,2013,LEN
2014-01-28T00:00:00Z,1377,1899,100482,522,0.00519496,0.018898907,0.013703947,2014,LEN
2015-01-23T00:00:00Z,1142,1689,88768,547,0.00616213,0.019027127,0.012864996,2015,LEN
2016-01-22T00:00:00Z,1114,1603,86355,489,0.005662672,0.018562909,0.012900237,2016,LEN
2017-01-20T00:00:00Z,1058,1504,84655,446,0.005268443,0.017766228,0.012497785,2017,LEN
2018-01-25T00:00:00Z,1089,1556,82706,467,0.005646507,0.018813629,0.013167122,2018,LEN
2019-01-28T00:00:00Z,1002,1374,79782,372,0.004662706,0.01722193,0.012559224,2019,LEN
2010-02-22T00:00:00Z,993,1177,53760,184,0.003422619,0.021893601,0.018470982,2010,LLY
2011-02-22T00:00:00Z,984,1212,53088,228,0.004294756,0.022830018,0.018535262,2011,LLY
2012-02-24T00:00:00Z,874,1134,49447,260,0.005258155,0.022933646,0.017675491,2012,LLY
2013-02-21T00:00:00Z,823,1093,47009,270,0.005743581,0.023250867,0.017507286,2013,LLY
2014-02-19T00:00:00Z,923,1112,47574,189,0.003972758,0.023374112,0.019401354,2014,LLY
2015-02-19T00:00:00Z,961,1169,51737,208,0.004020334,0.022595048,0.018574714,2015,LLY
2016-02-19T00:00:00Z,984,1242,55142,258,0.004678829,0.022523666,0.017844837,2016,LLY
2017-02-21T00:00:00Z,1011,1272,54873,261,0.004756438,0.023180799,0.018424362,2017,LLY
2018-02-20T00:00:00Z,1069,1352,57545,283,0.00491789,0.023494656,0.018576766,2018,LLY
2019-02-19T00:00:00Z,1093,1395,57593,302,0.005243693,0.024221694,0.018978001,2019,LLY
2011-02-25T00:00:00Z,3152,3811,151064,659,0.004362389,0.025227718,0.020865329,2011,LNC
2012-02-23T00:00:00Z,2641,3146,124015,505,0.004072088,0.025367899,0.021295811,2012,LNC
2013-03-01T00:00:00Z,2570,3180,121646,610,0.00501455,0.026141427,0.021126876,2013,LNC
2014-02-25T00:00:00Z,2526,3137,119472,611,0.005114169,0.026257198,0.021143029,2014,LNC
2015-02-26T00:00:00Z,2505,3085,117520,580,0.00493533,0.026250851,0.021315521,2015,LNC
2016-02-25T00:00:00Z,2493,2993,115160,500,0.004341785,0.025989927,0.021648142,2016,LNC
2017-02-23T00:00:00Z,2535,3040,118449,505,0.004263438,0.025665054,0.021401616,2017,LNC
2018-02-22T00:00:00Z,2525,3044,116006,519,0.004473907,0.026240022,0.021766116,2018,LNC
2019-02-20T00:00:00Z,2565,3159,118772,594,0.005001179,0.026597178,0.021595999,2019,LNC
2018-03-23T00:00:00Z,244,289,18173,45,0.002476201,0.015902713,0.013426512,2018,LIN
2019-03-18T00:00:00Z,751,1412,63966,661,0.010333615,0.022074227,0.011740612,2019,LIN
2011-02-25T00:00:00Z,734,818,46771,84,0.001795985,0.01748947,0.015693485,2011,LKQ
2012-02-27T00:00:00Z,796,1002,53379,206,0.003859196,0.018771427,0.014912231,2012,LKQ
2013-03-01T00:00:00Z,748,1003,52523,255,0.004855016,0.019096396,0.01424138,2013,LKQ
2014-03-03T00:00:00Z,856,1012,55868,156,0.002792296,0.018114126,0.01532183,2014,LKQ
2015-03-02T00:00:00Z,900,1136,61091,236,0.003863089,0.01859521,0.014732121,2015,LKQ
2016-02-25T00:00:00Z,1030,1160,67089,130,0.001937725,0.017290465,0.01535274,2016,LKQ
2017-02-27T00:00:00Z,1102,1144,66374,42,0.000632778,0.017235665,0.016602887,2017,LKQ
2018-02-28T00:00:00Z,1202,1218,70526,16,0.000226867,0.017270227,0.01704336,2018,LKQ
2019-03-01T00:00:00Z,1315,1454,78075,139,0.001780339,0.018623119,0.016842779,2019,LKQ
2011-02-25T00:00:00Z,684,1319,55894,635,0.01136079,0.02359824,0.012237449,2011,LMT
2012-02-23T00:00:00Z,717,1315,58678,598,0.010191213,0.022410443,0.01221923,2012,LMT
2013-02-28T00:00:00Z,768,1427,63061,659,0.010450199,0.022628883,0.012178684,2013,LMT
2014-02-14T00:00:00Z,777,1463,63628,686,0.010781417,0.022993022,0.012211605,2014,LMT
2015-02-09T00:00:00Z,774,1563,64590,789,0.012215513,0.024198792,0.011983279,2015,LMT
2016-02-24T00:00:00Z,870,1731,75177,861,0.011452971,0.023025659,0.011572688,2016,LMT
2017-02-09T00:00:00Z,167,292,15253,125,0.008195109,0.019143775,0.010948666,2017,LMT
2018-02-06T00:00:00Z,903,1788,75074,885,0.011788369,0.023816501,0.012028132,2018,LMT
2019-02-08T00:00:00Z,929,1871,74390,942,0.012662992,0.02515123,0.012488238,2019,LMT
2010-02-24T00:00:00Z,2620,2021,106096,-599,-0.00564583,0.019048786,0.024694616,2010,L
2011-02-23T00:00:00Z,2093,1908,93295,-185,-0.001982957,0.020451257,0.022434214,2011,L
2012-02-22T00:00:00Z,1984,1807,91025,-177,-0.001944521,0.019851689,0.02179621,2012,L
2013-02-22T00:00:00Z,1905,1746,88633,-159,-0.001793914,0.019699209,0.021493123,2013,L
2014-02-24T00:00:00Z,512,441,23776,-71,-0.002986205,0.018548116,0.02153432,2014,L
2015-02-24T00:00:00Z,539,432,22696,-107,-0.004714487,0.019034191,0.023748678,2015,L
2016-02-19T00:00:00Z,509,415,20904,-94,-0.004496747,0.01985266,0.024349407,2016,L
2017-02-16T00:00:00Z,500,411,21283,-89,-0.004181741,0.019311187,0.023492929,2017,L
2018-02-15T00:00:00Z,465,391,20702,-74,-0.003574534,0.018887064,0.022461598,2018,L
2019-02-13T00:00:00Z,479,388,20277,-91,-0.004487843,0.019134981,0.023622824,2019,L
2011-03-29T00:00:00Z,168,276,10922,108,0.009888299,0.025270097,0.015381798,2011,LOW
2012-04-02T00:00:00Z,518,999,36383,481,0.01322046,0.027457879,0.014237419,2012,LOW
2013-04-02T00:00:00Z,516,912,35463,396,0.011166568,0.025716944,0.014550376,2013,LOW
2014-03-31T00:00:00Z,523,927,36777,404,0.010985127,0.025205971,0.014220845,2014,LOW
2015-03-31T00:00:00Z,493,871,35638,378,0.010606656,0.024440204,0.013833548,2015,LOW
2016-03-29T00:00:00Z,580,1013,40385,433,0.010721803,0.025083571,0.014361768,2016,LOW
2017-04-04T00:00:00Z,579,1115,42984,536,0.012469756,0.025939885,0.013470128,2017,LOW
2018-04-02T00:00:00Z,595,1089,43187,494,0.011438627,0.025215921,0.013777294,2018,LOW
2019-04-02T00:00:00Z,687,1210,48754,523,0.010727325,0.024818476,0.014091151,2019,LOW
2011-03-18T00:00:00Z,1165,1586,83228,421,0.005058394,0.019056087,0.013997693,2011,LYB
2012-02-29T00:00:00Z,1208,1725,87183,517,0.005930055,0.019785967,0.013855912,2012,LYB
2013-02-12T00:00:00Z,979,1283,64382,304,0.004721817,0.01992793,0.015206114,2013,LYB
2014-02-20T00:00:00Z,973,1279,62495,306,0.004896392,0.020465637,0.015569246,2014,LYB
2015-02-17T00:00:00Z,1079,1435,67172,356,0.005299827,0.021363068,0.016063241,2015,LYB
2016-02-16T00:00:00Z,1215,1509,71186,294,0.004130026,0.021197988,0.017067963,2016,LYB
2017-02-17T00:00:00Z,1133,1461,66368,328,0.004942141,0.022013621,0.01707148,2017,LYB
2018-02-22T00:00:00Z,1092,1482,65605,390,0.005944669,0.022589742,0.016645073,2018,LYB
2019-02-21T00:00:00Z,1030,1566,68197,536,0.007859583,0.022962887,0.015103304,2019,LYB
2010-02-19T00:00:00Z,1279,1972,97374,693,0.00711689,0.020251813,0.013134923,2010,MTB
2011-02-22T00:00:00Z,1392,2025,99455,633,0.006364688,0.020360967,0.01399628,2011,MTB
2012-02-23T00:00:00Z,1522,2262,103234,740,0.007168181,0.021911386,0.014743205,2012,MTB
2013-02-25T00:00:00Z,1628,2267,104044,639,0.006141632,0.021788859,0.015647226,2013,MTB
2014-02-21T00:00:00Z,1636,2210,102296,574,0.005611168,0.021603973,0.015992805,2014,MTB
2015-02-20T00:00:00Z,1602,2033,97763,431,0.004408621,0.020795188,0.016386568,2015,MTB
2016-02-19T00:00:00Z,1675,2171,102059,496,0.004859934,0.021272009,0.016412075,2016,MTB
2017-02-22T00:00:00Z,1676,2168,100085,492,0.004915822,0.021661588,0.016745766,2017,MTB
2018-02-22T00:00:00Z,1575,2041,95658,466,0.004871521,0.021336428,0.016464906,2018,MTB
2019-02-20T00:00:00Z,1637,2097,96860,460,0.004749122,0.021649804,0.016900681,2019,MTB
2012-02-24T00:00:00Z,810,1149,65351,339,0.005187373,0.01758198,0.012394608,2012,MAC
2013-02-22T00:00:00Z,867,1252,69265,385,0.005558363,0.018075507,0.012517144,2013,MAC
2014-02-21T00:00:00Z,796,1094,64546,298,0.004616862,0.016949153,0.01233229,2014,MAC
2015-02-23T00:00:00Z,768,1097,65158,329,0.005049265,0.016835999,0.011786734,2015,MAC
2016-02-23T00:00:00Z,783,1071,66693,288,0.004318294,0.016058657,0.011740363,2016,MAC
2017-02-24T00:00:00Z,735,1014,64279,279,0.004340453,0.015774981,0.011434528,2017,MAC
2018-02-23T00:00:00Z,735,997,60868,262,0.004304396,0.016379707,0.012075311,2018,MAC
2019-02-25T00:00:00Z,737,959,60482,222,0.003670514,0.015855957,0.012185444,2019,MAC
2010-03-31T00:00:00Z,611,1023,46034,412,0.008949907,0.022222705,0.013272798,2010,M
2011-03-30T00:00:00Z,576,957,43453,381,0.008768094,0.022023796,0.013255702,2011,M
2012-03-28T00:00:00Z,484,927,39905,443,0.011101366,0.023230172,0.012128806,2012,M
2013-04-03T00:00:00Z,489,861,39169,372,0.009497307,0.021981669,0.012484363,2013,M
2014-04-02T00:00:00Z,481,851,39311,370,0.009412124,0.021647885,0.012235761,2014,M
2015-04-01T00:00:00Z,493,817,38823,324,0.008345568,0.021044226,0.012698658,2015,M
2016-03-30T00:00:00Z,540,906,41540,366,0.008810785,0.021810303,0.012999519,2016,M
2017-03-29T00:00:00Z,607,921,43117,314,0.00728251,0.021360484,0.014077974,2017,M
2018-04-04T00:00:00Z,627,1018,44082,391,0.008869833,0.023093326,0.014223493,2018,M
2019-04-03T00:00:00Z,697,1075,44176,378,0.008556682,0.02433448,0.015777798,2019,M
2011-02-28T00:00:00Z,1219,1571,75832,352,0.00464184,0.020716848,0.016075008,2011,MRO
2012-02-29T00:00:00Z,1024,1329,65563,305,0.004652014,0.020270579,0.015618565,2012,MRO
2013-02-22T00:00:00Z,1050,1333,65628,283,0.004312184,0.020311452,0.015999269,2013,MRO
2014-02-28T00:00:00Z,1107,1454,68437,347,0.005070357,0.021245817,0.016175461,2014,MRO
2015-03-02T00:00:00Z,1191,1228,64349,37,0.00057499,0.019083436,0.018508446,2015,MRO
2016-02-25T00:00:00Z,1211,1268,64384,57,0.000885313,0.019694334,0.018809021,2016,MRO
2017-02-24T00:00:00Z,1179,1240,61086,61,0.000998592,0.02029925,0.019300658,2017,MRO
2018-02-22T00:00:00Z,1136,1239,61349,103,0.001678919,0.020195928,0.018517009,2018,MRO
2019-02-21T00:00:00Z,1125,1251,60840,126,0.002071006,0.02056213,0.018491124,2019,MRO
2012-02-29T00:00:00Z,1164,1461,62976,297,0.004716082,0.023199314,0.018483232,2012,MPC
2013-02-28T00:00:00Z,1193,1483,67893,290,0.004271427,0.021843194,0.017571767,2013,MPC
2014-02-28T00:00:00Z,1226,1575,71433,349,0.004885697,0.022048633,0.017162936,2014,MPC
2015-02-27T00:00:00Z,1277,1689,73896,412,0.005575403,0.022856447,0.017281044,2015,MPC
2016-02-26T00:00:00Z,1508,1994,87527,486,0.005552572,0.022781542,0.017228969,2016,MPC
2017-02-24T00:00:00Z,1508,2140,91974,632,0.006871507,0.023267445,0.016395938,2017,MPC
2018-02-28T00:00:00Z,1422,2056,87503,634,0.007245466,0.023496337,0.016250871,2018,MPC
2019-02-28T00:00:00Z,1538,2019,89438,481,0.005378027,0.022574297,0.01719627,2019,MPC
2010-02-12T00:00:00Z,1212,1774,76659,562,0.007331168,0.023141445,0.015810277,2010,MAR
2011-02-18T00:00:00Z,1017,1486,69344,469,0.006763383,0.021429395,0.014666013,2011,MAR
2012-02-16T00:00:00Z,848,1438,66615,590,0.008856864,0.02158673,0.012729866,2012,MAR
2013-02-20T00:00:00Z,776,1368,62608,592,0.009455661,0.021850243,0.012394582,2013,MAR
2014-02-20T00:00:00Z,748,1327,60754,579,0.009530237,0.021842183,0.012311947,2014,MAR
2015-02-19T00:00:00Z,669,1114,53751,445,0.008278916,0.020725196,0.01244628,2015,MAR
2016-02-18T00:00:00Z,745,1163,53102,418,0.007871643,0.021901247,0.014029603,2016,MAR
2017-02-21T00:00:00Z,711,1189,52330,478,0.00913434,0.022721192,0.013586853,2017,MAR
2018-02-15T00:00:00Z,715,1169,50088,454,0.009064047,0.023338923,0.014274876,2018,MAR
2019-03-01T00:00:00Z,772,1156,51972,384,0.007388594,0.022242746,0.014854152,2019,MAR
2010-02-26T00:00:00Z,1240,1520,57044,280,0.004908492,0.026646098,0.021737606,2010,MMC
2011-02-28T00:00:00Z,1148,1485,57563,337,0.005854455,0.025797822,0.019943366,2011,MMC
2012-02-28T00:00:00Z,1048,1416,55001,368,0.006690787,0.025744986,0.019054199,2012,MMC
2013-02-27T00:00:00Z,1014,1386,54762,372,0.006793032,0.025309521,0.01851649,2013,MMC
2014-02-27T00:00:00Z,1023,1389,54764,366,0.006683223,0.025363377,0.018680155,2014,MMC
2015-02-26T00:00:00Z,1004,1356,53586,352,0.00656888,0.025305117,0.018736237,2015,MMC
2016-02-24T00:00:00Z,1055,1484,56735,429,0.00756147,0.026156693,0.018595223,2016,MMC
2017-02-24T00:00:00Z,1080,1605,59142,525,0.00887694,0.027138074,0.018261134,2017,MMC
2018-02-22T00:00:00Z,1109,1688,62131,579,0.009319019,0.027168402,0.017849383,2018,MMC
2019-02-21T00:00:00Z,1242,1826,69256,584,0.008432482,0.026365947,0.017933464,2019,MMC
2011-02-25T00:00:00Z,343,331,23105,-12,-0.000519368,0.014325903,0.014845272,2011,MLM
2012-02-29T00:00:00Z,491,523,31925,32,0.001002349,0.016382146,0.015379796,2012,MLM
2013-02-22T00:00:00Z,363,409,24724,46,0.00186054,0.016542631,0.01468209,2013,MLM
2014-02-24T00:00:00Z,434,483,28248,49,0.001734636,0.017098556,0.01536392,2014,MLM
2015-02-24T00:00:00Z,449,533,30660,84,0.002739726,0.017384214,0.014644488,2015,MLM
2016-02-23T00:00:00Z,439,567,31557,128,0.004056152,0.017967487,0.013911335,2016,MLM
2017-02-24T00:00:00Z,427,574,31011,147,0.004740253,0.018509561,0.013769308,2017,MLM
2018-02-23T00:00:00Z,439,568,29946,129,0.004307754,0.018967475,0.014659721,2018,MLM
2019-02-25T00:00:00Z,91,61,6407,-30,-0.004682379,0.009520837,0.014203215,2019,MLM
2010-02-16T00:00:00Z,662,1052,41169,390,0.009473147,0.025553208,0.01608006,2010,MAS
2011-02-18T00:00:00Z,753,1176,44024,423,0.009608395,0.026712702,0.017104307,2011,MAS
2012-02-21T00:00:00Z,754,1247,44134,493,0.011170526,0.02825486,0.017084334,2012,MAS
2013-02-15T00:00:00Z,691,1163,41971,472,0.01124586,0.027709609,0.016463749,2013,MAS
2014-02-14T00:00:00Z,641,1163,40924,522,0.012755351,0.028418532,0.015663181,2014,MAS
2015-02-13T00:00:00Z,623,1123,39652,500,0.012609704,0.028321396,0.015711692,2015,MAS
2016-02-12T00:00:00Z,639,1118,38779,479,0.012352046,0.028830037,0.016477991,2016,MAS
2017-02-09T00:00:00Z,598,1098,38298,500,0.013055512,0.028669904,0.015614392,2017,MAS
2018-02-08T00:00:00Z,608,1055,38329,447,0.011662188,0.027524851,0.015862663,2018,MAS
2019-02-07T00:00:00Z,613,1030,38911,417,0.010716764,0.026470664,0.0157539,2019,MAS
2011-02-24T00:00:00Z,1111,1711,77593,600,0.007732656,0.022050958,0.014318302,2011,MA
2012-02-16T00:00:00Z,1102,1722,75988,620,0.008159183,0.022661473,0.01450229,2012,MA
2013-02-14T00:00:00Z,1097,1633,69910,536,0.007667,0.023358604,0.015691603,2013,MA
2014-02-14T00:00:00Z,952,1334,57005,382,0.006701167,0.023401456,0.016700289,2014,MA
2015-02-13T00:00:00Z,884,1241,52433,357,0.006808689,0.0236683,0.016859611,2015,MA
2016-02-12T00:00:00Z,883,1181,50328,298,0.005921157,0.023466063,0.017544905,2016,MA
2017-02-15T00:00:00Z,921,1281,53882,360,0.006681266,0.023774173,0.017092907,2017,MA
2018-02-14T00:00:00Z,1048,1504,61700,456,0.0073906,0.024376013,0.016985413,2018,MA
2019-02-13T00:00:00Z,1010,1546,60809,536,0.008814485,0.025423868,0.016609383,2019,MA
2010-02-24T00:00:00Z,936,1181,57257,245,0.004278953,0.020626299,0.016347346,2010,MAT
2011-02-24T00:00:00Z,1007,1205,58664,198,0.003375153,0.020540706,0.017165553,2011,MAT
2012-02-23T00:00:00Z,938,1179,54190,241,0.004447315,0.021756782,0.017309467,2012,MAT
2013-02-26T00:00:00Z,886,1184,53492,298,0.005570926,0.022134151,0.016563224,2013,MAT
2014-02-26T00:00:00Z,927,1184,54197,257,0.00474196,0.021846228,0.017104268,2014,MAT
2015-02-25T00:00:00Z,963,1243,56790,280,0.004930446,0.021887656,0.016957211,2015,MAT
2016-02-25T00:00:00Z,933,1256,55855,323,0.005782831,0.022486796,0.016703966,2016,MAT
2017-02-23T00:00:00Z,934,1248,55729,314,0.005634409,0.022394086,0.016759676,2017,MAT
2018-02-27T00:00:00Z,1127,1398,62940,271,0.004305688,0.02221163,0.017905942,2018,MAT
2019-02-22T00:00:00Z,1165,1397,63424,232,0.003657921,0.022026362,0.018368441,2019,MAT
2013-01-25T00:00:00Z,432,712,30900,280,0.009061489,0.023042071,0.013980583,2013,MKC
2014-01-29T00:00:00Z,528,768,33504,240,0.007163324,0.022922636,0.015759312,2014,MKC
2015-01-29T00:00:00Z,568,853,35111,285,0.008117114,0.024294381,0.016177266,2015,MKC
2016-01-28T00:00:00Z,604,952,40922,348,0.008503983,0.02326377,0.014759787,2016,MKC
2017-01-25T00:00:00Z,582,996,43490,414,0.00951943,0.022901817,0.013382387,2017,MKC
2018-01-25T00:00:00Z,683,1242,53810,559,0.010388404,0.023081212,0.012692808,2018,MKC
2019-01-25T00:00:00Z,662,1211,51150,549,0.010733138,0.023675464,0.012942326,2019,MKC
2010-08-19T00:00:00Z,829,994,45247,165,0.003646651,0.021968307,0.018321657,2010,MXIM
2011-08-08T00:00:00Z,755,892,41598,137,0.003293428,0.021443339,0.018149911,2011,MXIM
2012-08-17T00:00:00Z,768,817,38586,49,0.001269891,0.021173483,0.019903592,2012,MXIM
2013-08-13T00:00:00Z,758,877,38509,119,0.003090187,0.022773897,0.01968371,2013,MXIM
2014-08-18T00:00:00Z,771,871,39992,100,0.0025005,0.021779356,0.019278856,2014,MXIM
2015-08-18T00:00:00Z,804,1020,43257,216,0.004993411,0.023579999,0.018586587,2015,MXIM
2016-08-12T00:00:00Z,826,989,43023,163,0.003788671,0.022987704,0.019199033,2016,MXIM
2017-08-11T00:00:00Z,777,992,42039,215,0.005114299,0.023597136,0.018482837,2017,MXIM
2018-08-17T00:00:00Z,793,954,41479,161,0.003881482,0.02299959,0.019118108,2018,MXIM
2010-02-26T00:00:00Z,489,920,40466,431,0.010650917,0.022735136,0.012084219,2010,MCD
2011-02-25T00:00:00Z,397,778,36066,381,0.010563966,0.021571563,0.011007597,2011,MCD
2012-02-24T00:00:00Z,425,790,35786,365,0.010199519,0.022075672,0.011876153,2012,MCD
2013-02-25T00:00:00Z,435,823,34673,388,0.011190263,0.023736048,0.012545785,2013,MCD
2014-02-24T00:00:00Z,432,720,32561,288,0.008844937,0.022112343,0.013267406,2014,MCD
2015-02-24T00:00:00Z,541,817,35703,276,0.007730443,0.022883231,0.015152788,2015,MCD
2016-02-25T00:00:00Z,562,889,37499,327,0.008720233,0.023707299,0.014987066,2016,MCD
2017-03-01T00:00:00Z,519,907,37181,388,0.010435437,0.02439418,0.013958742,2017,MCD
2018-02-23T00:00:00Z,513,913,38992,400,0.010258515,0.023415059,0.013156545,2018,MCD
2019-02-22T00:00:00Z,506,894,38783,388,0.010004383,0.023051337,0.013046954,2019,MCD
2010-05-04T00:00:00Z,1047,1182,60455,135,0.002233066,0.019551733,0.017318667,2010,MCK
2011-05-05T00:00:00Z,1135,1230,62509,95,0.001519781,0.019677166,0.018157385,2011,MCK
2012-05-02T00:00:00Z,1136,1257,62499,121,0.001936031,0.020112322,0.018176291,2012,MCK
2013-05-07T00:00:00Z,1075,1414,63655,339,0.005325583,0.022213495,0.016887911,2013,MCK
2014-05-14T00:00:00Z,1128,1512,66363,384,0.005786357,0.02278378,0.016997423,2014,MCK
2015-05-12T00:00:00Z,1135,1507,64628,372,0.005756019,0.023318066,0.017562047,2015,MCK
2016-05-05T00:00:00Z,1184,1589,66668,405,0.006074879,0.023834523,0.017759645,2016,MCK
2017-05-22T00:00:00Z,1277,1841,71946,564,0.007839213,0.025588636,0.017749423,2017,MCK
2018-05-24T00:00:00Z,1378,2056,78996,678,0.008582713,0.026026634,0.017443921,2018,MCK
2019-05-15T00:00:00Z,1311,1810,73213,499,0.006815729,0.024722385,0.017906656,2019,MCK
2015-06-23T00:00:00Z,1695,2178,92776,483,0.005206088,0.023475899,0.018269811,2015,MDT
2016-06-28T00:00:00Z,1722,2199,93062,477,0.005125615,0.023629408,0.018503793,2016,MDT
2017-06-27T00:00:00Z,1736,2182,90524,446,0.00492687,0.024104105,0.019177235,2017,MDT
2018-06-22T00:00:00Z,1400,1969,78134,569,0.007282361,0.025200297,0.017917936,2018,MDT
2010-03-01T00:00:00Z,2083,2891,135605,808,0.005958482,0.021319273,0.015360791,2010,MRK
2011-02-28T00:00:00Z,1477,2502,108677,1025,0.009431618,0.023022351,0.013590732,2011,MRK
2012-02-28T00:00:00Z,1442,2307,99893,865,0.008659265,0.023094711,0.014435446,2012,MRK
2013-02-28T00:00:00Z,1405,2118,92446,713,0.007712611,0.022910672,0.015198062,2013,MRK
2014-02-27T00:00:00Z,1376,2034,91204,658,0.007214596,0.022301653,0.015087058,2014,MRK
2015-02-27T00:00:00Z,1445,2102,91986,657,0.007142391,0.022851303,0.015708912,2015,MRK
2016-02-26T00:00:00Z,1442,2179,92152,737,0.007997656,0.023645716,0.01564806,2016,MRK
2017-02-28T00:00:00Z,1357,2071,85980,714,0.008304257,0.024086997,0.01578274,2017,MRK
2018-02-27T00:00:00Z,1381,2021,85656,640,0.007471747,0.023594378,0.01612263,2018,MRK
2019-02-27T00:00:00Z,1415,2102,86974,687,0.007898912,0.024168142,0.01626923,2019,MRK
2011-02-25T00:00:00Z,5001,6657,237610,1656,0.006969404,0.028016498,0.021047094,2011,MET
2012-02-28T00:00:00Z,5052,6300,235941,1248,0.005289458,0.026701591,0.021412133,2012,MET
2013-02-27T00:00:00Z,4509,5280,210575,771,0.003661403,0.025074202,0.021412798,2013,MET
2014-02-27T00:00:00Z,4560,5260,209984,700,0.003333587,0.025049528,0.02171594,2014,MET
2015-02-27T00:00:00Z,4416,5249,206161,833,0.004040531,0.025460684,0.021420152,2015,MET
2016-02-25T00:00:00Z,4334,5095,201995,761,0.00376742,0.025223397,0.021455977,2016,MET
2017-03-01T00:00:00Z,4670,5443,218767,773,0.00353344,0.024880352,0.021346912,2017,MET
2018-03-01T00:00:00Z,4831,5613,221184,782,0.003535518,0.025377062,0.021841544,2018,MET
2019-02-22T00:00:00Z,4232,5119,199983,887,0.004435377,0.025597176,0.021161799,2019,MET
2010-02-09T00:00:00Z,534,877,39163,343,0.008758267,0.022393586,0.013635319,2010,MTD
2011-02-16T00:00:00Z,523,912,39918,389,0.009744977,0.022846836,0.013101859,2011,MTD
2012-02-13T00:00:00Z,520,861,39561,341,0.0086196,0.021763858,0.013144258,2012,MTD
2013-02-08T00:00:00Z,583,883,40187,300,0.007465101,0.02197228,0.014507179,2013,MTD
2014-02-07T00:00:00Z,594,843,38524,249,0.006463503,0.021882463,0.01541896,2014,MTD
2015-02-06T00:00:00Z,567,825,37981,258,0.00679287,0.021721387,0.014928517,2015,MTD
2016-02-04T00:00:00Z,617,906,39526,289,0.007311643,0.022921621,0.015609978,2016,MTD
2017-02-02T00:00:00Z,621,921,40376,300,0.007430157,0.022810581,0.015380424,2017,MTD
2018-02-09T00:00:00Z,625,940,41952,315,0.007508581,0.02240656,0.014897979,2018,MTD
2019-02-08T00:00:00Z,645,935,42361,290,0.00684592,0.022072189,0.015226269,2019,MTD
2010-02-26T00:00:00Z,915,1191,54140,276,0.005097894,0.021998522,0.016900628,2010,MGM
2011-02-28T00:00:00Z,965,1276,59323,311,0.005242486,0.021509364,0.016266878,2011,MGM
2012-02-29T00:00:00Z,1222,1819,73631,597,0.008107998,0.024704269,0.016596271,2012,MGM
2013-03-01T00:00:00Z,1237,1826,73669,589,0.007995222,0.024786545,0.016791323,2013,MGM
2014-03-03T00:00:00Z,543,582,25357,39,0.001538037,0.022952242,0.021414205,2014,MGM
2015-03-02T00:00:00Z,1125,1609,68449,484,0.007070958,0.023506552,0.016435594,2015,MGM
2016-02-29T00:00:00Z,1095,1649,68453,554,0.008093144,0.024089521,0.015996377,2016,MGM
2017-03-01T00:00:00Z,1143,1936,78201,793,0.010140535,0.024756717,0.014616181,2017,MGM
2018-03-01T00:00:00Z,1052,1700,69284,648,0.009352809,0.02453669,0.015183881,2018,MGM
2019-02-27T00:00:00Z,991,1545,64896,554,0.008536736,0.023807322,0.015270587,2019,MGM
2011-05-31T00:00:00Z,853,1128,52493,275,0.005238794,0.021488579,0.016249786,2011,MCHP
2012-05-30T00:00:00Z,857,1115,52253,258,0.004937516,0.021338488,0.016400972,2012,MCHP
2013-05-30T00:00:00Z,893,1152,54178,259,0.004780538,0.021263243,0.016482705,2013,MCHP
2014-05-30T00:00:00Z,831,1102,51301,271,0.005282548,0.021481063,0.016198515,2014,MCHP
2015-05-27T00:00:00Z,925,1289,56858,364,0.006401914,0.022670513,0.016268599,2015,MCHP
2016-05-24T00:00:00Z,958,1335,59875,377,0.006296451,0.022296451,0.016,2016,MCHP
2017-05-30T00:00:00Z,1213,1435,65831,222,0.003372271,0.021798241,0.01842597,2017,MCHP
2018-05-18T00:00:00Z,1287,1581,71458,294,0.004114305,0.022124885,0.01801058,2018,MCHP
2009-10-28T00:00:00Z,966,873,50904,-93,-0.001826968,0.017149929,0.018976898,2009,MU
2010-10-26T00:00:00Z,1049,980,52019,-69,-0.001326438,0.01883927,0.020165709,2010,MU
2011-10-25T00:00:00Z,1028,904,50272,-124,-0.002466582,0.017982177,0.020448759,2011,MU
2012-10-29T00:00:00Z,1173,997,56362,-176,-0.003122671,0.017689223,0.020811895,2012,MU
2013-10-28T00:00:00Z,1255,1261,68862,6,8.71E-05,0.018311986,0.018224856,2013,MU
2014-10-27T00:00:00Z,1081,1125,62252,44,0.000706805,0.018071709,0.017364904,2014,MU
2015-10-27T00:00:00Z,893,1008,55286,115,0.002080093,0.018232464,0.016152371,2015,MU
2016-10-28T00:00:00Z,944,1003,57245,59,0.001030658,0.017521181,0.016490523,2016,MU
2017-10-26T00:00:00Z,935,991,53041,56,0.001055787,0.01868366,0.017627873,2017,MU
2018-10-15T00:00:00Z,965,1047,51741,82,0.001584817,0.020235403,0.018650587,2018,MU
2009-07-30T00:00:00Z,610,1105,46163,495,0.010722873,0.023936919,0.013214046,2009,MSFT
2010-07-30T00:00:00Z,608,1086,44130,478,0.010831634,0.024609109,0.013777476,2010,MSFT
2011-07-28T00:00:00Z,625,1074,44832,449,0.010015168,0.023956103,0.013940935,2011,MSFT
2012-07-26T00:00:00Z,671,1158,46535,487,0.010465241,0.024884496,0.014419254,2012,MSFT
2013-07-30T00:00:00Z,705,1147,47236,442,0.00935727,0.024282327,0.014925057,2013,MSFT
2014-07-31T00:00:00Z,787,1227,50790,440,0.008663123,0.024158299,0.015495176,2014,MSFT
2015-07-31T00:00:00Z,815,1244,50481,429,0.008498247,0.024642935,0.016144688,2015,MSFT
2016-07-28T00:00:00Z,859,1304,51857,445,0.008581291,0.025146075,0.016564784,2016,MSFT
2017-08-02T00:00:00Z,883,1308,50919,425,0.00834659,0.025687857,0.017341268,2017,MSFT
2018-08-03T00:00:00Z,915,1268,52095,353,0.006776082,0.024340148,0.017564066,2018,MSFT
2010-02-25T00:00:00Z,732,1057,52677,325,0.006169676,0.020065683,0.013896008,2010,MAA
2011-02-24T00:00:00Z,722,1000,51193,278,0.00543043,0.019533921,0.014103491,2011,MAA
2012-02-24T00:00:00Z,301,399,24266,98,0.004038572,0.016442759,0.012404187,2012,MAA
2013-02-22T00:00:00Z,836,1061,54163,225,0.004154127,0.019589018,0.015434891,2013,MAA
2014-02-21T00:00:00Z,1250,1599,80565,349,0.004331906,0.019847328,0.015515422,2014,MAA
2015-02-25T00:00:00Z,1151,1378,72198,227,0.003144131,0.019086401,0.01594227,2015,MAA
2016-02-26T00:00:00Z,1168,1367,68576,199,0.00290189,0.019934088,0.017032198,2016,MAA
2017-02-24T00:00:00Z,1205,1505,75909,300,0.003952101,0.019826371,0.015874271,2017,MAA
2018-02-23T00:00:00Z,985,1234,61645,249,0.004039257,0.020017844,0.015978587,2018,MAA
2019-02-21T00:00:00Z,978,1179,59492,201,0.003378606,0.019817791,0.016439185,2019,MAA
2011-03-01T00:00:00Z,568,776,35716,208,0.00582372,0.021726957,0.015903237,2011,MHK
2012-02-29T00:00:00Z,571,812,37227,241,0.006473796,0.021812126,0.01533833,2012,MHK
2013-02-27T00:00:00Z,494,755,36031,261,0.007243762,0.020954178,0.013710416,2013,MHK
2014-02-28T00:00:00Z,544,871,38637,327,0.00846339,0.022543158,0.014079768,2014,MHK
2015-02-27T00:00:00Z,559,856,38818,297,0.00765109,0.022051626,0.014400536,2015,MHK
2016-02-29T00:00:00Z,612,847,40814,235,0.005757828,0.020752683,0.014994855,2016,MHK
2017-02-27T00:00:00Z,642,933,42285,291,0.006881873,0.022064562,0.015182689,2017,MHK
2018-02-28T00:00:00Z,618,985,43129,367,0.008509356,0.022838461,0.014329106,2018,MHK
2019-02-28T00:00:00Z,591,1007,43803,416,0.009497066,0.022989293,0.013492227,2019,MHK
2011-02-22T00:00:00Z,1052,1611,78235,559,0.00714514,0.020591807,0.013446667,2011,TAP
2012-02-27T00:00:00Z,1177,1767,78872,590,0.007480475,0.022403388,0.014922913,2012,TAP
2013-02-22T00:00:00Z,1292,1769,84710,477,0.005630976,0.020883013,0.015252036,2013,TAP
2014-02-14T00:00:00Z,1402,2005,92397,603,0.006526186,0.021699839,0.015173653,2014,TAP
2015-02-12T00:00:00Z,1419,2033,91246,614,0.006729062,0.022280429,0.015551367,2015,TAP
2016-02-11T00:00:00Z,1421,2182,93905,761,0.008103935,0.023236249,0.015132315,2016,TAP
2017-02-14T00:00:00Z,1492,2345,101924,853,0.008368981,0.023007339,0.014638358,2017,TAP
2018-02-14T00:00:00Z,1487,2346,99371,859,0.008644373,0.023608497,0.014964124,2018,TAP
2019-02-12T00:00:00Z,1553,2331,97827,778,0.007952815,0.023827778,0.015874963,2019,TAP
2011-02-28T00:00:00Z,970,1297,58212,327,0.005617398,0.022280629,0.016663231,2011,MDLZ
2012-02-27T00:00:00Z,946,1247,57030,301,0.005277924,0.021865685,0.016587761,2012,MDLZ
2013-02-25T00:00:00Z,921,1332,59906,411,0.006860749,0.022234835,0.015374086,2013,MDLZ
2014-03-03T00:00:00Z,1175,1519,69761,344,0.004931122,0.021774344,0.016843222,2014,MDLZ
2015-02-20T00:00:00Z,1036,1454,61019,418,0.006850325,0.023828644,0.016978318,2015,MDLZ
2016-02-19T00:00:00Z,1176,1599,70194,423,0.006026156,0.022779725,0.016753569,2016,MDLZ
2017-02-24T00:00:00Z,1218,1695,74054,477,0.006441246,0.022888703,0.016447457,2017,MDLZ
2018-02-09T00:00:00Z,329,588,26193,259,0.009888138,0.022448746,0.012560608,2018,MDLZ
2019-02-08T00:00:00Z,1200,1689,74382,489,0.006574171,0.022707107,0.016132935,2019,MDLZ
2012-02-29T00:00:00Z,1318,1081,56194,-237,-0.004217532,0.019236929,0.023454461,2012,MNST
2013-03-01T00:00:00Z,1370,1079,53710,-291,-0.005417985,0.020089369,0.025507354,2013,MNST
2014-03-03T00:00:00Z,1392,1053,53164,-339,-0.006376495,0.019806636,0.026183131,2014,MNST
2015-03-02T00:00:00Z,1497,1150,58191,-347,-0.005963121,0.019762506,0.025725628,2015,MNST
2016-02-29T00:00:00Z,1507,1189,59507,-318,-0.005343909,0.019980843,0.025324752,2016,MNST
2017-03-01T00:00:00Z,1388,1134,57919,-254,-0.004385435,0.019579067,0.023964502,2017,MNST
2018-03-01T00:00:00Z,1363,1126,56704,-237,-0.004179599,0.019857506,0.024037105,2018,MNST
2019-02-28T00:00:00Z,1348,1080,56106,-268,-0.004776673,0.019249278,0.024025951,2019,MNST
2011-02-28T00:00:00Z,1581,1354,70157,-227,-0.0032356,0.019299571,0.022535171,2011,MCO
2012-02-27T00:00:00Z,1631,1494,74518,-137,-0.001838482,0.020048847,0.021887329,2012,MCO
2013-02-26T00:00:00Z,1788,1394,74684,-394,-0.005275561,0.01866531,0.023940871,2013,MCO
2014-02-27T00:00:00Z,504,322,19647,-182,-0.009263501,0.016389271,0.025652771,2014,MCO
2015-02-26T00:00:00Z,481,388,20432,-93,-0.004551684,0.01898982,0.023541504,2015,MCO
2016-02-25T00:00:00Z,506,387,21212,-119,-0.005610032,0.01824439,0.023854422,2016,MCO
2017-02-24T00:00:00Z,522,421,21887,-101,-0.004614611,0.019235162,0.023849774,2017,MCO
2018-02-27T00:00:00Z,551,462,23521,-89,-0.003783853,0.019642022,0.023425875,2018,MCO
2019-02-25T00:00:00Z,1648,1739,78742,91,0.001155673,0.022084783,0.02092911,2019,MCO
2010-02-26T00:00:00Z,2437,2910,125886,473,0.003757368,0.023116153,0.019358785,2010,MS
2011-02-28T00:00:00Z,2818,3264,139948,446,0.003186898,0.023322949,0.020136051,2011,MS
2012-02-27T00:00:00Z,3129,3263,143856,134,0.000931487,0.022682405,0.021750918,2012,MS
2013-02-26T00:00:00Z,3376,3370,152666,-6,-3.93E-05,0.022074332,0.022113634,2013,MS
2014-02-25T00:00:00Z,3499,3416,156934,-83,-0.000528885,0.021767112,0.022295997,2014,MS
2015-03-02T00:00:00Z,3697,3621,165436,-76,-0.000459392,0.021887618,0.02234701,2015,MS
2016-02-23T00:00:00Z,3167,3033,137632,-134,-0.000973611,0.022037026,0.023010637,2016,MS
2017-02-27T00:00:00Z,3101,2857,130300,-244,-0.001872602,0.021926324,0.023798926,2017,MS
2018-02-27T00:00:00Z,3013,2722,124788,-291,-0.002331955,0.021812995,0.02414495,2018,MS
2019-02-26T00:00:00Z,2884,2601,119770,-283,-0.002362862,0.021716624,0.024079486,2019,MS
2011-07-19T00:00:00Z,524,553,33266,29,0.000871761,0.01662358,0.015751819,2011,MOS
2012-07-17T00:00:00Z,1125,1518,77569,393,0.005066457,0.019569673,0.014503216,2012,MOS
2013-07-17T00:00:00Z,1172,1576,81250,404,0.004972308,0.019396923,0.014424615,2013,MOS
2015-02-17T00:00:00Z,1111,1501,82774,390,0.004711624,0.018133713,0.013422089,2015,MOS
2016-02-19T00:00:00Z,1193,1646,85359,453,0.005306998,0.019283262,0.013976265,2016,MOS
2017-02-15T00:00:00Z,1268,1778,86422,510,0.005901275,0.020573465,0.01467219,2017,MOS
2018-02-21T00:00:00Z,1225,1699,84024,474,0.005641245,0.020220413,0.014579168,2018,MOS
2019-03-13T00:00:00Z,1287,1836,90050,549,0.006096613,0.020388673,0.01429206,2019,MOS
2010-02-16T00:00:00Z,1407,2066,87712,659,0.007513225,0.02355436,0.016041135,2010,MSI
2011-02-18T00:00:00Z,1446,1797,81791,351,0.004291426,0.021970632,0.017679207,2011,MSI
2012-02-15T00:00:00Z,1253,1609,71162,356,0.00500267,0.022610382,0.017607712,2012,MSI
2013-02-12T00:00:00Z,1038,1483,65341,445,0.006810425,0.022696316,0.015885891,2013,MSI
2014-02-13T00:00:00Z,1035,1495,65865,460,0.006983982,0.022697943,0.01571396,2014,MSI
2015-02-13T00:00:00Z,1063,1293,61143,230,0.003761673,0.021147147,0.017385473,2015,MSI
2016-02-23T00:00:00Z,1112,1369,63666,257,0.004036691,0.021502843,0.017466151,2016,MSI
2017-02-21T00:00:00Z,1102,1425,65367,323,0.004941331,0.021799991,0.01685866,2017,MSI
2018-02-16T00:00:00Z,1064,1379,63597,315,0.004953064,0.021683413,0.016730349,2018,MSI
2019-02-15T00:00:00Z,1021,1399,65913,378,0.005734832,0.021224948,0.015490116,2019,MSI
2012-02-29T00:00:00Z,1046,1550,74811,504,0.006736977,0.020718878,0.013981901,2012,MSCI
2013-03-01T00:00:00Z,1071,1447,70265,376,0.005351171,0.020593468,0.015242297,2013,MSCI
2014-02-28T00:00:00Z,1117,1438,70882,321,0.004528653,0.020287238,0.015758585,2014,MSCI
2015-02-27T00:00:00Z,1121,1368,68057,247,0.003629311,0.020100798,0.016471487,2015,MSCI
2016-02-26T00:00:00Z,453,470,25789,17,0.000659196,0.018224825,0.017565629,2016,MSCI
2017-02-24T00:00:00Z,1040,1432,71580,392,0.00547639,0.020005588,0.014529198,2017,MSCI
2018-02-26T00:00:00Z,933,1472,69440,539,0.007762097,0.021198157,0.01343606,2018,MSCI
2019-02-22T00:00:00Z,843,1387,67133,544,0.008103317,0.02066048,0.012557163,2019,MSCI
2016-02-16T00:00:00Z,1762,2346,108380,584,0.005388448,0.02164606,0.016257612,2016,MYL
2017-03-01T00:00:00Z,1794,2566,115912,772,0.006660225,0.022137484,0.015477259,2017,MYL
2018-03-01T00:00:00Z,1721,2441,107696,720,0.006685485,0.022665651,0.015980166,2018,MYL
2019-02-27T00:00:00Z,1521,2013,89412,492,0.005502617,0.022513757,0.017011139,2019,MYL
2010-02-18T00:00:00Z,1298,1831,92401,533,0.005768336,0.019815803,0.014047467,2010,NDAQ
2011-02-24T00:00:00Z,1397,1876,98171,479,0.004879241,0.019109513,0.014230272,2011,NDAQ
2012-02-24T00:00:00Z,1298,1869,92393,571,0.006180122,0.020228805,0.014048683,2012,NDAQ
2013-02-21T00:00:00Z,1362,1955,97172,593,0.006102581,0.020118964,0.014016383,2013,NDAQ
2014-02-24T00:00:00Z,1283,1803,93170,520,0.005581196,0.019351723,0.013770527,2014,NDAQ
2015-02-17T00:00:00Z,1206,1565,82139,359,0.00437064,0.019053069,0.014682429,2015,NDAQ
2016-02-26T00:00:00Z,1224,1635,84332,411,0.004873595,0.019387658,0.014514063,2016,NDAQ
2017-03-01T00:00:00Z,1052,1420,75488,368,0.004874947,0.018810937,0.01393599,2017,NDAQ
2018-02-28T00:00:00Z,1103,1531,78373,428,0.005461064,0.019534789,0.014073724,2018,NDAQ
2019-02-22T00:00:00Z,1193,1550,76924,357,0.004640944,0.020149758,0.015508814,2019,NDAQ
2010-02-26T00:00:00Z,747,1172,52865,425,0.008039346,0.022169677,0.014130332,2010,NOV
2011-02-23T00:00:00Z,730,1134,51215,404,0.007888314,0.022141951,0.014253637,2011,NOV
2012-02-23T00:00:00Z,783,1237,54259,454,0.008367275,0.022798061,0.014430786,2012,NOV
2013-02-22T00:00:00Z,759,1203,54550,444,0.008139322,0.022053162,0.013913841,2013,NOV
2014-02-14T00:00:00Z,792,1285,57045,493,0.0086423,0.022526076,0.013883776,2014,NOV
2015-02-17T00:00:00Z,171,229,12647,58,0.004586068,0.018107061,0.013520993,2015,NOV
2016-02-19T00:00:00Z,216,243,12581,27,0.002146093,0.01931484,0.017168747,2016,NOV
2017-02-17T00:00:00Z,235,255,13424,20,0.001489869,0.018995828,0.017505959,2017,NOV
2018-02-16T00:00:00Z,251,313,14343,62,0.004322666,0.021822492,0.017499826,2018,NOV
2019-02-14T00:00:00Z,736,1136,43817,400,0.009128877,0.02592601,0.016797134,2019,NOV
2011-03-01T00:00:00Z,1072,1228,58559,156,0.00266398,0.020970303,0.018306324,2011,NKTR
2012-02-29T00:00:00Z,1120,1320,59894,200,0.003339233,0.022038935,0.018699703,2012,NKTR
2013-03-01T00:00:00Z,1255,1394,65674,139,0.002116515,0.021226056,0.019109541,2013,NKTR
2014-02-27T00:00:00Z,1326,1328,66170,2,3.02E-05,0.020069518,0.020039293,2014,NKTR
2015-02-26T00:00:00Z,1308,1282,63974,-26,-0.000406415,0.020039391,0.020445806,2015,NKTR
2016-02-29T00:00:00Z,1273,1355,65216,82,0.00125736,0.02077711,0.01951975,2016,NKTR
2017-03-01T00:00:00Z,1283,1392,66395,109,0.00164169,0.020965434,0.019323744,2017,NKTR
2018-03-01T00:00:00Z,1378,1462,71933,84,0.001167753,0.020324469,0.019156715,2018,NKTR
2019-03-01T00:00:00Z,1396,1486,70188,90,0.00128227,0.02117171,0.01988944,2019,NKTR
2009-06-17T00:00:00Z,1265,1574,71948,309,0.004294768,0.021876911,0.017582143,2009,NTAP
2010-06-18T00:00:00Z,1041,1312,59648,271,0.004543321,0.021995708,0.017452387,2010,NTAP
2011-06-23T00:00:00Z,1138,1463,67223,325,0.004834655,0.021763385,0.01692873,2011,NTAP
2012-06-19T00:00:00Z,1095,1397,64469,302,0.004684422,0.021669329,0.016984907,2012,NTAP
2013-06-17T00:00:00Z,941,1238,55642,297,0.005337695,0.02224938,0.016911685,2013,NTAP
2014-06-17T00:00:00Z,941,1204,53464,263,0.004919198,0.022519826,0.017600628,2014,NTAP
2015-06-12T00:00:00Z,986,1206,51208,220,0.004296204,0.023551008,0.019254804,2015,NTAP
2016-06-22T00:00:00Z,984,1252,53853,268,0.00497651,0.023248473,0.018271963,2016,NTAP
2017-06-20T00:00:00Z,947,1182,52468,235,0.00447892,0.022528017,0.018049097,2017,NTAP
2018-06-19T00:00:00Z,1020,1243,54313,223,0.004105831,0.022885865,0.018780034,2018,NTAP
2012-02-10T00:00:00Z,566,722,38088,156,0.004095778,0.018956102,0.014860323,2012,NFLX
2013-02-01T00:00:00Z,526,778,37896,252,0.006649778,0.020529871,0.013880093,2013,NFLX
2014-02-03T00:00:00Z,510,662,34004,152,0.004470062,0.019468298,0.014998236,2014,NFLX
2015-01-29T00:00:00Z,500,676,32926,176,0.00534532,0.020530887,0.015185568,2015,NFLX
2016-01-28T00:00:00Z,556,661,33318,105,0.00315145,0.019839126,0.016687676,2016,NFLX
2017-01-27T00:00:00Z,508,649,31876,141,0.004423391,0.020360146,0.015936755,2017,NFLX
2018-01-29T00:00:00Z,522,671,33736,149,0.004416647,0.019889732,0.015473085,2018,NFLX
2019-01-29T00:00:00Z,543,675,34378,132,0.003839665,0.01963465,0.015794985,2019,NFLX
2011-03-01T00:00:00Z,936,1519,59355,583,0.009822256,0.025591778,0.015769522,2011,NWL
2012-02-29T00:00:00Z,832,1452,56102,620,0.011051299,0.02588143,0.014830131,2012,NWL
2013-03-01T00:00:00Z,891,1477,60236,586,0.009728402,0.02452022,0.014791819,2013,NWL
2014-03-03T00:00:00Z,902,1421,60405,519,0.008592004,0.023524543,0.014932539,2014,NWL
2015-03-02T00:00:00Z,942,1605,67886,663,0.009766373,0.023642577,0.013876204,2015,NWL
2016-02-29T00:00:00Z,1071,1779,80276,708,0.008819572,0.022161044,0.013341472,2016,NWL
2017-03-01T00:00:00Z,926,1511,72069,585,0.008117221,0.020966019,0.012848798,2017,NWL
2018-03-01T00:00:00Z,198,297,15473,99,0.006398242,0.019194726,0.012796484,2018,NWL
2019-03-04T00:00:00Z,981,1287,59023,306,0.00518442,0.021805059,0.016620639,2019,NWL
2010-02-25T00:00:00Z,1396,2359,90468,963,0.010644648,0.026075518,0.015430871,2010,NEM
2011-02-24T00:00:00Z,1106,1962,77750,856,0.011009646,0.025234727,0.01422508,2011,NEM
2012-02-24T00:00:00Z,1202,2146,85055,944,0.011098701,0.025230733,0.014132032,2012,NEM
2013-02-22T00:00:00Z,1213,2103,86340,890,0.010308084,0.024357192,0.014049108,2013,NEM
2014-02-21T00:00:00Z,1326,2246,90889,920,0.010122237,0.024711461,0.014589224,2014,NEM
2015-02-20T00:00:00Z,1365,2235,90406,870,0.009623255,0.02472181,0.015098555,2015,NEM
2016-02-17T00:00:00Z,1592,2534,102628,942,0.009178782,0.024691117,0.015512336,2016,NEM
2017-02-21T00:00:00Z,1696,2474,104499,778,0.007445047,0.023674868,0.01622982,2017,NEM
2018-02-22T00:00:00Z,1662,2463,101776,801,0.007870225,0.024200204,0.01632998,2018,NEM
2019-02-21T00:00:00Z,1813,2578,106257,765,0.007199526,0.024261931,0.017062405,2019,NEM
2013-09-20T00:00:00Z,843,2176,93567,1333,0.014246476,0.023256063,0.009009587,2013,NWSA
2014-08-14T00:00:00Z,826,1891,83934,1065,0.012688541,0.022529607,0.009841066,2014,NWSA
2015-08-13T00:00:00Z,911,1961,84898,1050,0.012367783,0.023098306,0.010730524,2015,NWSA
2016-08-12T00:00:00Z,954,1829,78409,875,0.011159433,0.023326404,0.012166971,2016,NWSA
2017-08-14T00:00:00Z,1039,1906,82227,867,0.010543982,0.023179734,0.012635752,2017,NWSA
2018-08-15T00:00:00Z,1183,2024,89986,841,0.009345898,0.022492388,0.013146489,2018,NWSA
2013-09-20T00:00:00Z,843,2176,93567,1333,0.014246476,0.023256063,0.009009587,2013,NWS
2014-08-14T00:00:00Z,826,1891,83934,1065,0.012688541,0.022529607,0.009841066,2014,NWS
2015-08-13T00:00:00Z,911,1961,84898,1050,0.012367783,0.023098306,0.010730524,2015,NWS
2016-08-12T00:00:00Z,954,1829,78409,875,0.011159433,0.023326404,0.012166971,2016,NWS
2017-08-14T00:00:00Z,1039,1906,82227,867,0.010543982,0.023179734,0.012635752,2017,NWS
2018-08-15T00:00:00Z,1183,2024,89986,841,0.009345898,0.022492388,0.013146489,2018,NWS
2010-02-26T00:00:00Z,1085,1726,77162,641,0.008307198,0.022368523,0.014061326,2010,NEE
2011-02-28T00:00:00Z,1228,1844,82445,616,0.007471648,0.022366426,0.014894778,2011,NEE
2012-02-28T00:00:00Z,1334,1847,84007,513,0.006106634,0.021986263,0.015879629,2012,NEE
2013-02-28T00:00:00Z,1373,1911,86095,538,0.006248911,0.022196411,0.0159475,2013,NEE
2014-02-24T00:00:00Z,1372,1987,89034,615,0.006907474,0.022317317,0.015409843,2014,NEE
2015-02-20T00:00:00Z,1343,1946,88173,603,0.006838828,0.022070248,0.01523142,2015,NEE
2016-02-22T00:00:00Z,1392,1896,88876,504,0.005670822,0.021333093,0.015662271,2016,NEE
2017-02-23T00:00:00Z,1229,1787,80686,558,0.006915698,0.022147584,0.015231887,2017,NEE
2018-02-16T00:00:00Z,1208,1734,77635,526,0.006775295,0.022335287,0.015559992,2018,NEE
2019-02-15T00:00:00Z,1210,1773,79550,563,0.00707731,0.022287869,0.015210559,2019,NEE
2011-03-01T00:00:00Z,1061,1638,75874,577,0.007604713,0.021588423,0.01398371,2011,NLSN
2012-02-22T00:00:00Z,990,1474,69477,484,0.006966334,0.021215654,0.01424932,2012,NLSN
2013-02-22T00:00:00Z,815,1386,66919,571,0.008532704,0.020711607,0.012178903,2013,NLSN
2014-02-21T00:00:00Z,842,1365,66292,523,0.007889338,0.02059072,0.012701382,2014,NLSN
2015-02-20T00:00:00Z,915,1545,72085,630,0.008739682,0.02143303,0.012693348,2015,NLSN
2016-02-19T00:00:00Z,964,1611,72474,647,0.008927339,0.022228661,0.013301322,2016,NLSN
2017-02-17T00:00:00Z,924,1650,70366,726,0.010317483,0.023448825,0.013131342,2017,NLSN
2018-02-08T00:00:00Z,1076,1824,75272,748,0.009937294,0.024232118,0.014294824,2018,NLSN
2019-02-28T00:00:00Z,1202,1940,80202,738,0.009201766,0.024188923,0.014987157,2019,NLSN
2009-07-27T00:00:00Z,802,1145,49474,343,0.006932934,0.023143469,0.016210535,2009,NKE
2010-07-20T00:00:00Z,831,1174,50912,343,0.006737115,0.023059397,0.016322282,2010,NKE
2011-07-22T00:00:00Z,850,1097,49117,247,0.005028809,0.022334426,0.017305617,2011,NKE
2012-07-24T00:00:00Z,933,1138,52895,205,0.003875603,0.021514321,0.017638718,2012,NKE
2013-07-23T00:00:00Z,999,1128,53493,129,0.00241153,0.021086871,0.018675341,2013,NKE
2014-07-25T00:00:00Z,1000,1168,56080,168,0.00299572,0.020827389,0.017831669,2014,NKE
2015-07-23T00:00:00Z,1049,1222,57597,173,0.003003629,0.021216383,0.018212754,2015,NKE
2016-07-21T00:00:00Z,1053,1213,57157,160,0.002799307,0.021222247,0.01842294,2016,NKE
2017-07-20T00:00:00Z,1057,1161,56052,104,0.00185542,0.020712909,0.018857489,2017,NKE
2018-07-25T00:00:00Z,1010,1130,54600,120,0.002197802,0.020695971,0.018498168,2018,NKE
2011-02-28T00:00:00Z,1374,1867,85075,493,0.005794887,0.021945342,0.016150455,2011,NI
2012-02-24T00:00:00Z,1337,1848,88215,511,0.005792666,0.020948818,0.015156153,2012,NI
2013-02-19T00:00:00Z,1107,1632,76204,525,0.006889402,0.021416199,0.014526796,2013,NI
2014-02-18T00:00:00Z,995,1586,73439,591,0.008047495,0.021596155,0.013548659,2014,NI
2015-02-18T00:00:00Z,823,1499,68347,676,0.009890705,0.021932199,0.012041494,2015,NI
2016-02-18T00:00:00Z,823,1241,55000,418,0.0076,0.022563636,0.014963636,2016,NI
2017-02-22T00:00:00Z,801,1290,53725,489,0.009101908,0.024011168,0.01490926,2017,NI
2018-02-20T00:00:00Z,780,1247,53939,467,0.008657928,0.023118708,0.01446078,2018,NI
2019-02-20T00:00:00Z,964,1437,65047,473,0.007271665,0.022091718,0.014820053,2019,NI
2010-02-18T00:00:00Z,1561,1795,79125,234,0.002957346,0.022685624,0.019728278,2010,NBL
2011-02-10T00:00:00Z,1586,1699,78830,113,0.001433464,0.021552708,0.020119244,2011,NBL
2012-02-09T00:00:00Z,1909,1947,91310,38,0.000416165,0.021322966,0.020906801,2012,NBL
2013-02-07T00:00:00Z,2133,1934,95717,-199,-0.002079046,0.020205397,0.022284443,2013,NBL
2014-02-06T00:00:00Z,1782,1718,85262,-64,-0.000750627,0.020149656,0.020900284,2014,NBL
2015-02-19T00:00:00Z,1887,1789,89442,-98,-0.001095682,0.020001789,0.021097471,2015,NBL
2016-02-17T00:00:00Z,2101,2030,97573,-71,-0.00072766,0.020804936,0.021532596,2016,NBL
2017-02-14T00:00:00Z,1939,2070,94912,131,0.001380226,0.021809676,0.02042945,2017,NBL
2018-02-20T00:00:00Z,1819,2204,98977,385,0.003889793,0.0222678,0.018378007,2018,NBL
2019-02-19T00:00:00Z,1692,1955,91263,263,0.002881781,0.021421606,0.018539824,2019,NBL
2010-03-22T00:00:00Z,508,753,36825,245,0.006653089,0.020448065,0.013794976,2010,JWN
2011-03-18T00:00:00Z,463,674,35854,211,0.005884978,0.01879846,0.012913482,2011,JWN
2012-03-16T00:00:00Z,500,843,40172,343,0.008538285,0.020984766,0.01244648,2012,JWN
2013-03-18T00:00:00Z,409,695,35401,286,0.008078868,0.019632214,0.011553346,2013,JWN
2014-03-17T00:00:00Z,427,695,36119,268,0.007419917,0.01924195,0.011822033,2014,JWN
2015-03-16T00:00:00Z,446,728,38685,282,0.007289647,0.018818664,0.011529016,2015,JWN
2016-03-14T00:00:00Z,392,735,36974,343,0.009276789,0.019878834,0.010602045,2016,JWN
2017-03-20T00:00:00Z,413,795,36810,382,0.010377615,0.021597392,0.011219777,2017,JWN
2018-03-19T00:00:00Z,416,828,39249,412,0.010497083,0.021096079,0.010598996,2018,JWN
2019-03-18T00:00:00Z,437,819,37546,382,0.010174186,0.021813242,0.011639056,2019,JWN
2010-02-17T00:00:00Z,844,864,41608,20,0.000480677,0.020765237,0.020284561,2010,NSC
2011-02-17T00:00:00Z,832,879,42948,47,0.001094347,0.020466611,0.019372264,2011,NSC
2012-02-15T00:00:00Z,795,899,43024,104,0.002417255,0.020895314,0.018478059,2012,NSC
2013-02-15T00:00:00Z,813,862,41814,49,0.001171856,0.020615105,0.019443249,2013,NSC
2014-02-14T00:00:00Z,802,830,39995,28,0.000700088,0.020752594,0.020052507,2014,NSC
2015-02-11T00:00:00Z,684,762,37167,78,0.002098636,0.020502058,0.018403422,2015,NSC
2016-02-08T00:00:00Z,688,756,36742,68,0.001850743,0.020575908,0.018725165,2016,NSC
2017-02-06T00:00:00Z,640,734,34942,94,0.002690172,0.021006239,0.018316067,2017,NSC
2018-02-05T00:00:00Z,620,746,34851,126,0.003615391,0.021405412,0.01779002,2018,NSC
2019-02-08T00:00:00Z,612,714,34865,102,0.00292557,0.02047899,0.01755342,2019,NSC
2010-02-26T00:00:00Z,518,613,24376,95,0.003897276,0.025147686,0.02125041,2010,NTRS
2011-02-25T00:00:00Z,579,619,25287,40,0.00158184,0.024478981,0.022897141,2011,NTRS
2012-02-24T00:00:00Z,598,650,27887,52,0.001864668,0.023308352,0.021443683,2012,NTRS
2013-02-26T00:00:00Z,626,631,28431,5,0.000175864,0.022194084,0.02201822,2013,NTRS
2014-02-26T00:00:00Z,383,329,13500,-54,-0.004,0.02437037,0.02837037,2014,NTRS
2015-02-26T00:00:00Z,2325,2838,97983,513,0.005235602,0.028964208,0.023728606,2015,NTRS
2016-02-29T00:00:00Z,2332,2635,95207,303,0.003182539,0.027676536,0.024493997,2016,NTRS
2017-02-28T00:00:00Z,2360,2681,98218,321,0.00326824,0.027296422,0.024028182,2017,NTRS
2018-02-27T00:00:00Z,2246,2697,98685,451,0.004570097,0.027329381,0.022759285,2018,NTRS
2019-02-26T00:00:00Z,2359,2754,101526,395,0.003890629,0.027126056,0.023235427,2019,NTRS
2010-02-09T00:00:00Z,988,1450,61125,462,0.007558282,0.023721881,0.016163599,2010,NOC
2011-02-09T00:00:00Z,1039,1491,62699,452,0.007209046,0.023780284,0.016571237,2011,NOC
2012-02-08T00:00:00Z,948,1498,61162,550,0.008992512,0.024492332,0.01549982,2012,NOC
2013-02-05T00:00:00Z,832,1163,50389,331,0.006568894,0.023080434,0.01651154,2013,NOC
2014-02-03T00:00:00Z,849,1189,51408,340,0.006613757,0.023128696,0.016514939,2014,NOC
2015-02-02T00:00:00Z,769,1132,46528,363,0.007801754,0.024329436,0.016527682,2015,NOC
2016-02-01T00:00:00Z,790,1128,48054,338,0.007033754,0.023473592,0.016439839,2016,NOC
2017-01-30T00:00:00Z,772,1121,47398,349,0.00736318,0.023650787,0.016287607,2017,NOC
2018-01-29T00:00:00Z,821,1177,50786,356,0.007009806,0.023175678,0.016165872,2018,NOC
2019-01-31T00:00:00Z,907,1414,59312,507,0.008548017,0.023840032,0.015292015,2019,NOC
2013-02-20T00:00:00Z,896,1833,82171,937,0.01140305,0.02230714,0.01090409,2013,NCLH
2014-02-21T00:00:00Z,794,1280,58821,486,0.008262355,0.021760936,0.01349858,2014,NCLH
2015-02-27T00:00:00Z,916,1596,64195,680,0.010592725,0.024861749,0.014269024,2015,NCLH
2016-02-29T00:00:00Z,914,1348,58295,434,0.007444892,0.023123767,0.015678875,2016,NCLH
2017-02-27T00:00:00Z,952,1469,59745,517,0.008653444,0.024587832,0.015934388,2017,NCLH
2018-02-27T00:00:00Z,901,1303,56186,402,0.007154807,0.02319083,0.016036023,2018,NCLH
2019-02-27T00:00:00Z,943,1199,56266,256,0.004549817,0.021309494,0.016759677,2019,NCLH
2012-02-28T00:00:00Z,1624,2161,108598,537,0.004944842,0.019899077,0.014954235,2012,NRG
2013-02-27T00:00:00Z,1772,2473,120558,701,0.005814629,0.020512948,0.014698319,2013,NRG
2014-02-28T00:00:00Z,1830,2400,121733,570,0.004682379,0.019715279,0.0150329,2014,NRG
2015-02-27T00:00:00Z,1955,2461,125409,506,0.004034798,0.019623791,0.015588993,2015,NRG
2016-02-29T00:00:00Z,2076,2513,127204,437,0.003435427,0.019755668,0.016320242,2016,NRG
2017-02-28T00:00:00Z,2283,2637,134998,354,0.002622261,0.019533623,0.016911362,2017,NRG
2018-03-01T00:00:00Z,2306,2556,129103,250,0.001936438,0.019798146,0.017861707,2018,NRG
2019-02-28T00:00:00Z,2053,2130,103306,77,0.000745358,0.020618357,0.019872999,2019,NRG
2010-02-25T00:00:00Z,274,187,13136,-87,-0.006623021,0.014235688,0.020858709,2010,NUE
2011-02-28T00:00:00Z,233,173,11838,-60,-0.005068424,0.014613955,0.019682379,2011,NUE
2012-02-28T00:00:00Z,279,221,13281,-58,-0.004367141,0.016640313,0.021007454,2012,NUE
2013-02-28T00:00:00Z,296,241,14283,-55,-0.003850732,0.016873206,0.020723938,2013,NUE
2014-02-28T00:00:00Z,309,263,14941,-46,-0.003078777,0.01760257,0.020681347,2014,NUE
2015-02-27T00:00:00Z,305,260,15173,-45,-0.002965795,0.017135702,0.020101496,2015,NUE
2016-02-26T00:00:00Z,307,258,15773,-49,-0.003106575,0.016357066,0.01946364,2016,NUE
2017-02-28T00:00:00Z,291,255,14876,-36,-0.002420005,0.017141705,0.01956171,2017,NUE
2018-02-28T00:00:00Z,295,252,14562,-43,-0.002952891,0.017305315,0.020258206,2018,NUE
2019-02-28T00:00:00Z,288,248,14490,-40,-0.002760524,0.017115252,0.019875776,2019,NUE
2010-03-18T00:00:00Z,1459,1479,70147,20,0.000285116,0.021084294,0.020799179,2010,NVDA
2011-03-16T00:00:00Z,1382,1471,66307,89,0.001342241,0.022184686,0.020842445,2011,NVDA
2012-03-13T00:00:00Z,1430,1473,65539,43,0.000656098,0.022475167,0.02181907,2012,NVDA
2013-03-12T00:00:00Z,1264,1401,61600,137,0.002224026,0.022743506,0.020519481,2013,NVDA
2014-03-13T00:00:00Z,1055,1221,56395,166,0.002943523,0.021650856,0.018707332,2014,NVDA
2015-03-12T00:00:00Z,757,886,46168,129,0.002794143,0.019190781,0.016396638,2015,NVDA
2016-03-17T00:00:00Z,834,957,48945,123,0.002513025,0.019552559,0.017039534,2016,NVDA
2017-03-01T00:00:00Z,792,918,48945,126,0.002574318,0.018755746,0.016181428,2017,NVDA
2018-02-28T00:00:00Z,758,939,44267,181,0.004088825,0.02121219,0.017123365,2018,NVDA
2019-02-21T00:00:00Z,754,854,42847,100,0.002333886,0.019931384,0.017597498,2019,NVDA
2010-02-26T00:00:00Z,578,952,48887,374,0.007650296,0.01947348,0.011823184,2010,ORLY
2011-02-28T00:00:00Z,616,1029,51425,413,0.008031113,0.020009723,0.01197861,2011,ORLY
2012-02-28T00:00:00Z,623,1032,49411,409,0.008277509,0.020886038,0.012608528,2012,ORLY
2013-02-28T00:00:00Z,610,930,47626,320,0.006719019,0.019527149,0.01280813,2013,ORLY
2014-02-28T00:00:00Z,590,938,45864,348,0.00758765,0.02045177,0.01286412,2014,ORLY
2015-02-27T00:00:00Z,558,902,42781,344,0.008040953,0.021084126,0.013043173,2015,ORLY
2016-02-26T00:00:00Z,588,971,45170,383,0.008479079,0.021496569,0.013017489,2016,ORLY
2017-02-28T00:00:00Z,586,1051,47158,465,0.009860469,0.022286781,0.012426312,2017,ORLY
2018-02-28T00:00:00Z,585,1054,48453,469,0.009679483,0.021753039,0.012073556,2018,ORLY
2019-02-27T00:00:00Z,566,1026,47969,460,0.009589527,0.021388814,0.011799287,2019,ORLY
2010-02-25T00:00:00Z,711,1070,52877,359,0.006789341,0.020235641,0.0134463,2010,OXY
2011-02-24T00:00:00Z,746,1067,55190,321,0.005816271,0.019333213,0.013516941,2011,OXY
2012-02-23T00:00:00Z,694,1071,54437,377,0.006925437,0.019674119,0.012748682,2012,OXY
2013-02-26T00:00:00Z,670,1044,53108,374,0.007042254,0.019658055,0.012615802,2013,OXY
2014-03-03T00:00:00Z,662,1092,54446,430,0.007897734,0.02005657,0.012158836,2014,OXY
2015-02-23T00:00:00Z,759,1209,61408,450,0.007328035,0.019687989,0.012359953,2015,OXY
2016-02-26T00:00:00Z,818,1219,61687,401,0.006500559,0.019761052,0.013260492,2016,OXY
2017-02-23T00:00:00Z,841,1186,61049,345,0.005651198,0.019427018,0.013775819,2017,OXY
2018-02-23T00:00:00Z,828,1166,57017,338,0.005928057,0.020450041,0.014521985,2018,OXY
2019-02-21T00:00:00Z,850,1167,56524,317,0.005608237,0.020646097,0.01503786,2019,OXY
2011-02-23T00:00:00Z,102,132,9236,30,0.003248159,0.014291901,0.011043742,2011,OMC
2012-02-17T00:00:00Z,519,876,38030,357,0.009387326,0.023034446,0.013647121,2012,OMC
2013-02-19T00:00:00Z,515,922,39350,407,0.010343075,0.02343075,0.013087675,2013,OMC
2014-02-12T00:00:00Z,553,950,41011,397,0.00968033,0.023164517,0.013484187,2014,OMC
2015-02-10T00:00:00Z,532,826,37409,294,0.007859071,0.022080248,0.014221177,2015,OMC
2016-02-09T00:00:00Z,519,797,36058,278,0.007709801,0.022103278,0.014393477,2016,OMC
2017-02-09T00:00:00Z,515,775,35130,260,0.007401082,0.022060917,0.014659835,2017,OMC
2018-02-15T00:00:00Z,530,804,37066,274,0.007392219,0.021691038,0.014298818,2018,OMC
2019-02-12T00:00:00Z,523,895,40206,372,0.00925235,0.022260359,0.013008009,2019,OMC
2011-02-22T00:00:00Z,1229,1447,72476,218,0.003007892,0.01996523,0.016957338,2011,OKE
2012-02-21T00:00:00Z,1455,1529,79144,74,0.000935005,0.019319216,0.018384211,2012,OKE
2013-02-26T00:00:00Z,1547,1628,83967,81,0.000964665,0.019388569,0.018423905,2013,OKE
2014-02-25T00:00:00Z,1571,1728,91173,157,0.001722001,0.01895298,0.017230978,2014,OKE
2015-02-25T00:00:00Z,1619,1525,88044,-94,-0.001067648,0.017320885,0.018388533,2015,OKE
2016-02-23T00:00:00Z,1634,1560,90396,-74,-0.00081862,0.017257401,0.018076021,2016,OKE
2017-02-28T00:00:00Z,1460,1455,81156,-5,-6.16E-05,0.017928434,0.017990044,2017,OKE
2018-02-27T00:00:00Z,1288,1364,76199,76,0.000997388,0.017900497,0.016903109,2018,OKE
2019-02-26T00:00:00Z,1205,1267,71618,62,0.000865704,0.017691083,0.016825379,2019,OKE
2009-06-29T00:00:00Z,801,1783,69925,982,0.014043618,0.025498749,0.01145513,2009,ORCL
2010-07-01T00:00:00Z,964,2034,80972,1070,0.013214444,0.025119794,0.01190535,2010,ORCL
2011-06-28T00:00:00Z,1027,2002,77133,975,0.012640504,0.025955168,0.013314664,2011,ORCL
2012-06-26T00:00:00Z,1068,2002,78029,934,0.011969909,0.025657127,0.013687219,2012,ORCL
2013-06-26T00:00:00Z,1026,1710,67688,684,0.010105189,0.025262971,0.015157783,2013,ORCL
2014-06-26T00:00:00Z,1263,2068,81121,805,0.009923448,0.025492782,0.015569335,2014,ORCL
2015-06-25T00:00:00Z,1343,2161,82893,818,0.009868143,0.026069753,0.016201609,2015,ORCL
2016-06-22T00:00:00Z,1517,2128,81831,611,0.007466608,0.026004815,0.018538207,2016,ORCL
2017-06-27T00:00:00Z,1431,2048,79466,617,0.007764327,0.025772028,0.018007701,2017,ORCL
2018-06-22T00:00:00Z,308,407,20202,99,0.004900505,0.02014652,0.015246015,2018,ORCL
2010-02-26T00:00:00Z,91,73,7809,-18,-0.002305033,0.009348188,0.011653221,2010,PCAR
2011-03-01T00:00:00Z,98,74,8038,-24,-0.002985817,0.00920627,0.012192088,2011,PCAR
2012-02-29T00:00:00Z,112,89,8317,-23,-0.00276542,0.010700974,0.013466394,2012,PCAR
2013-02-27T00:00:00Z,115,90,8549,-25,-0.002924319,0.010527547,0.013451866,2013,PCAR
2014-02-27T00:00:00Z,572,518,36709,-54,-0.001471029,0.014110981,0.01558201,2014,PCAR
2015-02-26T00:00:00Z,593,520,37430,-73,-0.001950307,0.0138926,0.015842907,2015,PCAR
2016-02-16T00:00:00Z,589,516,38086,-73,-0.001916715,0.013548285,0.015465,2016,PCAR
2017-02-21T00:00:00Z,616,536,39651,-80,-0.002017604,0.013517944,0.015535548,2017,PCAR
2018-02-21T00:00:00Z,629,571,39822,-58,-0.001456481,0.014338808,0.015795289,2018,PCAR
2019-02-21T00:00:00Z,626,591,41396,-35,-0.000845492,0.014276742,0.015122234,2019,PCAR
2010-02-17T00:00:00Z,401,660,33487,259,0.007734345,0.019709141,0.011974796,2010,PKG
2011-02-22T00:00:00Z,438,651,35767,213,0.00595521,0.018201135,0.012245925,2011,PKG
2012-02-21T00:00:00Z,443,707,36822,264,0.007169627,0.019200478,0.012030851,2012,PKG
2013-02-28T00:00:00Z,387,673,34118,286,0.008382672,0.019725658,0.011342986,2013,PKG
2014-02-28T00:00:00Z,533,841,43133,308,0.007140704,0.019497832,0.012357128,2014,PKG
2015-02-27T00:00:00Z,530,835,44730,305,0.00681869,0.018667561,0.011848871,2015,PKG
2016-02-26T00:00:00Z,502,863,43512,361,0.008296562,0.019833609,0.011537047,2016,PKG
2017-02-28T00:00:00Z,483,913,42997,430,0.010000698,0.02123404,0.011233342,2017,PKG
2018-02-28T00:00:00Z,552,985,46469,433,0.00931804,0.021196927,0.011878887,2018,PKG
2019-02-28T00:00:00Z,563,979,46057,416,0.009032286,0.021256269,0.012223983,2019,PKG
2009-08-27T00:00:00Z,206,173,12195,-33,-0.002706027,0.014186142,0.016892169,2009,PH
2010-08-26T00:00:00Z,225,202,13520,-23,-0.001701183,0.014940828,0.016642012,2010,PH
2011-08-26T00:00:00Z,210,202,13601,-8,-0.000588192,0.014851849,0.015440041,2011,PH
2012-08-24T00:00:00Z,203,183,12576,-20,-0.001590331,0.014551527,0.016141858,2012,PH
2013-08-29T00:00:00Z,200,202,13005,2,0.000153787,0.015532488,0.0153787,2013,PH
2014-08-22T00:00:00Z,195,196,12090,1,8.27E-05,0.016211745,0.016129032,2014,PH
2015-08-26T00:00:00Z,195,215,12821,20,0.001559941,0.016769363,0.015209422,2015,PH
2016-08-26T00:00:00Z,480,909,34177,429,0.012552301,0.026596834,0.014044533,2016,PH
2017-08-25T00:00:00Z,507,920,35447,413,0.011651198,0.025954242,0.014303044,2017,PH
2018-08-24T00:00:00Z,505,934,35954,429,0.011931913,0.025977638,0.014045725,2018,PH
2009-07-20T00:00:00Z,522,958,37066,436,0.011762801,0.025845789,0.014082987,2009,PAYX
2010-07-16T00:00:00Z,477,914,34627,437,0.01262021,0.026395587,0.013775378,2010,PAYX
2011-07-15T00:00:00Z,443,902,34729,459,0.01321662,0.02597253,0.01275591,2011,PAYX
2012-07-20T00:00:00Z,444,892,34768,448,0.012885412,0.025655775,0.012770364,2012,PAYX
2013-07-22T00:00:00Z,423,927,33961,504,0.014840552,0.027296016,0.012455464,2013,PAYX
2014-07-22T00:00:00Z,437,959,36085,522,0.014465845,0.02657614,0.012110295,2014,PAYX
2015-07-21T00:00:00Z,434,949,35059,515,0.014689523,0.027068656,0.012379132,2015,PAYX
2016-07-22T00:00:00Z,464,960,35849,496,0.013835811,0.02677899,0.012943178,2016,PAYX
2017-07-21T00:00:00Z,534,1045,39759,511,0.012852436,0.026283357,0.013430921,2017,PAYX
2018-07-20T00:00:00Z,589,1050,41528,461,0.011100944,0.025284146,0.014183202,2018,PAYX
2016-02-11T00:00:00Z,1224,1408,65123,184,0.002825423,0.021620626,0.018795203,2016,PYPL
2017-02-08T00:00:00Z,1357,1478,69204,121,0.001748454,0.021357147,0.019608693,2017,PYPL
2018-02-07T00:00:00Z,1422,1651,76095,229,0.003009396,0.021696564,0.018687167,2018,PYPL
2019-02-07T00:00:00Z,1526,1681,76214,155,0.002033747,0.022056315,0.020022568,2019,PYPL
2012-02-21T00:00:00Z,645,1037,41943,392,0.009346017,0.02472403,0.015378013,2012,PNR
2013-02-26T00:00:00Z,1018,1413,62502,395,0.006319798,0.022607277,0.016287479,2013,PNR
2014-02-25T00:00:00Z,1037,1394,63652,357,0.005608622,0.021900333,0.016291711,2014,PNR
2015-02-24T00:00:00Z,1059,1206,58277,147,0.002522436,0.02069427,0.018171835,2015,PNR
2016-02-26T00:00:00Z,1057,1263,59282,206,0.003474917,0.021304949,0.017830033,2016,PNR
2017-02-21T00:00:00Z,948,1102,53466,154,0.002880335,0.02061123,0.017730894,2017,PNR
2018-02-27T00:00:00Z,910,1084,49953,174,0.003483274,0.021700398,0.018217124,2018,PNR
2019-02-19T00:00:00Z,876,1064,48356,188,0.003887832,0.022003474,0.018115642,2019,PNR
2010-03-01T00:00:00Z,1169,1727,75352,558,0.007405245,0.0229191,0.015513855,2010,PBCT
2011-03-01T00:00:00Z,1456,1949,85696,493,0.005752894,0.022743185,0.016990291,2011,PBCT
2012-02-29T00:00:00Z,1610,1984,91768,374,0.004075495,0.021619737,0.017544242,2012,PBCT
2013-03-01T00:00:00Z,1697,2019,94417,322,0.003410403,0.021383861,0.017973458,2013,PBCT
2014-03-03T00:00:00Z,1551,1960,90239,409,0.004532408,0.021720099,0.01718769,2014,PBCT
2015-03-02T00:00:00Z,907,1258,52356,351,0.006704103,0.02402781,0.017323707,2015,PBCT
2016-02-29T00:00:00Z,1420,1820,86128,400,0.00464425,0.021131339,0.016487089,2016,PBCT
2017-03-01T00:00:00Z,1451,1870,88217,419,0.004749651,0.021197728,0.016448077,2017,PBCT
2018-03-01T00:00:00Z,1484,2004,92240,520,0.005637467,0.021725932,0.016088465,2018,PBCT
2019-03-01T00:00:00Z,1582,2006,93157,424,0.004551456,0.02153354,0.016982084,2019,PBCT
2010-02-22T00:00:00Z,758,1271,51498,513,0.009961552,0.02468057,0.014719018,2010,PEP
2011-02-18T00:00:00Z,740,1331,56298,591,0.010497709,0.023642048,0.013144339,2011,PEP
2012-02-27T00:00:00Z,791,1302,57251,511,0.008925608,0.022741961,0.013816353,2012,PEP
2013-02-21T00:00:00Z,841,1339,58816,498,0.008467084,0.022765914,0.01429883,2013,PEP
2014-02-14T00:00:00Z,1020,1350,61886,330,0.005332385,0.021814304,0.016481918,2014,PEP
2015-02-12T00:00:00Z,997,1369,63200,372,0.005886076,0.021661392,0.015775316,2015,PEP
2016-02-11T00:00:00Z,980,1383,64417,403,0.006256113,0.021469488,0.015213375,2016,PEP
2017-02-15T00:00:00Z,1066,1571,67842,505,0.007443766,0.023156747,0.01571298,2017,PEP
2018-02-13T00:00:00Z,1119,1608,70397,489,0.006946319,0.022841882,0.015895564,2018,PEP
2019-02-15T00:00:00Z,1144,1678,68996,534,0.007739579,0.02432025,0.016580671,2019,PEP
2010-03-01T00:00:00Z,1068,1658,72981,590,0.008084296,0.022718242,0.014633946,2010,PKI
2011-03-01T00:00:00Z,991,1574,69365,583,0.008404815,0.022691559,0.014286744,2011,PKI
2012-02-28T00:00:00Z,964,1605,73113,641,0.008767251,0.02195232,0.01318507,2012,PKI
2013-02-26T00:00:00Z,954,1578,74249,624,0.008404154,0.021252811,0.012848658,2013,PKI
2014-02-25T00:00:00Z,979,1553,73378,574,0.007822508,0.021164382,0.013341874,2014,PKI
2015-02-24T00:00:00Z,964,1526,69957,562,0.008033506,0.0218134,0.013779893,2015,PKI
2016-03-01T00:00:00Z,982,1501,69725,519,0.007443528,0.021527429,0.014083901,2016,PKI
2017-02-28T00:00:00Z,1081,1665,74850,584,0.007802271,0.022244489,0.014442218,2017,PKI
2018-02-27T00:00:00Z,1090,1642,74810,552,0.007378693,0.021948937,0.014570245,2018,PKI
2019-02-26T00:00:00Z,1102,1721,78746,619,0.007860717,0.021855078,0.013994362,2019,PKI
2014-08-14T00:00:00Z,1472,1667,83062,195,0.002347644,0.020069346,0.017721702,2014,PRGO
2015-08-13T00:00:00Z,1276,1492,73036,216,0.002957446,0.020428282,0.017470836,2015,PRGO
2017-05-22T00:00:00Z,1839,2585,122807,746,0.006074572,0.021049289,0.014974716,2017,PRGO
2018-03-01T00:00:00Z,1674,2042,98065,368,0.003752613,0.020822924,0.017070311,2018,PRGO
2019-02-27T00:00:00Z,1639,1764,84206,125,0.001484455,0.020948626,0.019464171,2019,PRGO
2011-02-28T00:00:00Z,379,561,22710,182,0.008014091,0.024702774,0.016688683,2011,PFE
2012-02-28T00:00:00Z,522,717,29156,195,0.00668816,0.024591851,0.01790369,2012,PFE
2013-02-28T00:00:00Z,519,660,29461,141,0.004785988,0.022402498,0.01761651,2013,PFE
2014-02-28T00:00:00Z,530,702,30274,172,0.005681443,0.023188214,0.017506771,2014,PFE
2015-02-27T00:00:00Z,486,652,26780,166,0.006198656,0.024346527,0.018147872,2015,PFE
2016-02-29T00:00:00Z,621,778,32568,157,0.004820683,0.023888479,0.019067797,2016,PFE
2017-02-23T00:00:00Z,584,739,31230,155,0.004963176,0.023663144,0.018699968,2017,PFE
2018-02-22T00:00:00Z,616,795,32810,179,0.005455654,0.024230418,0.018774764,2018,PFE
2019-02-28T00:00:00Z,680,877,35969,197,0.005476938,0.024382107,0.018905168,2019,PFE
2010-02-26T00:00:00Z,363,368,19591,5,0.000255219,0.018784136,0.018528916,2010,PM
2011-02-25T00:00:00Z,347,350,19248,3,0.00015586,0.018183707,0.018027847,2011,PM
2012-02-24T00:00:00Z,351,331,18602,-20,-0.001075153,0.017793786,0.018868939,2012,PM
2013-02-22T00:00:00Z,349,348,18686,-1,-5.35E-05,0.018623568,0.018677084,2013,PM
2014-02-21T00:00:00Z,335,340,18510,5,0.000270124,0.018368449,0.018098325,2014,PM
2015-02-20T00:00:00Z,1155,1284,65347,129,0.001974077,0.019648951,0.017674874,2015,PM
2016-02-17T00:00:00Z,1332,1466,72465,134,0.001849169,0.020230456,0.018381288,2016,PM
2017-02-14T00:00:00Z,1290,1447,69143,157,0.002270656,0.020927643,0.018656986,2017,PM
2018-02-13T00:00:00Z,1021,1289,60988,268,0.004394307,0.021135305,0.016740998,2018,PM
2019-02-07T00:00:00Z,1140,1416,62075,276,0.004446234,0.022811116,0.018364881,2019,PM
2013-02-22T00:00:00Z,968,1436,63213,468,0.00740354,0.022716846,0.015313306,2013,PSX
2014-02-21T00:00:00Z,1318,1839,83644,521,0.006228779,0.021986036,0.015757257,2014,PSX
2015-02-20T00:00:00Z,1014,1433,63210,419,0.006628698,0.022670464,0.016041766,2015,PSX
2016-02-19T00:00:00Z,1010,1430,61888,420,0.006786453,0.023106256,0.016319804,2016,PSX
2017-02-17T00:00:00Z,1037,1466,63642,429,0.006740832,0.023035103,0.016294271,2017,PSX
2018-02-23T00:00:00Z,1031,1440,63491,409,0.006441858,0.02268038,0.016238522,2018,PSX
2019-02-22T00:00:00Z,975,1388,61295,413,0.006737907,0.022644588,0.015906681,2019,PSX
2010-02-19T00:00:00Z,1031,2138,77206,1107,0.014338264,0.027692148,0.013353884,2010,PNW
2011-02-18T00:00:00Z,1022,2167,79531,1145,0.014396902,0.027247237,0.012850335,2011,PNW
2012-02-24T00:00:00Z,1018,2128,78360,1110,0.014165391,0.027156713,0.012991322,2012,PNW
2013-02-22T00:00:00Z,1080,2292,81431,1212,0.014883767,0.028146529,0.013262762,2013,PNW
2014-02-21T00:00:00Z,1075,2280,82610,1205,0.014586612,0.027599564,0.013012952,2014,PNW
2015-02-20T00:00:00Z,1028,2222,82633,1194,0.014449433,0.026889983,0.01244055,2015,PNW
2016-02-19T00:00:00Z,1010,2204,82951,1194,0.01439404,0.026569903,0.012175863,2016,PNW
2017-02-24T00:00:00Z,1062,2319,88430,1257,0.014214633,0.026224132,0.012009499,2017,PNW
2018-02-23T00:00:00Z,1185,2487,92742,1302,0.014038947,0.026816329,0.012777382,2018,PNW
2019-02-22T00:00:00Z,1191,2531,99886,1340,0.013415293,0.025338886,0.011923593,2019,PNW
2012-02-21T00:00:00Z,645,1037,41943,392,0.009346017,0.02472403,0.015378013,2012,PNR
2013-02-26T00:00:00Z,1018,1413,62502,395,0.006319798,0.022607277,0.016287479,2013,PNR
2014-02-25T00:00:00Z,1037,1394,63652,357,0.005608622,0.021900333,0.016291711,2014,PNR
2015-02-24T00:00:00Z,1059,1206,58277,147,0.002522436,0.02069427,0.018171835,2015,PNR
2016-02-26T00:00:00Z,1057,1263,59282,206,0.003474917,0.021304949,0.017830033,2016,PNR
2017-02-21T00:00:00Z,948,1102,53466,154,0.002880335,0.02061123,0.017730894,2017,PNR
2018-02-27T00:00:00Z,910,1084,49953,174,0.003483274,0.021700398,0.018217124,2018,PNR
2019-02-19T00:00:00Z,876,1064,48356,188,0.003887832,0.022003474,0.018115642,2019,PNR
2010-03-01T00:00:00Z,1169,1727,75352,558,0.007405245,0.0229191,0.015513855,2010,PBCT
2011-03-01T00:00:00Z,1456,1949,85696,493,0.005752894,0.022743185,0.016990291,2011,PBCT
2012-02-29T00:00:00Z,1610,1984,91768,374,0.004075495,0.021619737,0.017544242,2012,PBCT
2013-03-01T00:00:00Z,1697,2019,94417,322,0.003410403,0.021383861,0.017973458,2013,PBCT
2014-03-03T00:00:00Z,1551,1960,90239,409,0.004532408,0.021720099,0.01718769,2014,PBCT
2015-03-02T00:00:00Z,907,1258,52356,351,0.006704103,0.02402781,0.017323707,2015,PBCT
2016-02-29T00:00:00Z,1420,1820,86128,400,0.00464425,0.021131339,0.016487089,2016,PBCT
2017-03-01T00:00:00Z,1451,1870,88217,419,0.004749651,0.021197728,0.016448077,2017,PBCT
2018-03-01T00:00:00Z,1484,2004,92240,520,0.005637467,0.021725932,0.016088465,2018,PBCT
2019-03-01T00:00:00Z,1582,2006,93157,424,0.004551456,0.02153354,0.016982084,2019,PBCT
2010-02-22T00:00:00Z,758,1271,51498,513,0.009961552,0.02468057,0.014719018,2010,PEP
2011-02-18T00:00:00Z,740,1331,56298,591,0.010497709,0.023642048,0.013144339,2011,PEP
2012-02-27T00:00:00Z,791,1302,57251,511,0.008925608,0.022741961,0.013816353,2012,PEP
2013-02-21T00:00:00Z,841,1339,58816,498,0.008467084,0.022765914,0.01429883,2013,PEP
2014-02-14T00:00:00Z,1020,1350,61886,330,0.005332385,0.021814304,0.016481918,2014,PEP
2015-02-12T00:00:00Z,997,1369,63200,372,0.005886076,0.021661392,0.015775316,2015,PEP
2016-02-11T00:00:00Z,980,1383,64417,403,0.006256113,0.021469488,0.015213375,2016,PEP
2017-02-15T00:00:00Z,1066,1571,67842,505,0.007443766,0.023156747,0.01571298,2017,PEP
2018-02-13T00:00:00Z,1119,1608,70397,489,0.006946319,0.022841882,0.015895564,2018,PEP
2019-02-15T00:00:00Z,1144,1678,68996,534,0.007739579,0.02432025,0.016580671,2019,PEP
2010-03-01T00:00:00Z,1068,1658,72981,590,0.008084296,0.022718242,0.014633946,2010,PKI
2011-03-01T00:00:00Z,991,1574,69365,583,0.008404815,0.022691559,0.014286744,2011,PKI
2012-02-28T00:00:00Z,964,1605,73113,641,0.008767251,0.02195232,0.01318507,2012,PKI
2013-02-26T00:00:00Z,954,1578,74249,624,0.008404154,0.021252811,0.012848658,2013,PKI
2014-02-25T00:00:00Z,979,1553,73378,574,0.007822508,0.021164382,0.013341874,2014,PKI
2015-02-24T00:00:00Z,964,1526,69957,562,0.008033506,0.0218134,0.013779893,2015,PKI
2016-03-01T00:00:00Z,982,1501,69725,519,0.007443528,0.021527429,0.014083901,2016,PKI
2017-02-28T00:00:00Z,1081,1665,74850,584,0.007802271,0.022244489,0.014442218,2017,PKI
2018-02-27T00:00:00Z,1090,1642,74810,552,0.007378693,0.021948937,0.014570245,2018,PKI
2019-02-26T00:00:00Z,1102,1721,78746,619,0.007860717,0.021855078,0.013994362,2019,PKI
2014-08-14T00:00:00Z,1472,1667,83062,195,0.002347644,0.020069346,0.017721702,2014,PRGO
2015-08-13T00:00:00Z,1276,1492,73036,216,0.002957446,0.020428282,0.017470836,2015,PRGO
2017-05-22T00:00:00Z,1839,2585,122807,746,0.006074572,0.021049289,0.014974716,2017,PRGO
2018-03-01T00:00:00Z,1674,2042,98065,368,0.003752613,0.020822924,0.017070311,2018,PRGO
2019-02-27T00:00:00Z,1639,1764,84206,125,0.001484455,0.020948626,0.019464171,2019,PRGO
2011-02-28T00:00:00Z,379,561,22710,182,0.008014091,0.024702774,0.016688683,2011,PFE
2012-02-28T00:00:00Z,522,717,29156,195,0.00668816,0.024591851,0.01790369,2012,PFE
2013-02-28T00:00:00Z,519,660,29461,141,0.004785988,0.022402498,0.01761651,2013,PFE
2014-02-28T00:00:00Z,530,702,30274,172,0.005681443,0.023188214,0.017506771,2014,PFE
2015-02-27T00:00:00Z,486,652,26780,166,0.006198656,0.024346527,0.018147872,2015,PFE
2016-02-29T00:00:00Z,621,778,32568,157,0.004820683,0.023888479,0.019067797,2016,PFE
2017-02-23T00:00:00Z,584,739,31230,155,0.004963176,0.023663144,0.018699968,2017,PFE
2018-02-22T00:00:00Z,616,795,32810,179,0.005455654,0.024230418,0.018774764,2018,PFE
2019-02-28T00:00:00Z,680,877,35969,197,0.005476938,0.024382107,0.018905168,2019,PFE
2010-02-26T00:00:00Z,363,368,19591,5,0.000255219,0.018784136,0.018528916,2010,PM
2011-02-25T00:00:00Z,347,350,19248,3,0.00015586,0.018183707,0.018027847,2011,PM
2012-02-24T00:00:00Z,351,331,18602,-20,-0.001075153,0.017793786,0.018868939,2012,PM
2013-02-22T00:00:00Z,349,348,18686,-1,-5.35E-05,0.018623568,0.018677084,2013,PM
2014-02-21T00:00:00Z,335,340,18510,5,0.000270124,0.018368449,0.018098325,2014,PM
2015-02-20T00:00:00Z,1155,1284,65347,129,0.001974077,0.019648951,0.017674874,2015,PM
2016-02-17T00:00:00Z,1332,1466,72465,134,0.001849169,0.020230456,0.018381288,2016,PM
2017-02-14T00:00:00Z,1290,1447,69143,157,0.002270656,0.020927643,0.018656986,2017,PM
2018-02-13T00:00:00Z,1021,1289,60988,268,0.004394307,0.021135305,0.016740998,2018,PM
2019-02-07T00:00:00Z,1140,1416,62075,276,0.004446234,0.022811116,0.018364881,2019,PM
2013-02-22T00:00:00Z,968,1436,63213,468,0.00740354,0.022716846,0.015313306,2013,PSX
2014-02-21T00:00:00Z,1318,1839,83644,521,0.006228779,0.021986036,0.015757257,2014,PSX
2015-02-20T00:00:00Z,1014,1433,63210,419,0.006628698,0.022670464,0.016041766,2015,PSX
2016-02-19T00:00:00Z,1010,1430,61888,420,0.006786453,0.023106256,0.016319804,2016,PSX
2017-02-17T00:00:00Z,1037,1466,63642,429,0.006740832,0.023035103,0.016294271,2017,PSX
2018-02-23T00:00:00Z,1031,1440,63491,409,0.006441858,0.02268038,0.016238522,2018,PSX
2019-02-22T00:00:00Z,975,1388,61295,413,0.006737907,0.022644588,0.015906681,2019,PSX
2010-02-19T00:00:00Z,1031,2138,77206,1107,0.014338264,0.027692148,0.013353884,2010,PNW
2011-02-18T00:00:00Z,1022,2167,79531,1145,0.014396902,0.027247237,0.012850335,2011,PNW
2012-02-24T00:00:00Z,1018,2128,78360,1110,0.014165391,0.027156713,0.012991322,2012,PNW
2013-02-22T00:00:00Z,1080,2292,81431,1212,0.014883767,0.028146529,0.013262762,2013,PNW
2014-02-21T00:00:00Z,1075,2280,82610,1205,0.014586612,0.027599564,0.013012952,2014,PNW
2015-02-20T00:00:00Z,1028,2222,82633,1194,0.014449433,0.026889983,0.01244055,2015,PNW
2016-02-19T00:00:00Z,1010,2204,82951,1194,0.01439404,0.026569903,0.012175863,2016,PNW
2017-02-24T00:00:00Z,1062,2319,88430,1257,0.014214633,0.026224132,0.012009499,2017,PNW
2018-02-23T00:00:00Z,1185,2487,92742,1302,0.014038947,0.026816329,0.012777382,2018,PNW
2019-02-22T00:00:00Z,1191,2531,99886,1340,0.013415293,0.025338886,0.011923593,2019,PNW
2011-02-25T00:00:00Z,1269,1545,83779,276,0.003294382,0.018441376,0.015146994,2011,PXD
2012-02-29T00:00:00Z,1278,1499,82726,221,0.00267147,0.018120059,0.015448589,2012,PXD
2013-02-13T00:00:00Z,1318,1516,81726,198,0.00242273,0.018549788,0.016127059,2013,PXD
2014-02-27T00:00:00Z,1476,1660,86492,184,0.002127364,0.019192526,0.017065162,2014,PXD
2015-02-19T00:00:00Z,1344,1500,80282,156,0.00194315,0.018684138,0.016740988,2015,PXD
2016-02-19T00:00:00Z,1378,1482,82034,104,0.001267767,0.01806568,0.016797913,2016,PXD
2017-02-17T00:00:00Z,1349,1423,79619,74,0.000929426,0.017872618,0.016943192,2017,PXD
2018-02-20T00:00:00Z,1337,1344,75036,7,9.33E-05,0.017911403,0.017818114,2018,PXD
2019-02-26T00:00:00Z,1270,1266,71054,-4,-5.63E-05,0.017817435,0.01787373,2019,PXD
2011-03-01T00:00:00Z,2974,2958,134771,-16,-0.00011872,0.021948342,0.022067062,2011,PNC
2012-02-29T00:00:00Z,3289,3257,153338,-32,-0.000208689,0.021240658,0.021449347,2012,PNC
2013-03-01T00:00:00Z,3642,3736,172465,94,0.000545038,0.021662366,0.021117328,2013,PNC
2014-03-03T00:00:00Z,3717,3762,170567,45,0.000263826,0.022055849,0.021792023,2014,PNC
2015-03-02T00:00:00Z,3700,3745,171218,45,0.000262823,0.0218727,0.021609877,2015,PNC
2016-02-29T00:00:00Z,3567,3533,161267,-34,-0.00021083,0.021907768,0.022118598,2016,PNC
2017-02-28T00:00:00Z,2920,2851,126204,-69,-0.000546734,0.022590409,0.023137143,2017,PNC
2018-02-28T00:00:00Z,2688,2632,117835,-56,-0.000475241,0.022336318,0.022811559,2018,PNC
2019-03-01T00:00:00Z,2768,2689,117636,-79,-0.000671563,0.022858649,0.023530212,2019,PNC
2011-02-17T00:00:00Z,757,1261,57982,504,0.008692353,0.021748129,0.013055776,2011,PPG
2012-02-16T00:00:00Z,844,1278,59631,434,0.007278094,0.021431806,0.014153712,2012,PPG
2013-02-21T00:00:00Z,845,1340,62884,495,0.007871637,0.021309077,0.01343744,2013,PPG
2014-02-20T00:00:00Z,726,1266,57865,540,0.009332066,0.02187851,0.012546444,2014,PPG
2015-02-19T00:00:00Z,690,1265,56980,575,0.01009126,0.022200772,0.012109512,2015,PPG
2016-02-18T00:00:00Z,664,1238,55256,574,0.010388012,0.022404807,0.012016795,2016,PPG
2017-02-16T00:00:00Z,669,1281,55974,612,0.010933648,0.022885625,0.011951978,2017,PPG
2018-02-15T00:00:00Z,591,1242,49929,651,0.013038515,0.024875323,0.011836808,2018,PPG
2019-02-21T00:00:00Z,624,1256,49628,632,0.012734747,0.025308294,0.012573547,2019,PPG
2010-02-26T00:00:00Z,2771,3309,156835,538,0.003430357,0.021098607,0.01766825,2010,PPL
2011-02-28T00:00:00Z,2967,3529,174566,562,0.003219413,0.02021585,0.016996437,2011,PPL
2012-02-28T00:00:00Z,4207,5688,264629,1481,0.005596514,0.021494243,0.015897729,2012,PPL
2013-02-28T00:00:00Z,3923,5263,246393,1340,0.005438466,0.021360185,0.015921719,2013,PPL
2014-02-24T00:00:00Z,2651,3567,177168,916,0.005170234,0.020133433,0.014963199,2014,PPL
2015-02-23T00:00:00Z,2743,3565,176369,822,0.004660683,0.020213303,0.01555262,2015,PPL
2016-02-19T00:00:00Z,889,939,58868,50,0.000849358,0.015950941,0.015101583,2016,PPL
2017-02-17T00:00:00Z,1662,2544,127971,882,0.006892187,0.019879504,0.012987317,2017,PPL
2018-02-22T00:00:00Z,1709,2780,135518,1071,0.007903009,0.02051388,0.012610871,2018,PPL
2019-02-14T00:00:00Z,1831,2750,138774,919,0.006622278,0.019816392,0.013194114,2019,PPL
2010-02-17T00:00:00Z,2404,3060,116905,656,0.005611394,0.026175099,0.020563706,2010,PFG
2011-02-16T00:00:00Z,2390,3118,121005,728,0.00601628,0.02576753,0.01975125,2011,PFG
2012-02-15T00:00:00Z,2271,3080,120643,809,0.006705735,0.025529869,0.018824134,2012,PFG
2013-02-13T00:00:00Z,2368,3225,127168,857,0.006739117,0.025360153,0.018621037,2013,PFG
2014-02-12T00:00:00Z,2330,3240,127596,910,0.007131885,0.025392646,0.018260761,2014,PFG
2015-02-11T00:00:00Z,2305,3075,122216,770,0.006300321,0.025160372,0.018860051,2015,PFG
2016-02-10T00:00:00Z,2355,3080,122993,725,0.005894644,0.025042076,0.019147431,2016,PFG
2017-02-08T00:00:00Z,2381,3220,124632,839,0.006731818,0.025836061,0.019104243,2017,PFG
2018-02-09T00:00:00Z,2412,3321,126103,909,0.007208393,0.026335615,0.019127221,2018,PFG
2019-02-13T00:00:00Z,2349,3315,126417,966,0.007641377,0.026222739,0.018581362,2019,PFG
2009-08-14T00:00:00Z,88,163,9789,75,0.007661661,0.016651343,0.008989682,2009,PG
2010-08-13T00:00:00Z,110,202,11645,92,0.007900386,0.017346501,0.009446114,2010,PG
2011-08-10T00:00:00Z,116,191,11332,75,0.006618426,0.016854924,0.010236498,2011,PG
2012-08-08T00:00:00Z,530,1194,45119,664,0.014716638,0.026463352,0.011746714,2012,PG
2013-08-08T00:00:00Z,538,1187,45543,649,0.014250269,0.026063281,0.011813012,2013,PG
2014-08-08T00:00:00Z,546,1177,46190,631,0.013660966,0.025481706,0.01182074,2014,PG
2015-08-07T00:00:00Z,581,1160,47355,579,0.012226798,0.024495829,0.012269032,2015,PG
2016-08-09T00:00:00Z,614,1144,46387,530,0.011425615,0.024662082,0.013236467,2016,PG
2017-08-07T00:00:00Z,627,1242,47610,615,0.012917454,0.026086957,0.013169502,2017,PG
2018-08-07T00:00:00Z,637,1251,49487,614,0.012407299,0.025279366,0.012872067,2018,PG
2010-03-01T00:00:00Z,600,561,22526,-39,-0.001731333,0.024904555,0.026635887,2010,PGR
2011-03-01T00:00:00Z,619,597,23215,-22,-0.000947663,0.025716132,0.026663795,2011,PGR
2012-02-28T00:00:00Z,665,633,24734,-32,-0.001293766,0.025592302,0.026886068,2012,PGR
2013-02-26T00:00:00Z,686,649,25179,-37,-0.001469479,0.025775448,0.027244926,2013,PGR
2014-02-26T00:00:00Z,691,659,25668,-32,-0.001246688,0.025673991,0.026920679,2014,PGR
2015-03-02T00:00:00Z,730,706,27188,-24,-0.000882742,0.025967339,0.026850081,2015,PGR
2016-02-29T00:00:00Z,619,640,24996,21,0.000840134,0.025604097,0.024763962,2016,PGR
2017-03-01T00:00:00Z,548,638,24101,90,0.003734285,0.026471931,0.022737646,2017,PGR
2018-02-27T00:00:00Z,576,676,25118,100,0.003981209,0.026912971,0.022931762,2018,PGR
2019-02-27T00:00:00Z,534,601,23110,67,0.002899178,0.026006058,0.02310688,2019,PGR
2011-02-18T00:00:00Z,2334,2719,144699,385,0.002660696,0.018790731,0.016130035,2011,PLD
2012-02-29T00:00:00Z,1194,1607,89809,413,0.004598648,0.01789353,0.013294881,2012,PLD
2013-02-28T00:00:00Z,1265,1640,89745,375,0.004178506,0.018273999,0.014095493,2013,PLD
2014-02-26T00:00:00Z,1235,1512,83788,277,0.003305963,0.018045544,0.014739581,2014,PLD
2015-02-25T00:00:00Z,1074,1247,73954,173,0.002339292,0.016861833,0.014522541,2015,PLD
2016-02-19T00:00:00Z,1009,1266,74758,257,0.003437759,0.016934642,0.013496883,2016,PLD
2017-02-15T00:00:00Z,922,1248,72869,326,0.004473782,0.017126624,0.012652843,2017,PLD
2018-02-15T00:00:00Z,911,1205,67074,294,0.004383219,0.017965232,0.013582014,2018,PLD
2019-02-13T00:00:00Z,902,1184,60026,282,0.004697964,0.019724786,0.015026822,2019,PLD
2011-02-25T00:00:00Z,5065,6373,264168,1308,0.004951395,0.024124799,0.019173405,2011,PRU
2012-02-24T00:00:00Z,4947,6333,264902,1386,0.005232124,0.023906954,0.018674831,2012,PRU
2013-02-22T00:00:00Z,4112,5381,220633,1269,0.005751633,0.024388917,0.018637285,2013,PRU
2014-02-27T00:00:00Z,4495,5420,223250,925,0.004143337,0.024277716,0.020134378,2014,PRU
2015-02-20T00:00:00Z,4456,5249,216791,793,0.003657901,0.02421226,0.020554359,2015,PRU
2016-02-19T00:00:00Z,4189,5029,202778,840,0.004142461,0.024800521,0.02065806,2016,PRU
2017-02-17T00:00:00Z,4208,4876,201629,668,0.003313015,0.024183029,0.020870014,2017,PRU
2018-02-16T00:00:00Z,3816,4613,186480,797,0.004273917,0.024737237,0.02046332,2018,PRU
2019-02-15T00:00:00Z,3639,4361,179426,722,0.004023943,0.024305285,0.020281342,2019,PRU
2010-02-25T00:00:00Z,1477,1888,95044,411,0.004324313,0.019864484,0.015540171,2010,PEG
2011-02-25T00:00:00Z,1556,1922,99297,366,0.003685912,0.019356073,0.015670161,2011,PEG
2012-02-27T00:00:00Z,1547,2063,100149,516,0.005152323,0.020599307,0.015446984,2012,PEG
2013-02-26T00:00:00Z,1543,2070,96252,527,0.005475211,0.021506047,0.016030836,2013,PEG
2014-02-26T00:00:00Z,1526,1959,91310,433,0.004742087,0.021454386,0.016712299,2014,PEG
2015-02-26T00:00:00Z,1533,2099,95704,566,0.005914068,0.021932208,0.016018139,2015,PEG
2016-02-26T00:00:00Z,1549,2200,99938,651,0.006514039,0.022013648,0.01549961,2016,PEG
2017-02-27T00:00:00Z,1684,2321,104648,637,0.006087073,0.022179115,0.016092042,2017,PEG
2018-02-26T00:00:00Z,1657,2347,105817,690,0.006520691,0.022179801,0.01565911,2018,PEG
2019-02-28T00:00:00Z,1704,2436,105817,732,0.006917603,0.023020876,0.016103273,2019,PEG
2010-03-01T00:00:00Z,784,1175,80209,391,0.004874765,0.014649229,0.009774464,2010,PSA
2011-03-01T00:00:00Z,730,1157,79407,427,0.00537736,0.014570504,0.009193144,2011,PSA
2012-02-27T00:00:00Z,721,1128,75713,407,0.005375563,0.014898366,0.009522803,2012,PSA
2013-02-26T00:00:00Z,642,981,71185,339,0.004762239,0.013780993,0.009018754,2013,PSA
2014-02-26T00:00:00Z,620,910,71652,290,0.00404734,0.012700274,0.008652934,2014,PSA
2015-02-25T00:00:00Z,608,873,71235,265,0.003720081,0.012255212,0.00853513,2015,PSA
2016-02-29T00:00:00Z,508,706,39701,198,0.00498728,0.017782927,0.012795647,2016,PSA
2017-03-01T00:00:00Z,491,737,40806,246,0.006028525,0.018061069,0.012032544,2017,PSA
2018-03-01T00:00:00Z,536,760,41451,224,0.005403971,0.018334901,0.01293093,2018,PSA
2019-02-27T00:00:00Z,587,816,43800,229,0.005228311,0.018630137,0.013401826,2019,PSA
2010-02-19T00:00:00Z,861,1119,53324,258,0.004838347,0.020984922,0.016146576,2010,PHM
2011-02-10T00:00:00Z,933,1199,55855,266,0.004762331,0.021466297,0.016703966,2011,PHM
2012-02-09T00:00:00Z,872,1027,50215,155,0.003086727,0.020452056,0.017365329,2012,PHM
2013-02-06T00:00:00Z,817,971,45566,154,0.003379713,0.021309748,0.017930036,2013,PHM
2014-02-05T00:00:00Z,772,937,44872,165,0.003677126,0.020881619,0.017204493,2014,PHM
2015-02-04T00:00:00Z,658,856,42884,198,0.004617107,0.019960825,0.015343718,2015,PHM
2016-02-08T00:00:00Z,647,817,41891,170,0.004058151,0.019502996,0.015444845,2016,PHM
2017-02-01T00:00:00Z,624,796,42645,172,0.004033298,0.018665729,0.014632431,2017,PHM
2018-02-07T00:00:00Z,669,859,44646,190,0.0042557,0.019240245,0.014984545,2018,PHM
2019-01-31T00:00:00Z,660,855,45751,195,0.004262202,0.018688116,0.014425914,2019,PHM
2010-03-31T00:00:00Z,112,181,10967,69,0.006291602,0.016504058,0.010212456,2010,PVH
2011-03-30T00:00:00Z,603,1234,60869,631,0.010366525,0.020273045,0.009906521,2011,PVH
2012-03-28T00:00:00Z,641,1258,62219,617,0.009916585,0.020218904,0.010302319,2012,PVH
2013-04-03T00:00:00Z,670,1415,68101,745,0.010939634,0.020777962,0.009838328,2013,PVH
2014-04-03T00:00:00Z,814,1597,73622,783,0.010635408,0.021691886,0.011056478,2014,PVH
2015-04-01T00:00:00Z,900,1630,73544,730,0.009926031,0.022163603,0.012237572,2015,PVH
2016-03-25T00:00:00Z,914,1687,73294,773,0.010546566,0.023016891,0.012470325,2016,PVH
2017-03-24T00:00:00Z,922,1769,76875,847,0.011017886,0.023011382,0.011993496,2017,PVH
2018-03-30T00:00:00Z,899,1695,74394,796,0.010699788,0.022784095,0.012084308,2018,PVH
2019-03-29T00:00:00Z,884,1740,76407,856,0.011203162,0.022772783,0.011569621,2019,PVH
2015-05-27T00:00:00Z,749,1257,51917,508,0.009784849,0.024211723,0.014426874,2015,QRVO
2016-05-31T00:00:00Z,860,1489,59700,629,0.010536013,0.024941374,0.01440536,2016,QRVO
2017-05-23T00:00:00Z,868,1425,59325,557,0.009388959,0.024020228,0.014631268,2017,QRVO
2018-05-21T00:00:00Z,866,1418,58422,552,0.009448495,0.024271678,0.014823183,2018,QRVO
2019-05-17T00:00:00Z,852,1196,52926,344,0.006499641,0.022597589,0.016097948,2019,QRVO
2011-03-01T00:00:00Z,1244,1478,72296,234,0.003236694,0.020443731,0.017207038,2011,PWR
2012-02-29T00:00:00Z,1341,1722,79140,381,0.004814253,0.021758908,0.016944655,2012,PWR
2013-03-01T00:00:00Z,1345,1700,78029,355,0.004549591,0.021786772,0.017237181,2013,PWR
2014-03-03T00:00:00Z,1408,1742,82779,334,0.00403484,0.021043985,0.017009145,2014,PWR
2015-03-02T00:00:00Z,1516,1837,89096,321,0.003602855,0.02061821,0.017015354,2015,PWR
2016-02-29T00:00:00Z,1573,1868,89349,295,0.00330166,0.020906781,0.017605121,2016,PWR
2017-03-01T00:00:00Z,1718,2066,95130,348,0.003658152,0.02171765,0.018059498,2017,PWR
2018-02-28T00:00:00Z,1657,1974,88196,317,0.003594267,0.022381967,0.0187877,2018,PWR
2019-02-28T00:00:00Z,1646,1944,89284,298,0.003337664,0.021773218,0.018435554,2019,PWR
2010-11-03T00:00:00Z,853,1181,53935,328,0.006081394,0.021896728,0.015815333,2010,QCOM
2011-11-02T00:00:00Z,904,1280,57917,376,0.006492049,0.022100592,0.015608543,2011,QCOM
2012-11-07T00:00:00Z,868,1298,56405,430,0.007623438,0.023012144,0.015388707,2012,QCOM
2013-11-06T00:00:00Z,837,1192,53369,355,0.006651802,0.022335063,0.015683262,2013,QCOM
2014-11-05T00:00:00Z,907,1277,56016,370,0.006605256,0.022797058,0.016191802,2014,QCOM
2015-11-04T00:00:00Z,886,1361,56672,475,0.008381564,0.024015387,0.015633823,2015,QCOM
2016-11-02T00:00:00Z,968,1492,60755,524,0.008624805,0.02455765,0.015932845,2016,QCOM
2017-11-01T00:00:00Z,1218,1692,72310,474,0.00655511,0.023399253,0.016844143,2017,QCOM
2018-11-07T00:00:00Z,1391,1785,77645,394,0.005074377,0.022989246,0.017914869,2018,QCOM
2010-02-17T00:00:00Z,1208,1611,67823,403,0.005941937,0.023753004,0.017811067,2010,DGX
2011-02-16T00:00:00Z,1237,1586,66967,349,0.005211522,0.023683307,0.018471785,2011,DGX
2012-02-16T00:00:00Z,1272,1621,70543,349,0.004947337,0.022978892,0.018031555,2012,DGX
2013-02-27T00:00:00Z,1159,1639,69507,480,0.006905779,0.023580359,0.01667458,2013,DGX
2014-02-18T00:00:00Z,1125,1629,69710,504,0.007229953,0.02336824,0.016138287,2014,DGX
2015-02-24T00:00:00Z,986,1527,63372,541,0.008536893,0.024095815,0.015558922,2015,DGX
2016-02-26T00:00:00Z,951,1691,65548,740,0.011289437,0.025797889,0.014508452,2016,DGX
2017-02-22T00:00:00Z,977,1755,68038,778,0.011434786,0.025794409,0.014359623,2017,DGX
2018-02-23T00:00:00Z,953,1746,67604,793,0.011730075,0.025826874,0.014096799,2018,DGX
2019-02-21T00:00:00Z,928,1686,66356,758,0.011423232,0.025408403,0.013985171,2019,DGX
2010-06-02T00:00:00Z,1034,1688,68091,654,0.009604794,0.024790354,0.01518556,2010,RL
2011-05-26T00:00:00Z,1048,1641,66555,593,0.008909924,0.024656299,0.015746375,2011,RL
2012-05-24T00:00:00Z,1070,1670,67477,600,0.008891919,0.024749174,0.015857255,2012,RL
2013-05-23T00:00:00Z,1113,1738,70459,625,0.008870407,0.024666828,0.015796421,2013,RL
2014-05-15T00:00:00Z,1047,1687,68160,640,0.009389671,0.024750587,0.015360915,2014,RL
2015-05-15T00:00:00Z,1060,1594,68242,534,0.007825093,0.023358049,0.015532956,2015,RL
2016-05-19T00:00:00Z,1017,1581,67046,564,0.008412135,0.023580825,0.01516869,2016,RL
2017-05-18T00:00:00Z,1183,1734,71825,551,0.007671424,0.024142012,0.016470588,2017,RL
2018-05-23T00:00:00Z,1181,1807,75688,626,0.008270796,0.023874326,0.01560353,2018,RL
2019-05-16T00:00:00Z,1152,1846,76574,694,0.009063128,0.024107399,0.015044271,2019,RL
2010-11-24T00:00:00Z,1531,1759,83343,228,0.002735683,0.021105552,0.018369869,2010,RJF
2011-11-23T00:00:00Z,1634,1914,87940,280,0.003183989,0.02176484,0.018580851,2011,RJF
2012-11-21T00:00:00Z,1938,2188,106320,250,0.002351392,0.020579383,0.018227991,2012,RJF
2013-11-26T00:00:00Z,1966,2241,111067,275,0.002475983,0.02017701,0.017701027,2013,RJF
2014-11-25T00:00:00Z,2083,2362,114361,279,0.002439643,0.020653894,0.018214251,2014,RJF
2015-11-25T00:00:00Z,2111,2419,114885,308,0.002680942,0.021055838,0.018374897,2015,RJF
2016-11-22T00:00:00Z,2219,2690,121439,471,0.00387849,0.022151039,0.018272548,2016,RJF
2017-11-22T00:00:00Z,1972,2407,105573,435,0.004120372,0.02279939,0.018679018,2017,RJF
2018-11-21T00:00:00Z,1823,2142,95244,319,0.003349292,0.022489606,0.019140313,2018,RJF
2010-02-24T00:00:00Z,1060,1812,71556,752,0.010509251,0.025322824,0.014813573,2010,RTN
2011-02-23T00:00:00Z,1065,1779,73416,714,0.0097254,0.024231775,0.014506375,2011,RTN
2012-02-22T00:00:00Z,1075,1857,78274,782,0.009990546,0.023724353,0.013733807,2012,RTN
2013-02-13T00:00:00Z,1113,1824,79906,711,0.008897955,0.022826822,0.013928866,2013,RTN
2014-02-11T00:00:00Z,1088,1854,76856,766,0.009966691,0.024123035,0.014156344,2014,RTN
2015-02-11T00:00:00Z,1094,1911,79704,817,0.010250427,0.023976212,0.013725785,2015,RTN
2016-02-10T00:00:00Z,991,1918,78404,927,0.011823376,0.024463038,0.012639661,2016,RTN
2017-02-15T00:00:00Z,968,1906,79256,938,0.011835066,0.024048652,0.012213586,2017,RTN
2018-02-14T00:00:00Z,1004,1954,81888,950,0.011601211,0.02386186,0.012260649,2018,RTN
2019-02-13T00:00:00Z,1026,2030,86082,1004,0.011663298,0.023582166,0.011918868,2019,RTN
2011-02-10T00:00:00Z,593,883,79862,290,0.003631264,0.011056573,0.007425309,2011,O
2012-02-13T00:00:00Z,613,1002,86266,389,0.004509308,0.011615237,0.007105928,2012,O
2013-02-14T00:00:00Z,722,1205,102409,483,0.004716382,0.011766544,0.007050162,2013,O
2014-02-14T00:00:00Z,681,1191,113120,510,0.004508487,0.010528642,0.006020156,2014,O
2015-02-18T00:00:00Z,722,1279,118844,557,0.004686816,0.010762007,0.006075191,2015,O
2016-02-11T00:00:00Z,694,1168,118183,474,0.004010729,0.009882978,0.005872249,2016,O
2017-02-23T00:00:00Z,718,1224,123477,506,0.004097929,0.009912777,0.005814848,2017,O
2018-02-22T00:00:00Z,737,1279,127864,542,0.004238879,0.010002815,0.005763937,2018,O
2019-02-22T00:00:00Z,784,1480,88134,696,0.007897066,0.016792611,0.008895545,2019,O
2011-04-29T00:00:00Z,792,1205,52994,413,0.007793335,0.022738423,0.014945088,2011,RHT
2012-04-25T00:00:00Z,854,1330,56720,476,0.008392102,0.023448519,0.015056417,2012,RHT
2013-04-25T00:00:00Z,793,1275,54482,482,0.008846959,0.023402225,0.014555266,2013,RHT
2014-04-24T00:00:00Z,816,1212,53173,396,0.007447389,0.022793523,0.015346134,2014,RHT
2015-04-28T00:00:00Z,998,1345,61246,347,0.005665676,0.021960618,0.016294942,2015,RHT
2016-04-26T00:00:00Z,1016,1333,61937,317,0.005118104,0.021521869,0.016403765,2016,RHT
2017-04-26T00:00:00Z,1013,1402,62615,389,0.006212569,0.022390801,0.016178232,2017,RHT
2018-04-26T00:00:00Z,1078,1368,61941,290,0.004681875,0.022085533,0.017403658,2018,RHT
2019-04-24T00:00:00Z,1132,1418,67476,286,0.004238544,0.021014879,0.016776335,2019,RHT
2011-03-01T00:00:00Z,1041,1209,69274,168,0.002425152,0.017452435,0.015027283,2011,REG
2012-02-29T00:00:00Z,887,1080,58100,193,0.003321859,0.01858864,0.015266781,2012,REG
2013-03-01T00:00:00Z,894,1158,59903,264,0.004407125,0.019331252,0.014924127,2013,REG
2014-02-19T00:00:00Z,854,1114,61267,260,0.00424372,0.018182708,0.013938988,2014,REG
2015-02-20T00:00:00Z,886,1262,63792,376,0.005894156,0.019783045,0.013888889,2015,REG
2016-02-18T00:00:00Z,821,1242,59644,421,0.007058547,0.020823553,0.013765006,2016,REG
2017-02-27T00:00:00Z,899,1353,66841,454,0.006792238,0.020242067,0.013449829,2017,REG
2018-02-27T00:00:00Z,850,1347,70241,497,0.00707564,0.019176834,0.012101194,2018,REG
2019-02-21T00:00:00Z,825,1305,69987,480,0.006858417,0.01864632,0.011787903,2019,REG
2011-02-17T00:00:00Z,1162,1299,65765,137,0.002083175,0.019752148,0.017668973,2011,REGN
2012-02-21T00:00:00Z,1300,1655,81078,355,0.0043785,0.020412442,0.016033943,2012,REGN
2013-02-15T00:00:00Z,1154,1454,77247,300,0.003883646,0.018822737,0.014939091,2013,REGN
2014-02-13T00:00:00Z,1191,1504,83654,313,0.003741602,0.017978818,0.014237215,2014,REGN
2015-02-12T00:00:00Z,1335,1609,89603,274,0.003057933,0.017956988,0.014899055,2015,REGN
2016-02-11T00:00:00Z,1477,1718,96281,241,0.00250309,0.017843604,0.015340514,2016,REGN
2017-02-09T00:00:00Z,1575,1772,95313,197,0.002066874,0.018591378,0.016524503,2017,REGN
2018-02-08T00:00:00Z,1548,1696,90924,148,0.001627733,0.018652941,0.017025208,2018,REGN
2019-02-07T00:00:00Z,1442,1610,84733,168,0.001982699,0.019000862,0.017018163,2019,REGN
2012-02-24T00:00:00Z,2581,2685,120841,104,0.000860635,0.02221928,0.021358645,2012,RF
2013-02-21T00:00:00Z,2462,2599,117770,137,0.001163284,0.022068438,0.020905154,2013,RF
2014-02-21T00:00:00Z,2372,2506,110209,134,0.001215872,0.022738615,0.021522743,2014,RF
2015-02-17T00:00:00Z,2342,2436,109987,94,0.000854646,0.022148072,0.021293426,2015,RF
2016-02-16T00:00:00Z,2211,2513,110385,302,0.002735879,0.022765774,0.020029895,2016,RF
2017-02-24T00:00:00Z,2263,2470,110058,207,0.001880826,0.022442712,0.020561886,2017,RF
2018-02-26T00:00:00Z,2136,2421,104249,285,0.002733839,0.023223244,0.020489405,2018,RF
2019-02-22T00:00:00Z,2250,2466,104794,216,0.002061187,0.023531882,0.021470695,2019,RF
2010-02-24T00:00:00Z,1788,2047,94196,259,0.002749586,0.021731284,0.018981698,2010,RSG
2011-02-18T00:00:00Z,1775,1954,89420,179,0.002001789,0.021851935,0.019850145,2011,RSG
2012-02-17T00:00:00Z,1639,1761,79933,122,0.001526278,0.022030951,0.020504673,2012,RSG
2013-02-15T00:00:00Z,1459,1618,73658,159,0.002158625,0.021966385,0.01980776,2013,RSG
2014-02-13T00:00:00Z,1415,1653,73186,238,0.003251988,0.022586287,0.019334299,2014,RSG
2015-02-23T00:00:00Z,1238,1562,69146,324,0.004685737,0.022589882,0.017904145,2015,RSG
2016-02-12T00:00:00Z,1221,1690,71719,469,0.006539411,0.023564188,0.017024777,2016,RSG
2017-02-17T00:00:00Z,1283,1734,73374,451,0.006146591,0.023632349,0.017485758,2017,RSG
2018-02-09T00:00:00Z,1316,1842,77032,526,0.006828331,0.02391214,0.017083809,2018,RSG
2019-02-08T00:00:00Z,1338,1747,78978,409,0.005178657,0.022120084,0.016941427,2019,RSG
2010-08-17T00:00:00Z,709,1055,43459,346,0.007961527,0.024275754,0.016314227,2010,RMD
2011-08-17T00:00:00Z,619,1013,39983,394,0.009854188,0.025335768,0.01548158,2011,RMD
2012-08-14T00:00:00Z,576,1013,40462,437,0.010800257,0.025035836,0.014235579,2012,RMD
2013-08-13T00:00:00Z,558,959,39642,401,0.010115534,0.024191514,0.01407598,2013,RMD
2014-08-08T00:00:00Z,626,1002,40298,376,0.009330488,0.024864758,0.01553427,2014,RMD
2015-08-07T00:00:00Z,645,1008,40942,363,0.008866201,0.024620194,0.015753993,2015,RMD
2016-08-05T00:00:00Z,859,1155,48466,296,0.006107374,0.023831139,0.017723765,2016,RMD
2017-08-04T00:00:00Z,882,1210,51323,328,0.006390897,0.023576174,0.017185278,2017,RMD
2018-08-17T00:00:00Z,948,1232,53034,284,0.005355055,0.023230381,0.017875325,2018,RMD
2010-02-19T00:00:00Z,508,579,28566,71,0.002485472,0.020268851,0.017783379,2010,RHI
2011-02-17T00:00:00Z,434,515,26105,81,0.003102854,0.019728021,0.016625168,2011,RHI
2012-02-17T00:00:00Z,437,558,26694,121,0.004532854,0.020903574,0.01637072,2012,RHI
2013-02-15T00:00:00Z,363,457,24972,94,0.003764216,0.018300497,0.014536281,2013,RHI
2014-02-14T00:00:00Z,375,475,25656,100,0.003897724,0.018514188,0.014616464,2014,RHI
2015-02-13T00:00:00Z,456,519,26675,63,0.002361762,0.01945642,0.017094658,2015,RHI
2016-02-17T00:00:00Z,478,578,28280,100,0.003536068,0.020438472,0.016902405,2016,RHI
2017-02-13T00:00:00Z,474,610,28718,136,0.004735706,0.021241033,0.016505328,2017,RHI
2018-02-20T00:00:00Z,463,593,29427,130,0.004417712,0.020151561,0.01573385,2018,RHI
2019-02-15T00:00:00Z,476,533,28043,57,0.002032593,0.019006526,0.016973933,2019,RHI
2009-11-18T00:00:00Z,663,991,44248,328,0.007412764,0.022396492,0.014983728,2009,ROK
2010-11-18T00:00:00Z,618,987,42513,369,0.008679698,0.023216428,0.01453673,2010,ROK
2011-11-14T00:00:00Z,588,914,40037,326,0.008142468,0.022828883,0.014686415,2011,ROK
2012-11-19T00:00:00Z,545,841,39235,296,0.007544284,0.021434943,0.013890659,2012,ROK
2013-11-18T00:00:00Z,561,892,39635,331,0.008351205,0.022505361,0.014154157,2013,ROK
2014-11-18T00:00:00Z,570,859,39173,289,0.00737753,0.021928369,0.014550839,2014,ROK
2015-11-17T00:00:00Z,605,874,39546,269,0.006802205,0.022100845,0.01529864,2015,ROK
2016-11-15T00:00:00Z,573,857,38753,284,0.007328465,0.022114417,0.014785952,2016,ROK
2017-11-15T00:00:00Z,571,887,39106,316,0.008080601,0.022681941,0.01460134,2017,ROK
2018-11-09T00:00:00Z,623,957,41380,334,0.008071532,0.023127115,0.015055582,2018,ROK
2011-02-25T00:00:00Z,464,594,30155,130,0.00431106,0.019698226,0.015387166,2011,ROL
2012-02-28T00:00:00Z,445,572,29928,127,0.004243518,0.019112537,0.014869019,2012,ROL
2013-02-27T00:00:00Z,472,560,29909,88,0.002942258,0.018723461,0.015781203,2013,ROL
2014-02-26T00:00:00Z,470,578,30332,108,0.003560596,0.019055783,0.015495187,2014,ROL
2015-02-25T00:00:00Z,482,555,29478,73,0.002476423,0.0188276,0.016351177,2015,ROL
2016-02-24T00:00:00Z,465,584,32359,119,0.003677493,0.018047529,0.014370036,2016,ROL
2017-02-24T00:00:00Z,501,605,32863,104,0.003164653,0.018409762,0.015245108,2017,ROL
2018-02-26T00:00:00Z,493,618,31961,125,0.003911017,0.019336066,0.015425049,2018,ROL
2019-03-01T00:00:00Z,493,625,32278,132,0.004089473,0.019363034,0.015273561,2019,ROL
2011-02-25T00:00:00Z,444,533,28370,89,0.003137117,0.018787452,0.015650335,2011,ROP
2012-02-24T00:00:00Z,457,585,29385,128,0.004355964,0.019908116,0.015552152,2012,ROP
2013-02-25T00:00:00Z,381,546,25556,165,0.006456409,0.021364846,0.014908436,2013,ROP
2014-02-21T00:00:00Z,438,589,28031,151,0.005386893,0.021012451,0.015625557,2014,ROP
2015-02-20T00:00:00Z,97,102,7047,5,0.000709522,0.014474244,0.013764723,2015,ROP
2016-02-26T00:00:00Z,109,130,8048,21,0.002609344,0.016153082,0.013543738,2016,ROP
2017-02-27T00:00:00Z,155,160,9533,5,0.000524494,0.016783804,0.01625931,2017,ROP
2018-02-23T00:00:00Z,470,624,30411,154,0.005063957,0.020518891,0.015454934,2018,ROP
2019-02-25T00:00:00Z,485,616,31625,131,0.004142292,0.019478261,0.015335968,2019,ROP
2010-03-30T00:00:00Z,216,485,25596,269,0.010509455,0.018948273,0.008438819,2010,ROST
2011-03-29T00:00:00Z,206,479,25531,273,0.010692883,0.018761506,0.008068622,2011,ROST
2012-03-27T00:00:00Z,227,529,26410,302,0.011435062,0.020030292,0.008595229,2012,ROST
2013-04-02T00:00:00Z,232,467,24501,235,0.009591445,0.019060447,0.009469001,2013,ROST
2014-04-01T00:00:00Z,243,454,24386,211,0.008652506,0.018617239,0.009964734,2014,ROST
2015-03-31T00:00:00Z,244,467,24409,223,0.009135974,0.019132287,0.009996313,2015,ROST
2016-03-29T00:00:00Z,387,592,28441,205,0.007207904,0.020815021,0.013607116,2016,ROST
2017-03-28T00:00:00Z,394,614,28379,220,0.007752211,0.021635717,0.013883505,2017,ROST
2018-04-03T00:00:00Z,409,663,29550,254,0.008595601,0.022436548,0.013840948,2018,ROST
2019-04-02T00:00:00Z,418,658,30274,240,0.007927595,0.021734822,0.013807227,2019,ROST
2010-02-23T00:00:00Z,764,1099,52157,335,0.006422915,0.021070997,0.014648082,2010,RCL
2011-02-24T00:00:00Z,800,1178,54215,378,0.00697224,0.021728304,0.014756064,2011,RCL
2012-02-29T00:00:00Z,872,1290,60999,418,0.006852571,0.021147888,0.014295316,2012,RCL
2013-02-25T00:00:00Z,885,1358,60670,473,0.007796275,0.022383386,0.014587111,2013,RCL
2014-02-20T00:00:00Z,828,1346,59920,518,0.00864486,0.022463284,0.013818425,2014,RCL
2015-02-23T00:00:00Z,844,1386,60694,542,0.008930043,0.022835865,0.013905823,2015,RCL
2016-02-22T00:00:00Z,868,1432,62406,564,0.009037593,0.022946512,0.013908919,2016,RCL
2017-02-23T00:00:00Z,896,1426,61731,530,0.008585638,0.023100225,0.014514587,2017,RCL
2018-02-21T00:00:00Z,922,1339,60060,417,0.006943057,0.022294372,0.015351315,2018,RCL
2019-02-22T00:00:00Z,1004,1427,66552,423,0.006355932,0.02144188,0.015085948,2019,RCL
2011-03-23T00:00:00Z,758,1017,46615,259,0.005556151,0.021817012,0.01626086,2011,CRM
2012-03-09T00:00:00Z,818,1177,51728,359,0.006940148,0.022753634,0.015813486,2012,CRM
2013-03-08T00:00:00Z,838,1134,51687,296,0.005726778,0.021939753,0.016212974,2013,CRM
2014-03-05T00:00:00Z,951,1146,56191,195,0.003470307,0.020394725,0.016924419,2014,CRM
2015-03-06T00:00:00Z,1012,1212,57805,200,0.003459908,0.020967044,0.017507136,2015,CRM
2016-03-07T00:00:00Z,1077,1273,59468,196,0.00329589,0.021406471,0.01811058,2016,CRM
2017-03-06T00:00:00Z,1099,1439,64286,340,0.005288865,0.022384345,0.01709548,2017,CRM
2018-03-09T00:00:00Z,1107,1485,64909,378,0.005823538,0.022878183,0.017054646,2018,CRM
2019-03-08T00:00:00Z,1051,1356,60820,305,0.005014798,0.022295298,0.0172805,2019,CRM
2010-03-01T00:00:00Z,831,974,58875,143,0.002428875,0.016543524,0.01411465,2010,SBAC
2011-02-25T00:00:00Z,754,864,54452,110,0.002020128,0.015867186,0.013847058,2011,SBAC
2012-02-27T00:00:00Z,712,822,51334,110,0.002142829,0.016012779,0.01386995,2012,SBAC
2013-02-27T00:00:00Z,756,919,59496,163,0.00273968,0.015446417,0.012706737,2013,SBAC
2014-02-27T00:00:00Z,740,924,59251,184,0.003105433,0.015594674,0.012489241,2014,SBAC
2015-03-02T00:00:00Z,704,943,56200,239,0.004252669,0.016779359,0.01252669,2015,SBAC
2016-02-26T00:00:00Z,683,901,53933,218,0.004042052,0.016705913,0.012663861,2016,SBAC
2017-03-01T00:00:00Z,759,1050,62446,291,0.004660026,0.016814528,0.012154501,2017,SBAC
2018-03-01T00:00:00Z,710,1049,61708,339,0.005493615,0.016999417,0.011505802,2018,SBAC
2019-02-28T00:00:00Z,710,1021,60978,311,0.0051002,0.016743744,0.011643544,2019,SBAC
2010-02-05T00:00:00Z,522,697,32433,175,0.005395739,0.021490457,0.016094718,2010,SLB
2011-02-04T00:00:00Z,578,856,36792,278,0.00755599,0.023265927,0.015709937,2011,SLB
2012-02-01T00:00:00Z,502,826,34326,324,0.009438909,0.024063392,0.014624483,2012,SLB
2013-01-31T00:00:00Z,502,761,32468,259,0.007977085,0.023438462,0.015461377,2013,SLB
2014-01-31T00:00:00Z,475,722,31348,247,0.007879291,0.023031772,0.015152482,2014,SLB
2015-01-29T00:00:00Z,498,718,31822,220,0.006913456,0.022563007,0.015649551,2015,SLB
2016-01-27T00:00:00Z,620,676,33180,56,0.001687764,0.020373719,0.018685955,2016,SLB
2017-01-25T00:00:00Z,590,705,33208,115,0.003463021,0.021229824,0.017766803,2017,SLB
2018-01-24T00:00:00Z,578,709,33340,131,0.003929214,0.021265747,0.017336533,2018,SLB
2019-01-23T00:00:00Z,559,685,31309,126,0.004024402,0.021878693,0.017854291,2019,SLB
2011-08-17T00:00:00Z,1262,1395,63211,133,0.002104064,0.022068944,0.01996488,2011,STX
2012-08-09T00:00:00Z,1183,1329,59456,146,0.002455597,0.022352664,0.019897067,2012,STX
2013-08-08T00:00:00Z,1153,1315,57979,162,0.002794115,0.022680626,0.019886511,2013,STX
2014-08-08T00:00:00Z,1190,1362,59460,172,0.002892701,0.022906155,0.020013454,2014,STX
2015-08-12T00:00:00Z,1136,1400,58258,264,0.004531566,0.024031034,0.019499468,2015,STX
2016-08-05T00:00:00Z,1155,1403,59588,248,0.004161912,0.023545009,0.019383097,2016,STX
2017-08-04T00:00:00Z,335,316,16783,-19,-0.001132098,0.018828577,0.019960674,2017,STX
2018-08-03T00:00:00Z,1378,1389,63246,11,0.000173924,0.021961863,0.021787939,2018,STX
2010-03-01T00:00:00Z,1004,1908,71465,904,0.012649549,0.026698384,0.014048835,2010,SEE
2011-02-25T00:00:00Z,930,1771,65367,841,0.012865819,0.027093182,0.014227362,2011,SEE
2012-02-29T00:00:00Z,1052,2032,78195,980,0.012532771,0.025986316,0.013453546,2012,SEE
2013-03-01T00:00:00Z,1221,2069,78214,848,0.010842049,0.026453065,0.015611016,2013,SEE
2014-02-28T00:00:00Z,1202,2131,80081,929,0.011600754,0.026610557,0.015009803,2014,SEE
2015-02-27T00:00:00Z,1226,2157,83903,931,0.011096147,0.025708258,0.014612112,2015,SEE
2016-02-22T00:00:00Z,1298,2200,84716,902,0.010647339,0.02596912,0.015321781,2016,SEE
2017-02-15T00:00:00Z,1326,2293,87565,967,0.011043225,0.026186262,0.015143037,2017,SEE
2018-02-21T00:00:00Z,1205,2093,79570,888,0.011159985,0.026303883,0.015143898,2018,SEE
2019-02-19T00:00:00Z,1094,1922,75861,828,0.010914699,0.025335812,0.014421112,2019,SEE
2012-02-28T00:00:00Z,327,301,24682,-26,-0.001053399,0.012195122,0.013248521,2012,SRE
2013-02-26T00:00:00Z,395,376,28695,-19,-0.000662136,0.013103328,0.013765464,2013,SRE
2014-02-27T00:00:00Z,447,464,31367,17,0.000541971,0.014792616,0.014250646,2014,SRE
2015-02-26T00:00:00Z,520,543,33381,23,0.000689015,0.016266739,0.015577724,2015,SRE
2016-02-26T00:00:00Z,658,688,39259,30,0.000764156,0.017524644,0.016760488,2016,SRE
2017-02-28T00:00:00Z,715,770,41501,55,0.001325269,0.01855377,0.017228501,2017,SRE
2018-02-27T00:00:00Z,2655,3330,175616,675,0.003843613,0.018961826,0.015118212,2018,SRE
2019-02-26T00:00:00Z,2510,3084,178288,574,0.00321951,0.017297855,0.014078345,2019,SRE
2010-02-24T00:00:00Z,237,179,14030,-58,-0.004133999,0.012758375,0.016892373,2010,SHW
2011-02-23T00:00:00Z,251,191,15109,-60,-0.003971143,0.012641472,0.016612615,2011,SHW
2012-02-23T00:00:00Z,247,202,15406,-45,-0.00292094,0.013111775,0.016032715,2012,SHW
2013-02-28T00:00:00Z,282,239,16897,-43,-0.00254483,0.014144523,0.016689353,2013,SHW
2014-02-27T00:00:00Z,297,246,17647,-51,-0.00289001,0.013940046,0.016830056,2014,SHW
2015-02-25T00:00:00Z,267,226,15972,-41,-0.002566992,0.014149762,0.016716754,2015,SHW
2016-02-24T00:00:00Z,279,234,16100,-45,-0.002795031,0.014534161,0.017329193,2016,SHW
2017-02-22T00:00:00Z,312,260,17996,-52,-0.002889531,0.014447655,0.017337186,2017,SHW
2018-02-23T00:00:00Z,321,261,17641,-60,-0.003401168,0.01479508,0.018196247,2018,SHW
2019-02-22T00:00:00Z,315,264,17798,-51,-0.002865491,0.014833127,0.017698618,2019,SHW
2010-02-25T00:00:00Z,721,1134,64903,413,0.006363342,0.017472228,0.011108886,2010,SPG
2011-02-25T00:00:00Z,267,370,31427,103,0.003277437,0.011773316,0.008495879,2011,SPG
2012-02-28T00:00:00Z,277,391,31632,114,0.003603945,0.0123609,0.008756955,2012,SPG
2013-02-28T00:00:00Z,267,364,29792,97,0.003255908,0.012218045,0.008962137,2013,SPG
2014-02-27T00:00:00Z,682,1151,63063,469,0.007437007,0.01825159,0.010814582,2014,SPG
2015-02-27T00:00:00Z,766,1131,61893,365,0.005897274,0.018273472,0.012376198,2015,SPG
2016-02-26T00:00:00Z,858,1212,65338,354,0.00541798,0.018549695,0.013131715,2016,SPG
2017-02-24T00:00:00Z,967,1481,75749,514,0.006785568,0.019551413,0.012765845,2017,SPG
2018-02-23T00:00:00Z,1005,1461,76262,456,0.005979387,0.019157641,0.013178254,2018,SPG
2019-02-22T00:00:00Z,1040,1460,74298,420,0.005652911,0.019650596,0.013997685,2019,SPG
2014-11-25T00:00:00Z,603,960,38466,357,0.009280923,0.024957105,0.015676182,2014,SWKS
2015-11-24T00:00:00Z,616,970,38589,354,0.009173599,0.025136697,0.015963098,2015,SWKS
2016-11-22T00:00:00Z,566,882,36266,316,0.008713395,0.0243203,0.015606905,2016,SWKS
2017-11-13T00:00:00Z,575,908,36436,333,0.009139313,0.024920408,0.015781096,2017,SWKS
2018-11-15T00:00:00Z,603,956,37816,353,0.009334673,0.025280305,0.015945631,2018,SWKS
2011-02-28T00:00:00Z,1150,1628,80079,478,0.005969106,0.020329924,0.014360819,2011,SLG
2012-02-28T00:00:00Z,1148,1607,82577,459,0.005558448,0.019460625,0.013902176,2012,SLG
2013-02-27T00:00:00Z,1125,1500,79597,375,0.004711233,0.018844931,0.014133699,2013,SLG
2014-02-25T00:00:00Z,1189,1551,80685,362,0.004486584,0.019222904,0.01473632,2014,SLG
2015-02-24T00:00:00Z,1249,1662,86324,413,0.004784301,0.019253047,0.014468746,2015,SLG
2016-02-29T00:00:00Z,1280,1687,89598,407,0.004542512,0.018828545,0.014286033,2016,SLG
2017-02-21T00:00:00Z,1335,1684,90571,349,0.003853331,0.018593148,0.014739817,2017,SLG
2018-02-23T00:00:00Z,1179,1617,86565,438,0.005059782,0.018679605,0.013619823,2018,SLG
2019-02-27T00:00:00Z,1160,1560,82402,400,0.004854251,0.018931579,0.014077328,2019,SLG
2010-02-18T00:00:00Z,848,1193,59415,345,0.005806614,0.020079105,0.01427249,2010,SNA
2011-02-17T00:00:00Z,902,1230,62895,328,0.005215041,0.019556404,0.014341363,2011,SNA
2012-02-16T00:00:00Z,844,1321,59950,477,0.007956631,0.022035029,0.014078399,2012,SNA
2013-02-14T00:00:00Z,812,1331,59530,519,0.008718293,0.022358475,0.013640181,2013,SNA
2014-02-14T00:00:00Z,848,1286,59909,438,0.007311088,0.02146589,0.014154801,2014,SNA
2015-02-12T00:00:00Z,812,1225,57348,413,0.007201646,0.021360815,0.014159169,2015,SNA
2016-02-11T00:00:00Z,817,1242,56785,425,0.007484371,0.021871973,0.014387602,2016,SNA
2017-02-09T00:00:00Z,857,1325,61302,468,0.007634335,0.021614303,0.013979968,2017,SNA
2018-02-15T00:00:00Z,893,1346,63485,453,0.007135544,0.021201859,0.014066315,2018,SNA
2019-02-14T00:00:00Z,897,1427,65435,530,0.008099641,0.021807901,0.01370826,2019,SNA
2010-02-25T00:00:00Z,3521,5907,293681,2386,0.008124462,0.020113661,0.011989199,2010,SO
2011-02-25T00:00:00Z,3652,6710,317998,3058,0.009616413,0.021100762,0.011484349,2011,SO
2012-02-24T00:00:00Z,3526,6402,319907,2876,0.008990113,0.020012066,0.011021953,2012,SO
2013-02-28T00:00:00Z,3248,6470,313167,3222,0.01028844,0.020659904,0.010371463,2013,SO
2014-02-27T00:00:00Z,3191,6423,312721,3232,0.010335091,0.020539075,0.010203984,2014,SO
2015-03-02T00:00:00Z,3202,6354,322132,3152,0.009784809,0.019724833,0.009940025,2015,SO
2016-02-26T00:00:00Z,3394,6695,338296,3301,0.009757727,0.019790361,0.010032634,2016,SO
2017-02-22T00:00:00Z,4228,8679,426297,4451,0.010441077,0.020359045,0.009917968,2017,SO
2018-02-21T00:00:00Z,4230,8729,410852,4499,0.010950415,0.021246093,0.010295678,2018,SO
2019-02-20T00:00:00Z,2918,5663,299637,2745,0.009161085,0.018899535,0.00973845,2019,SO
2011-02-08T00:00:00Z,1024,1503,65836,479,0.007275655,0.022829455,0.0155538,2011,LUV
2012-02-09T00:00:00Z,1073,1616,75494,543,0.007192625,0.021405675,0.01421305,2012,LUV
2013-02-07T00:00:00Z,1060,1593,77730,533,0.006857069,0.020494018,0.013636948,2013,LUV
2014-02-04T00:00:00Z,1068,1588,77394,520,0.006718867,0.020518386,0.013799519,2014,LUV
2015-02-06T00:00:00Z,1058,1533,73482,475,0.006464168,0.020862252,0.014398084,2015,LUV
2016-02-03T00:00:00Z,1028,1367,68441,339,0.004953171,0.019973408,0.015020236,2016,LUV
2017-02-07T00:00:00Z,981,1359,68839,378,0.005491073,0.019741716,0.014250643,2017,LUV
2018-02-07T00:00:00Z,1026,1458,68868,432,0.00627287,0.021170936,0.014898066,2018,LUV
2019-02-05T00:00:00Z,1069,1636,70242,567,0.008072094,0.023290909,0.015218815,2019,LUV
2011-02-23T00:00:00Z,111,191,9968,80,0.008025682,0.019161316,0.011135634,2011,SPGI
2012-02-07T00:00:00Z,591,1068,47304,477,0.010083714,0.022577372,0.012493658,2012,SPGI
2013-02-28T00:00:00Z,605,1102,49881,497,0.009963714,0.02209258,0.012128867,2013,SPGI
2014-02-07T00:00:00Z,577,1077,49542,500,0.010092447,0.02173913,0.011646684,2014,SPGI
2015-02-13T00:00:00Z,797,1176,55840,379,0.006787249,0.021060172,0.014272923,2015,SPGI
2016-02-12T00:00:00Z,894,1246,58877,352,0.005978565,0.021162763,0.015184198,2016,SPGI
2017-02-09T00:00:00Z,879,1399,58593,520,0.00887478,0.023876572,0.015001792,2017,SPGI
2018-02-09T00:00:00Z,798,1359,56948,561,0.009851092,0.023863876,0.014012784,2018,SPGI
2019-02-13T00:00:00Z,848,1404,60460,556,0.009196163,0.023221965,0.014025802,2019,SPGI
2010-02-22T00:00:00Z,934,1513,58483,579,0.009900313,0.025870766,0.015970453,2010,SWK
2011-02-18T00:00:00Z,1133,1826,74944,693,0.009246904,0.024364859,0.015117955,2011,SWK
2012-02-23T00:00:00Z,1066,1568,70143,502,0.007156808,0.022354333,0.015197525,2012,SWK
2013-02-20T00:00:00Z,1045,1491,68601,446,0.006501363,0.021734377,0.015233014,2013,SWK
2014-02-21T00:00:00Z,1056,1555,68541,499,0.007280314,0.022687151,0.015406837,2014,SWK
2015-02-19T00:00:00Z,1096,1603,68480,507,0.007403621,0.023408294,0.016004673,2015,SWK
2016-02-19T00:00:00Z,1064,1618,65180,554,0.00849954,0.024823566,0.016324026,2016,SWK
2017-02-15T00:00:00Z,1032,1610,64705,578,0.008932849,0.024882157,0.015949308,2017,SWK
2018-02-27T00:00:00Z,1046,1697,69699,651,0.009340163,0.024347552,0.015007389,2018,SWK
2019-02-26T00:00:00Z,1046,1684,70498,638,0.009049902,0.023887202,0.0148373,2019,SWK
2009-11-20T00:00:00Z,554,904,41238,350,0.008487318,0.021921529,0.013434211,2009,SBUX
2010-11-22T00:00:00Z,532,961,39246,429,0.01093105,0.024486572,0.013555522,2010,SBUX
2011-11-18T00:00:00Z,555,1044,42735,489,0.011442611,0.024429624,0.012987013,2011,SBUX
2012-11-16T00:00:00Z,579,1022,44183,443,0.010026481,0.023131069,0.013104588,2012,SBUX
2013-11-18T00:00:00Z,534,1030,44159,496,0.011232138,0.023324804,0.012092665,2013,SBUX
2014-11-14T00:00:00Z,587,1124,46161,537,0.011633197,0.024349559,0.012716362,2014,SBUX
2015-11-12T00:00:00Z,666,1250,51481,584,0.011343991,0.024280803,0.012936812,2015,SBUX
2016-11-18T00:00:00Z,656,1171,48659,515,0.010583859,0.024065435,0.013481576,2016,SBUX
2017-11-17T00:00:00Z,736,1187,50036,451,0.00901351,0.023722919,0.014709409,2017,SBUX
2018-11-16T00:00:00Z,778,1229,54022,451,0.008348451,0.022749991,0.01440154,2018,SBUX
2012-02-27T00:00:00Z,2063,2236,102386,173,0.001689684,0.021838923,0.020149239,2012,STT
2013-02-22T00:00:00Z,2077,2340,105944,263,0.002482444,0.02208714,0.019604697,2013,STT
2014-02-21T00:00:00Z,2883,2863,127919,-20,-0.000156349,0.022381351,0.0225377,2014,STT
2015-02-20T00:00:00Z,2890,2636,123680,-254,-0.002053687,0.021313066,0.023366753,2015,STT
2016-02-19T00:00:00Z,2995,2558,123259,-437,-0.00354538,0.020753048,0.024298429,2016,STT
2017-02-17T00:00:00Z,3052,2666,125234,-386,-0.00308223,0.021288149,0.024370379,2017,STT
2018-02-26T00:00:00Z,3053,2679,122195,-374,-0.003060682,0.021923974,0.024984656,2018,STT
2019-02-21T00:00:00Z,3125,2670,124964,-455,-0.003641049,0.021366153,0.025007202,2019,STT
2011-02-18T00:00:00Z,544,922,38105,378,0.009919958,0.0241963,0.014276342,2011,SYK
2012-02-13T00:00:00Z,413,720,29192,307,0.01051658,0.024664292,0.014147712,2012,SYK
2013-02-27T00:00:00Z,453,726,29954,273,0.009113975,0.024237164,0.015123189,2013,SYK
2014-02-13T00:00:00Z,457,768,31971,311,0.009727566,0.02402177,0.014294204,2014,SYK
2015-02-12T00:00:00Z,442,731,30248,289,0.009554351,0.024166887,0.014612536,2015,SYK
2016-02-11T00:00:00Z,437,677,29349,240,0.008177451,0.023067225,0.014889775,2016,SYK
2017-02-09T00:00:00Z,398,632,28476,234,0.008217446,0.022194128,0.013976682,2017,SYK
2018-02-08T00:00:00Z,389,660,28506,271,0.009506771,0.02315302,0.01364625,2018,SYK
2019-02-07T00:00:00Z,402,692,31296,290,0.00926636,0.022111452,0.012845092,2019,SYK
2010-02-23T00:00:00Z,2699,3118,124125,419,0.003375629,0.025119839,0.021744209,2010,STI
2011-02-25T00:00:00Z,2801,3311,136849,510,0.003726735,0.02419455,0.020467815,2011,STI
2012-02-24T00:00:00Z,3085,3260,139874,175,0.001251126,0.02330669,0.022055564,2012,STI
2013-02-27T00:00:00Z,2908,3218,138348,310,0.002240726,0.023260184,0.021019458,2013,STI
2014-02-24T00:00:00Z,2887,3127,136573,240,0.001757302,0.02289618,0.021138878,2014,STI
2015-02-24T00:00:00Z,2577,2748,122086,171,0.001400652,0.022508723,0.021108071,2015,STI
2016-02-23T00:00:00Z,2392,2493,113153,101,0.000892597,0.022032116,0.021139519,2016,STI
2017-02-24T00:00:00Z,2421,2539,115107,118,0.001025133,0.022057738,0.021032604,2017,STI
2018-02-23T00:00:00Z,2289,2551,113608,262,0.002306176,0.022454405,0.020148229,2018,STI
2019-02-22T00:00:00Z,2360,2665,124894,305,0.002442071,0.021338095,0.018896024,2019,STI
2010-03-01T00:00:00Z,1748,2009,92432,261,0.002823697,0.021734897,0.0189112,2010,SIVB
2011-02-25T00:00:00Z,1674,2045,91226,371,0.004066823,0.022416855,0.018350032,2011,SIVB
2012-02-28T00:00:00Z,1587,2009,86134,422,0.004899343,0.023324123,0.01842478,2012,SIVB
2013-02-27T00:00:00Z,1500,1977,84100,477,0.005671819,0.023507729,0.01783591,2013,SIVB
2014-02-27T00:00:00Z,1563,2068,86837,505,0.005815493,0.023814733,0.01799924,2014,SIVB
2015-02-26T00:00:00Z,1679,2105,89669,426,0.004750806,0.023475226,0.01872442,2015,SIVB
2016-02-26T00:00:00Z,1827,2255,95474,428,0.004482896,0.023618996,0.0191361,2016,SIVB
2017-02-28T00:00:00Z,1842,2225,95650,383,0.004004182,0.023261892,0.01925771,2017,SIVB
2018-02-28T00:00:00Z,1877,2234,97679,357,0.003654829,0.022870832,0.019216003,2018,SIVB
2019-02-28T00:00:00Z,1900,2266,100423,366,0.003644583,0.022564552,0.018919969,2019,SIVB
2014-05-16T00:00:00Z,229,305,14088,76,0.005394662,0.021649631,0.016254969,2014,SYMC
2015-05-22T00:00:00Z,872,1101,45536,229,0.005028988,0.024178672,0.019149684,2015,SYMC
2016-05-20T00:00:00Z,879,1030,45006,151,0.003355108,0.022885837,0.019530729,2016,SYMC
2017-05-19T00:00:00Z,1003,1154,47922,151,0.003150954,0.024080798,0.020929844,2017,SYMC
2018-10-26T00:00:00Z,1249,2159,89140,910,0.010208661,0.024220328,0.014011667,2018,SYMC
2019-05-24T00:00:00Z,1051,1267,49133,216,0.004396231,0.025787149,0.021390919,2019,SYMC
2015-02-23T00:00:00Z,2018,2356,104975,338,0.003219814,0.022443439,0.019223625,2015,SYF
2016-02-25T00:00:00Z,1857,1926,88822,69,0.000776835,0.021683817,0.020906983,2016,SYF
2017-02-23T00:00:00Z,1802,1893,85178,91,0.001068351,0.022224048,0.021155697,2017,SYF
2018-02-22T00:00:00Z,1783,1955,85716,172,0.002006627,0.022807877,0.020801251,2018,SYF
2019-02-15T00:00:00Z,1793,1934,82909,141,0.00170066,0.02332678,0.02162612,2019,SYF
2010-12-17T00:00:00Z,570,864,41519,294,0.007081095,0.02080975,0.013728654,2010,SNPS
2011-12-16T00:00:00Z,643,933,44779,290,0.00647625,0.02083566,0.01435941,2011,SNPS
2012-12-20T00:00:00Z,665,913,45791,248,0.005415911,0.019938416,0.014522504,2012,SNPS
2013-12-20T00:00:00Z,653,865,43286,212,0.004897657,0.019983366,0.015085709,2013,SNPS
2014-12-15T00:00:00Z,712,932,45767,220,0.004806957,0.020364018,0.015557061,2014,SNPS
2015-12-14T00:00:00Z,768,956,45516,188,0.004130416,0.021003603,0.016873187,2015,SNPS
2016-12-12T00:00:00Z,780,986,47142,206,0.004369776,0.020915532,0.016545755,2016,SNPS
2017-12-14T00:00:00Z,806,1018,48406,212,0.004379622,0.021030451,0.016650828,2017,SNPS
2018-12-17T00:00:00Z,747,1014,48080,267,0.005553245,0.02108985,0.015536606,2018,SNPS
2010-08-31T00:00:00Z,757,1142,55548,385,0.006930943,0.020558796,0.013627853,2010,SYY
2011-08-30T00:00:00Z,793,1222,57826,429,0.007418808,0.021132363,0.013713554,2011,SYY
2012-08-28T00:00:00Z,818,1244,56751,426,0.007506476,0.021920319,0.014413843,2012,SYY
2013-08-27T00:00:00Z,882,1362,59847,480,0.008020452,0.022758033,0.014737581,2013,SYY
2014-08-26T00:00:00Z,952,1453,64955,501,0.007713032,0.022369333,0.014656301,2014,SYY
2015-08-25T00:00:00Z,804,1273,57143,469,0.008207479,0.022277444,0.014069965,2015,SYY
2016-08-30T00:00:00Z,867,1438,61949,571,0.009217259,0.023212643,0.013995383,2016,SYY
2017-08-30T00:00:00Z,918,1492,63613,574,0.009023313,0.023454325,0.014431013,2017,SYY
2018-08-27T00:00:00Z,963,1489,63987,526,0.00822042,0.023270352,0.015049932,2018,SYY
2010-02-05T00:00:00Z,408,609,26009,201,0.007728094,0.023414972,0.015686878,2010,TROW
2011-02-08T00:00:00Z,393,603,26364,210,0.007965407,0.022872098,0.014906691,2011,TROW
2012-02-03T00:00:00Z,430,626,27257,196,0.007190813,0.022966577,0.015775764,2012,TROW
2013-02-05T00:00:00Z,395,668,28263,273,0.009659272,0.023635141,0.01397587,2013,TROW
2014-02-04T00:00:00Z,410,720,30383,310,0.010203074,0.023697462,0.013494388,2014,TROW
2015-02-05T00:00:00Z,396,707,30269,311,0.010274538,0.02335723,0.013082692,2015,TROW
2016-02-05T00:00:00Z,418,722,31896,304,0.009530976,0.022636067,0.013105092,2016,TROW
2017-02-07T00:00:00Z,465,899,38004,434,0.011419851,0.023655405,0.012235554,2017,TROW
2018-02-16T00:00:00Z,546,971,41234,425,0.010307028,0.023548528,0.0132415,2018,TROW
2019-02-13T00:00:00Z,607,1034,43035,427,0.009922156,0.024026955,0.014104798,2019,TROW
2011-05-25T00:00:00Z,902,996,51349,94,0.00183061,0.019396678,0.017566067,2011,TTWO
2012-05-23T00:00:00Z,950,1112,53697,162,0.003016928,0.020708792,0.017691864,2012,TTWO
2013-05-14T00:00:00Z,974,1123,53538,149,0.00278307,0.020975756,0.018192686,2013,TTWO
2014-05-14T00:00:00Z,1051,1176,55957,125,0.002233858,0.021016137,0.018782279,2014,TTWO
2015-05-22T00:00:00Z,1052,1197,55838,145,0.002596798,0.021437014,0.018840216,2015,TTWO
2016-05-19T00:00:00Z,1024,1266,56335,242,0.004295731,0.022472708,0.018176977,2016,TTWO
2017-05-24T00:00:00Z,1013,1352,58416,339,0.005803205,0.023144344,0.017341139,2017,TTWO
2018-05-17T00:00:00Z,1000,1282,54996,282,0.005127646,0.023310786,0.018183141,2018,TTWO
2019-05-14T00:00:00Z,995,1354,58386,359,0.006148734,0.023190491,0.017041757,2019,TTWO
2009-08-19T00:00:00Z,383,738,35259,355,0.010068351,0.020930826,0.010862475,2009,TPR
2010-08-25T00:00:00Z,361,675,33873,314,0.00926992,0.019927376,0.010657456,2010,TPR
2011-08-19T00:00:00Z,351,694,34822,343,0.009850095,0.019929929,0.010079835,2011,TPR
2012-08-22T00:00:00Z,388,726,38309,338,0.008822992,0.01895116,0.010128168,2012,TPR
2013-08-22T00:00:00Z,488,956,43091,468,0.010860737,0.022185607,0.011324871,2013,TPR
2014-08-15T00:00:00Z,616,979,46150,363,0.007865655,0.021213434,0.013347779,2014,TPR
2015-08-14T00:00:00Z,713,1081,51534,368,0.007140917,0.020976443,0.013835526,2015,TPR
2016-08-19T00:00:00Z,694,1152,54445,458,0.008412159,0.021158968,0.012746809,2016,TPR
2017-08-18T00:00:00Z,731,1122,54326,391,0.00719729,0.020653094,0.013455804,2017,TPR
2018-08-16T00:00:00Z,896,1072,54762,176,0.003213907,0.019575618,0.016361711,2018,TPR
2011-03-11T00:00:00Z,581,700,34427,119,0.003456589,0.020332878,0.016876289,2011,TGT
2012-03-15T00:00:00Z,567,689,33732,122,0.003616744,0.020425709,0.016808965,2012,TGT
2013-03-20T00:00:00Z,552,731,34357,179,0.005210001,0.021276596,0.016066595,2013,TGT
2014-03-14T00:00:00Z,639,729,33886,90,0.002655964,0.021513309,0.018857345,2014,TGT
2015-03-13T00:00:00Z,667,787,34599,120,0.003468308,0.022746322,0.019278014,2015,TGT
2016-03-11T00:00:00Z,546,745,33788,199,0.005889665,0.022049248,0.016159583,2016,TGT
2017-03-08T00:00:00Z,523,661,30103,138,0.004584261,0.021957944,0.017373684,2017,TGT
2018-03-14T00:00:00Z,491,672,30838,181,0.005869382,0.021791296,0.015921915,2018,TGT
2019-03-13T00:00:00Z,447,606,28844,159,0.005512412,0.021009569,0.015497157,2019,TGT
2009-11-18T00:00:00Z,1238,1714,79037,476,0.006022496,0.021686046,0.01566355,2009,TEL
2010-11-10T00:00:00Z,1232,1684,75247,452,0.006006884,0.02237963,0.016372746,2010,TEL
2011-11-18T00:00:00Z,1182,1835,78098,653,0.00836129,0.02349612,0.015134831,2011,TEL
2012-11-13T00:00:00Z,1054,1611,70712,557,0.007877022,0.022782555,0.014905532,2012,TEL
2013-11-15T00:00:00Z,1050,1555,68804,505,0.00733969,0.02260043,0.015260741,2013,TEL
2014-11-12T00:00:00Z,1046,1465,65501,419,0.006396849,0.022366071,0.015969222,2014,TEL
2015-11-10T00:00:00Z,909,1282,56567,373,0.006593951,0.02266339,0.01606944,2015,TEL
2016-11-15T00:00:00Z,850,1173,52014,323,0.006209867,0.022551621,0.016341754,2016,TEL
2017-11-14T00:00:00Z,796,1119,50015,323,0.006458063,0.022373288,0.015915225,2017,TEL
2018-11-13T00:00:00Z,842,1108,50406,266,0.00527715,0.02198151,0.016704361,2018,TEL
2017-01-13T00:00:00Z,236,259,15894,23,0.001447087,0.016295457,0.01484837,2017,FTI
2018-04-02T00:00:00Z,1036,1679,63364,643,0.010147718,0.026497696,0.016349978,2018,FTI
2019-03-11T00:00:00Z,1176,1875,70952,699,0.009851731,0.026426316,0.016574586,2019,FTI
2010-02-25T00:00:00Z,812,1265,53760,453,0.008426339,0.023530506,0.015104167,2010,TFX
2011-02-25T00:00:00Z,1063,1374,58965,311,0.005274315,0.023301959,0.018027644,2011,TFX
2012-02-24T00:00:00Z,1002,1274,55963,272,0.004860354,0.022765041,0.017904687,2012,TFX
2013-02-22T00:00:00Z,1176,1442,63928,266,0.004160931,0.022556626,0.018395695,2013,TFX
2014-02-24T00:00:00Z,1289,1530,65489,241,0.003680007,0.023362702,0.019682695,2014,TFX
2015-02-20T00:00:00Z,1201,1548,64992,347,0.005339119,0.023818316,0.018479197,2015,TFX
2016-02-25T00:00:00Z,1134,1560,64856,426,0.006568398,0.024053287,0.01748489,2016,TFX
2017-02-23T00:00:00Z,1185,1671,68300,486,0.007115666,0.024465593,0.017349927,2017,TFX
2018-02-22T00:00:00Z,1142,1773,70658,631,0.008930341,0.0250927,0.01616236,2018,TFX
2019-02-21T00:00:00Z,1121,1677,66374,556,0.008376774,0.025265917,0.016889143,2019,TFX
2010-02-23T00:00:00Z,141,213,12018,72,0.005991013,0.017723415,0.011732401,2010,TXN
2011-02-25T00:00:00Z,138,212,11979,74,0.006177477,0.017697638,0.01152016,2011,TXN
2012-02-24T00:00:00Z,150,228,12074,78,0.006460162,0.018883551,0.012423389,2012,TXN
2013-02-22T00:00:00Z,153,227,12605,74,0.005870686,0.018008727,0.01213804,2013,TXN
2014-02-24T00:00:00Z,170,227,12313,57,0.004629254,0.0184358,0.013806546,2014,TXN
2015-02-24T00:00:00Z,444,877,33936,433,0.012759312,0.025842763,0.013083451,2015,TXN
2016-02-24T00:00:00Z,437,794,32251,357,0.011069424,0.024619392,0.013549967,2016,TXN
2017-02-23T00:00:00Z,442,811,31992,369,0.011534134,0.025350088,0.013815954,2017,TXN
2018-02-22T00:00:00Z,431,782,31728,351,0.011062784,0.024646999,0.013584216,2018,TXN
2019-02-22T00:00:00Z,439,796,31087,357,0.0114839,0.025605559,0.014121659,2019,TXN
2010-02-25T00:00:00Z,951,1312,62985,361,0.005731523,0.020830356,0.015098833,2010,TXT
2011-03-01T00:00:00Z,882,1127,56066,245,0.00436985,0.020101309,0.015731459,2011,TXT
2012-02-23T00:00:00Z,878,1123,56043,245,0.004371643,0.020038185,0.015666542,2012,TXT
2013-02-15T00:00:00Z,793,1053,51617,260,0.0050371,0.020400256,0.015363156,2013,TXT
2014-02-14T00:00:00Z,759,997,47571,238,0.005003048,0.020958147,0.015955099,2014,TXT
2015-02-25T00:00:00Z,678,929,45239,251,0.00554831,0.020535379,0.014987069,2015,TXT
2016-02-24T00:00:00Z,656,888,42728,232,0.005429695,0.020782625,0.01535293,2016,TXT
2017-02-22T00:00:00Z,653,900,43296,247,0.005704915,0.02078714,0.015082225,2017,TXT
2018-02-15T00:00:00Z,659,886,43796,227,0.005183122,0.020230158,0.015047036,2018,TXT
2019-02-14T00:00:00Z,653,964,46462,311,0.006693642,0.020748138,0.014054496,2019,TXT
2012-02-29T00:00:00Z,766,1310,55956,544,0.009721924,0.023411252,0.013689327,2012,TMO
2013-02-27T00:00:00Z,802,1337,56728,535,0.009430969,0.023568608,0.014137639,2013,TMO
2014-02-27T00:00:00Z,876,1339,59184,463,0.00782306,0.022624358,0.014801298,2014,TMO
2015-02-26T00:00:00Z,855,1365,58706,510,0.008687357,0.023251456,0.014564099,2015,TMO
2016-02-25T00:00:00Z,769,1243,53975,474,0.008781843,0.02302918,0.014247337,2016,TMO
2017-02-28T00:00:00Z,747,1293,56101,546,0.009732447,0.023047718,0.013315271,2017,TMO
2018-02-28T00:00:00Z,768,1341,56117,573,0.01021081,0.023896502,0.013685692,2018,TMO
2019-02-27T00:00:00Z,735,1321,55273,586,0.010601921,0.023899553,0.013297632,2019,TMO
2011-03-28T00:00:00Z,548,1002,42475,454,0.01068864,0.023590347,0.012901707,2011,TIF
2012-03-28T00:00:00Z,574,990,42936,416,0.009688839,0.023057574,0.013368735,2012,TIF
2013-03-28T00:00:00Z,563,1001,42448,438,0.010318507,0.023581794,0.013263287,2013,TIF
2014-04-01T00:00:00Z,610,1064,44497,454,0.010202935,0.023911724,0.013708789,2014,TIF
2015-03-20T00:00:00Z,677,1176,47917,499,0.010413841,0.024542438,0.014128597,2015,TIF
2016-03-28T00:00:00Z,734,1250,53309,516,0.009679416,0.023448198,0.013768782,2016,TIF
2017-03-17T00:00:00Z,792,1410,56664,618,0.010906396,0.024883524,0.013977128,2017,TIF
2018-03-16T00:00:00Z,764,1425,57265,661,0.011542827,0.02488431,0.013341483,2018,TIF
2019-03-22T00:00:00Z,694,1337,54396,643,0.011820722,0.024579013,0.012758291,2019,TIF
2014-03-06T00:00:00Z,1037,1448,65323,411,0.006291811,0.022166771,0.01587496,2014,TWTR
2015-03-02T00:00:00Z,1034,1335,62092,301,0.004847645,0.021500354,0.016652709,2015,TWTR
2016-02-29T00:00:00Z,970,1338,59849,368,0.006148808,0.022356263,0.016207455,2016,TWTR
2017-02-27T00:00:00Z,1011,1402,61171,391,0.006391918,0.022919357,0.016527439,2017,TWTR
2018-02-23T00:00:00Z,1084,1409,63206,325,0.005141917,0.022292187,0.017150271,2018,TWTR
2019-02-21T00:00:00Z,1109,1474,67518,365,0.005405966,0.021831215,0.01642525,2019,TWTR
2010-03-30T00:00:00Z,673,872,41488,199,0.004796568,0.021018126,0.016221558,2010,TJX
2011-03-30T00:00:00Z,660,897,41375,237,0.005728097,0.021679758,0.015951662,2011,TJX
2012-03-27T00:00:00Z,639,893,41648,254,0.006098732,0.021441606,0.015342874,2012,TJX
2013-04-02T00:00:00Z,587,898,40227,311,0.007731126,0.022323315,0.014592189,2013,TJX
2014-04-01T00:00:00Z,621,923,41352,302,0.007303153,0.022320565,0.015017411,2014,TJX
2015-03-31T00:00:00Z,640,925,41440,285,0.006877413,0.022321429,0.015444015,2015,TJX
2016-03-29T00:00:00Z,634,994,42475,360,0.008475574,0.023402001,0.014926427,2016,TJX
2017-03-28T00:00:00Z,650,1039,43576,389,0.008926932,0.0238434,0.014916468,2017,TJX
2018-04-04T00:00:00Z,691,1109,45987,418,0.009089525,0.024115511,0.015025986,2018,TJX
2019-04-03T00:00:00Z,624,1032,42148,408,0.009680175,0.024485148,0.014804973,2019,TJX
2011-02-28T00:00:00Z,1118,1422,60547,304,0.005020893,0.023485887,0.018464994,2011,TMK
2012-02-28T00:00:00Z,1124,1432,58034,308,0.005307234,0.02467519,0.019367957,2012,TMK
2013-02-28T00:00:00Z,1057,1391,58642,334,0.005695577,0.023720201,0.018024624,2013,TMK
2014-02-28T00:00:00Z,987,1406,58881,419,0.007116048,0.023878671,0.016762623,2014,TMK
2015-02-27T00:00:00Z,977,1435,59571,458,0.007688305,0.024088902,0.016400598,2015,TMK
2016-02-26T00:00:00Z,967,1319,54475,352,0.00646168,0.024212942,0.017751262,2016,TMK
2017-02-27T00:00:00Z,972,1356,55645,384,0.00690089,0.024368766,0.017467877,2017,TMK
2018-02-27T00:00:00Z,939,1332,54515,393,0.007209025,0.024433642,0.017224617,2018,TMK
2019-03-01T00:00:00Z,977,1268,53126,291,0.005477544,0.023867786,0.018390242,2019,TMK
2016-02-25T00:00:00Z,328,264,15378,-64,-0.00416179,0.017167382,0.021329172,2016,TSS
2017-02-24T00:00:00Z,334,258,15812,-76,-0.004806476,0.016316721,0.021123198,2017,TSS
2018-02-23T00:00:00Z,385,281,16685,-104,-0.006233144,0.016841474,0.023074618,2018,TSS
2019-02-21T00:00:00Z,399,283,16598,-116,-0.006988794,0.017050247,0.024039041,2019,TSS
2010-02-24T00:00:00Z,348,721,31725,373,0.011757289,0.022726556,0.010969267,2010,TSCO
2011-02-23T00:00:00Z,399,679,33673,280,0.008315267,0.020164524,0.011849256,2011,TSCO
2012-02-29T00:00:00Z,374,689,31672,315,0.009945693,0.021754231,0.011808538,2012,TSCO
2013-02-20T00:00:00Z,418,753,33266,335,0.010070342,0.022635724,0.012565382,2013,TSCO
2014-02-19T00:00:00Z,460,735,33175,275,0.008289375,0.022155237,0.013865863,2014,TSCO
2015-02-18T00:00:00Z,443,752,33636,309,0.009186586,0.022356998,0.013170413,2015,TSCO
2016-02-23T00:00:00Z,473,788,35599,315,0.008848563,0.022135453,0.01328689,2016,TSCO
2017-02-23T00:00:00Z,547,1015,41865,468,0.011178789,0.024244596,0.013065807,2017,TSCO
2018-02-22T00:00:00Z,625,1014,43531,389,0.00893616,0.023293745,0.014357584,2018,TSCO
2019-02-21T00:00:00Z,646,1028,43179,382,0.008846893,0.02380787,0.014960976,2019,TSCO
2011-11-18T00:00:00Z,662,891,48619,229,0.004710093,0.018326169,0.013616076,2011,TDG
2012-11-16T00:00:00Z,693,950,52827,257,0.004864936,0.017983228,0.013118292,2012,TDG
2013-11-15T00:00:00Z,696,929,56980,233,0.004089154,0.016303966,0.012214812,2013,TDG
2014-11-14T00:00:00Z,703,893,55250,190,0.003438914,0.016162896,0.012723982,2014,TDG
2015-11-13T00:00:00Z,789,951,58072,162,0.00278964,0.016376223,0.013586582,2015,TDG
2016-11-15T00:00:00Z,754,968,58735,214,0.003643483,0.016480804,0.01283732,2016,TDG
2017-11-13T00:00:00Z,805,976,58991,171,0.002898747,0.016544897,0.013646149,2017,TDG
2018-11-09T00:00:00Z,873,1058,65058,185,0.002843616,0.016262412,0.013418796,2018,TDG
2011-02-17T00:00:00Z,3701,2825,129342,-876,-0.006772742,0.02184132,0.028614062,2011,TRV
2012-02-16T00:00:00Z,3663,2829,129445,-834,-0.006442891,0.021854842,0.028297733,2012,TRV
2013-02-19T00:00:00Z,3628,2877,130434,-751,-0.005757701,0.022057132,0.027814834,2013,TRV
2014-02-13T00:00:00Z,3671,2900,133571,-771,-0.005772211,0.0217113,0.027483511,2014,TRV
2015-02-12T00:00:00Z,3568,2834,132515,-734,-0.005538996,0.021386258,0.026925254,2015,TRV
2016-02-11T00:00:00Z,3572,2799,131205,-773,-0.005891544,0.021333028,0.027224572,2016,TRV
2017-02-16T00:00:00Z,3572,2782,129659,-790,-0.006092905,0.021456281,0.027549187,2017,TRV
2018-02-15T00:00:00Z,3604,2804,131231,-800,-0.006096121,0.021366903,0.027463023,2018,TRV
2019-02-14T00:00:00Z,3518,2640,126686,-878,-0.006930521,0.020838925,0.027769446,2019,TRV
2012-03-15T00:00:00Z,741,1430,59092,689,0.011659785,0.024199553,0.012539768,2012,TRIP
2013-02-15T00:00:00Z,804,1471,60652,667,0.010997164,0.024253116,0.013255952,2013,TRIP
2014-02-11T00:00:00Z,792,1422,61288,630,0.010279337,0.023201932,0.012922595,2014,TRIP
2015-02-17T00:00:00Z,807,1526,65164,719,0.0110337,0.023417838,0.012384138,2015,TRIP
2016-02-18T00:00:00Z,812,1599,65967,787,0.011930208,0.024239392,0.012309185,2016,TRIP
2017-02-17T00:00:00Z,874,1840,72664,966,0.013294066,0.02532203,0.012027964,2017,TRIP
2018-02-21T00:00:00Z,873,1738,71085,865,0.012168531,0.024449603,0.012281072,2018,TRIP
2019-02-22T00:00:00Z,946,1692,73657,746,0.010128026,0.02297134,0.012843314,2019,TRIP
2009-11-23T00:00:00Z,1037,1255,51999,218,0.004192388,0.02413508,0.019942691,2009,TSN
2010-11-22T00:00:00Z,1102,1229,53599,127,0.002369447,0.022929532,0.020560085,2010,TSN
2011-11-21T00:00:00Z,1035,1212,51496,177,0.00343716,0.023535809,0.020098648,2011,TSN
2012-11-19T00:00:00Z,847,1176,48078,329,0.006843047,0.024460252,0.017617205,2012,TSN
2013-11-18T00:00:00Z,841,1132,47809,291,0.00608672,0.02367755,0.01759083,2013,TSN
2014-11-17T00:00:00Z,968,1363,56876,395,0.006944933,0.023964414,0.017019481,2014,TSN
2015-11-23T00:00:00Z,955,1447,58770,492,0.008371618,0.024621405,0.016249787,2015,TSN
2016-11-21T00:00:00Z,937,1478,57656,541,0.009383239,0.0256348,0.016251561,2016,TSN
2017-11-13T00:00:00Z,981,1654,63744,673,0.010557856,0.02594754,0.015389684,2017,TSN
2018-11-13T00:00:00Z,994,1734,64312,740,0.011506406,0.026962309,0.015455902,2018,TSN
2010-02-25T00:00:00Z,985,997,59087,12,0.00020309,0.016873424,0.016670334,2010,UDR
2011-02-23T00:00:00Z,1460,1473,86922,13,0.000149559,0.016946228,0.016796668,2011,UDR
2012-02-27T00:00:00Z,1433,1487,87782,54,0.00061516,0.016939692,0.016324531,2012,UDR
2013-02-27T00:00:00Z,1717,1951,101641,234,0.002302221,0.01919501,0.016892789,2013,UDR
2014-02-25T00:00:00Z,1997,2076,114921,79,0.000687429,0.018064583,0.017377155,2014,UDR
2015-02-24T00:00:00Z,1783,1538,85785,-245,-0.002855977,0.017928542,0.020784519,2015,UDR
2016-02-23T00:00:00Z,1848,1541,87562,-307,-0.003506087,0.017598958,0.021105046,2016,UDR
2017-02-21T00:00:00Z,1625,1569,86209,-56,-0.000649584,0.018199956,0.01884954,2017,UDR
2018-02-20T00:00:00Z,1618,1599,88166,-19,-0.000215503,0.018136243,0.018351746,2018,UDR
2019-02-19T00:00:00Z,1615,1586,88821,-29,-0.000326499,0.017856138,0.018182637,2019,UDR
2010-03-31T00:00:00Z,587,944,36637,357,0.009744248,0.025766302,0.016022054,2010,ULTA
2011-03-30T00:00:00Z,516,900,35118,384,0.010934563,0.025627883,0.01469332,2011,ULTA
2012-03-28T00:00:00Z,506,843,34041,337,0.009899827,0.024764255,0.014864428,2012,ULTA
2013-04-03T00:00:00Z,470,786,32127,316,0.009835964,0.024465403,0.014629439,2013,ULTA
2014-04-02T00:00:00Z,542,818,34768,276,0.007938334,0.023527382,0.015589047,2014,ULTA
2015-04-01T00:00:00Z,538,867,36874,329,0.008922276,0.023512502,0.014590226,2015,ULTA
2016-03-30T00:00:00Z,480,910,37298,430,0.011528768,0.024398091,0.012869323,2016,ULTA
2017-03-28T00:00:00Z,470,999,37989,529,0.013925084,0.026297086,0.012372002,2017,ULTA
2018-04-03T00:00:00Z,505,1019,38976,514,0.013187603,0.026144294,0.012956691,2018,ULTA
2019-04-02T00:00:00Z,479,1027,38017,548,0.014414604,0.02701423,0.012599626,2019,ULTA
2011-02-28T00:00:00Z,138,224,12909,86,0.006662019,0.017352235,0.010690216,2011,USB
2012-02-23T00:00:00Z,200,245,13813,45,0.003257801,0.017736915,0.014479114,2012,USB
2013-02-22T00:00:00Z,222,248,14431,26,0.001801677,0.017185226,0.015383549,2013,USB
2014-02-21T00:00:00Z,252,287,16287,35,0.002148953,0.017621416,0.015472463,2014,USB
2015-02-27T00:00:00Z,251,289,16334,38,0.002326436,0.017693155,0.01536672,2015,USB
2016-02-25T00:00:00Z,293,333,18123,40,0.00220714,0.018374441,0.016167301,2016,USB
2017-02-23T00:00:00Z,297,330,17342,33,0.001902895,0.019028947,0.017126052,2017,USB
2018-02-22T00:00:00Z,293,329,17313,36,0.002079362,0.019003061,0.016923699,2018,USB
2019-02-22T00:00:00Z,347,362,18556,15,0.000808364,0.019508515,0.018700151,2019,USB
2011-02-24T00:00:00Z,550,789,39888,239,0.005991777,0.019780385,0.013788608,2011,UAA
2012-02-27T00:00:00Z,604,831,41150,227,0.005516403,0.020194411,0.014678007,2012,UAA
2013-02-25T00:00:00Z,617,814,41044,197,0.004799727,0.019832375,0.015032648,2013,UAA
2014-02-21T00:00:00Z,664,869,42183,205,0.004859778,0.020600716,0.015740938,2014,UAA
2015-02-20T00:00:00Z,674,878,42446,204,0.004806107,0.020685106,0.015878999,2015,UAA
2016-02-22T00:00:00Z,702,982,45680,280,0.006129597,0.021497373,0.015367776,2016,UAA
2017-02-23T00:00:00Z,728,959,46336,231,0.004985325,0.020696651,0.015711326,2017,UAA
2018-02-28T00:00:00Z,862,1129,50535,267,0.005283467,0.022340952,0.017057485,2018,UAA
2019-02-25T00:00:00Z,929,1189,53385,260,0.004870282,0.022272174,0.017401892,2019,UAA
2011-02-24T00:00:00Z,550,789,39888,239,0.005991777,0.019780385,0.013788608,2011,UA
2012-02-27T00:00:00Z,604,831,41150,227,0.005516403,0.020194411,0.014678007,2012,UA
2013-02-25T00:00:00Z,617,814,41044,197,0.004799727,0.019832375,0.015032648,2013,UA
2014-02-21T00:00:00Z,664,869,42183,205,0.004859778,0.020600716,0.015740938,2014,UA
2015-02-20T00:00:00Z,674,878,42446,204,0.004806107,0.020685106,0.015878999,2015,UA
2016-02-22T00:00:00Z,702,982,45680,280,0.006129597,0.021497373,0.015367776,2016,UA
2017-02-23T00:00:00Z,728,959,46336,231,0.004985325,0.020696651,0.015711326,2017,UA
2018-02-28T00:00:00Z,862,1129,50535,267,0.005283467,0.022340952,0.017057485,2018,UA
2019-02-25T00:00:00Z,929,1189,53385,260,0.004870282,0.022272174,0.017401892,2019,UA
2010-02-05T00:00:00Z,968,1124,48559,156,0.003212587,0.023147099,0.019934513,2010,UNP
2011-02-04T00:00:00Z,978,1110,48342,132,0.002730545,0.0229614,0.020230855,2011,UNP
2012-02-03T00:00:00Z,981,1099,48669,118,0.002424541,0.022581109,0.020156568,2012,UNP
2013-02-08T00:00:00Z,955,1105,47565,150,0.003153579,0.023231368,0.020077788,2013,UNP
2014-02-07T00:00:00Z,1017,1112,48409,95,0.001962445,0.022970935,0.02100849,2014,UNP
2015-02-06T00:00:00Z,1000,1080,48135,80,0.001661992,0.022436896,0.020774904,2015,UNP
2016-02-05T00:00:00Z,1010,1093,48931,83,0.001696266,0.022337577,0.020641311,2016,UNP
2017-02-03T00:00:00Z,892,1009,45321,117,0.002581585,0.02226341,0.019681825,2017,UNP
2018-02-09T00:00:00Z,834,1044,45976,210,0.0045676,0.0227075,0.018139899,2018,UNP
2019-02-08T00:00:00Z,840,1027,46493,187,0.004022111,0.022089347,0.018067236,2019,UNP
2011-02-22T00:00:00Z,1443,2015,104583,572,0.00546934,0.019266994,0.013797654,2011,UAL
2012-02-22T00:00:00Z,1240,1768,94535,528,0.005585233,0.018702068,0.013116835,2012,UAL
2013-02-25T00:00:00Z,1270,1589,87560,319,0.003643216,0.018147556,0.01450434,2013,UAL
2014-02-20T00:00:00Z,1083,1278,71643,195,0.002721829,0.017838449,0.01511662,2014,UAL
2015-02-20T00:00:00Z,1062,1199,67174,137,0.00203948,0.017849168,0.015809688,2015,UAL
2016-02-18T00:00:00Z,1021,1158,65826,137,0.002081244,0.017591833,0.015510589,2016,UAL
2017-02-23T00:00:00Z,867,1032,62632,165,0.002634436,0.0164772,0.013842764,2017,UAL
2018-02-22T00:00:00Z,839,1030,64073,191,0.002980975,0.016075414,0.013094439,2018,UAL
2019-02-28T00:00:00Z,829,1095,62702,266,0.004242289,0.017463558,0.013221269,2019,UAL
2010-02-10T00:00:00Z,827,1450,56649,623,0.010997546,0.025596215,0.014598669,2010,UNH
2011-02-10T00:00:00Z,943,1529,59460,586,0.009855365,0.025714766,0.015859401,2011,UNH
2012-02-09T00:00:00Z,930,1568,60576,638,0.010532224,0.025884839,0.015352615,2012,UNH
2013-02-07T00:00:00Z,908,1697,62031,789,0.012719447,0.027357289,0.014637842,2013,UNH
2014-02-12T00:00:00Z,865,1540,58109,675,0.011616101,0.026501919,0.014885818,2014,UNH
2015-02-10T00:00:00Z,855,1430,56680,575,0.010144672,0.025229358,0.015084686,2015,UNH
2016-02-09T00:00:00Z,792,1330,54295,538,0.009908831,0.02449581,0.014586979,2016,UNH
2017-02-08T00:00:00Z,760,1217,51836,457,0.008816267,0.023477892,0.014661625,2017,UNH
2018-02-13T00:00:00Z,689,1116,46994,427,0.009086266,0.023747712,0.014661446,2018,UNH
2019-02-12T00:00:00Z,681,1073,45703,392,0.008577117,0.023477671,0.014900554,2019,UNH
2010-02-26T00:00:00Z,935,1385,56881,450,0.007911253,0.02434908,0.016437826,2010,UPS
2011-02-28T00:00:00Z,981,1447,58567,466,0.007956699,0.024706746,0.016750047,2011,UPS
2012-02-27T00:00:00Z,1011,1578,64760,567,0.008755405,0.024366893,0.015611489,2012,UPS
2013-02-28T00:00:00Z,931,1521,62307,590,0.009469241,0.024411382,0.014942141,2013,UPS
2014-02-28T00:00:00Z,991,1655,66645,664,0.009963238,0.024833071,0.014869833,2014,UPS
2015-02-27T00:00:00Z,945,1730,66718,785,0.01176594,0.025930034,0.014164094,2015,UPS
2016-02-25T00:00:00Z,954,1791,68064,837,0.01229725,0.02631347,0.01401622,2016,UPS
2017-02-21T00:00:00Z,939,1887,68892,948,0.013760669,0.027390698,0.01363003,2017,UPS
2018-02-21T00:00:00Z,945,1812,70209,867,0.012348844,0.025808657,0.013459813,2018,UPS
2019-02-21T00:00:00Z,964,1884,73388,920,0.012536109,0.025671772,0.013135663,2019,UPS
2012-01-25T00:00:00Z,874,1114,53446,240,0.004490514,0.020843468,0.016352954,2012,URI
2013-01-23T00:00:00Z,922,1258,60031,336,0.005597108,0.020955839,0.015358731,2013,URI
2014-01-22T00:00:00Z,839,1257,59924,418,0.006975502,0.02097657,0.014001068,2014,URI
2015-01-21T00:00:00Z,822,1228,59550,406,0.0068178,0.020621327,0.013803526,2015,URI
2016-01-27T00:00:00Z,816,1210,55236,394,0.007133029,0.021906003,0.014772974,2016,URI
2017-01-25T00:00:00Z,782,1174,52804,392,0.00742368,0.022233164,0.014809484,2017,URI
2018-01-24T00:00:00Z,816,1349,58138,533,0.009167842,0.023203413,0.014035571,2018,URI
2019-01-23T00:00:00Z,859,1339,65665,480,0.00730983,0.02039138,0.01308155,2019,URI
2011-02-10T00:00:00Z,278,334,18246,56,0.003069166,0.018305382,0.015236216,2011,UTX
2012-02-09T00:00:00Z,331,415,20987,84,0.004002478,0.019774146,0.015771668,2012,UTX
2013-02-07T00:00:00Z,409,439,23293,30,0.001287941,0.018846864,0.017558923,2013,UTX
2014-02-06T00:00:00Z,302,358,20072,56,0.002789956,0.017835791,0.015045835,2014,UTX
2015-02-05T00:00:00Z,344,381,21761,37,0.00170029,0.017508387,0.015808097,2015,UTX
2016-02-11T00:00:00Z,341,363,19461,22,0.001130466,0.01865269,0.017522224,2016,UTX
2017-02-09T00:00:00Z,343,352,19350,9,0.000465116,0.018191214,0.017726098,2017,UTX
2018-02-09T00:00:00Z,378,361,20007,-17,-0.000849703,0.018043685,0.018893387,2018,UTX
2019-02-07T00:00:00Z,380,402,21346,22,0.001030638,0.018832568,0.01780193,2019,UTX
2011-02-28T00:00:00Z,1268,1402,74158,134,0.001806953,0.01890558,0.017098627,2011,UHS
2012-02-27T00:00:00Z,1289,1537,76778,248,0.003230092,0.020018755,0.016788663,2012,UHS
2013-02-28T00:00:00Z,1367,1645,83414,278,0.003332774,0.01972091,0.016388136,2013,UHS
2014-02-27T00:00:00Z,1339,1626,81382,287,0.003526578,0.019979848,0.01645327,2014,UHS
2015-02-26T00:00:00Z,322,401,22663,79,0.003485858,0.017694039,0.014208181,2015,UHS
2016-02-25T00:00:00Z,1416,1735,84405,319,0.003779397,0.020555654,0.016776257,2016,UHS
2017-02-28T00:00:00Z,1355,1622,81751,267,0.003266015,0.019840736,0.016574721,2017,UHS
2018-02-28T00:00:00Z,1407,1644,83710,237,0.002831203,0.019639231,0.016808028,2018,UHS
2019-02-27T00:00:00Z,1493,1744,88677,251,0.002830497,0.019666881,0.016836384,2019,UHS
2010-02-26T00:00:00Z,2176,2543,99350,367,0.003694011,0.025596376,0.021902365,2010,UNM
2011-02-25T00:00:00Z,2199,2600,101349,401,0.003956625,0.025653929,0.021697303,2011,UNM
2012-02-24T00:00:00Z,2312,2749,104941,437,0.004164245,0.026195672,0.022031427,2012,UNM
2013-02-22T00:00:00Z,2265,2695,102597,430,0.004191156,0.026267825,0.022076669,2013,UNM
2014-02-26T00:00:00Z,2259,2683,100420,424,0.004222266,0.026717785,0.022495519,2014,UNM
2015-02-25T00:00:00Z,2212,2587,96731,375,0.00387673,0.02674427,0.02286754,2015,UNM
2016-02-24T00:00:00Z,2192,2606,96691,414,0.004281681,0.026951836,0.022670155,2016,UNM
2017-02-22T00:00:00Z,2226,2604,97123,378,0.003891972,0.026811363,0.022919391,2017,UNM
2018-02-21T00:00:00Z,2190,2640,98666,450,0.004560842,0.026756938,0.022196096,2018,UNM
2019-02-19T00:00:00Z,2296,2699,103035,403,0.003911292,0.026194982,0.02228369,2019,UNM
2010-03-03T00:00:00Z,803,1297,53834,494,0.009176357,0.024092581,0.014916224,2010,VFC
2011-03-02T00:00:00Z,756,1244,52311,488,0.009328822,0.023780849,0.014452027,2011,VFC
2012-02-29T00:00:00Z,756,1202,51263,446,0.008700232,0.023447711,0.014747479,2012,VFC
2013-02-27T00:00:00Z,727,1197,50102,470,0.009380863,0.023891262,0.014510399,2013,VFC
2014-02-26T00:00:00Z,732,1161,49342,429,0.008694419,0.02352965,0.014835232,2014,VFC
2015-03-03T00:00:00Z,751,1217,50571,466,0.009214767,0.024065176,0.014850408,2015,VFC
2016-03-02T00:00:00Z,814,1273,54085,459,0.008486641,0.023537025,0.015050384,2016,VFC
2017-03-01T00:00:00Z,877,1378,55370,501,0.009048221,0.024887123,0.015838902,2017,VFC
2018-02-28T00:00:00Z,903,1316,57128,413,0.00722938,0.023035989,0.01580661,2018,VFC
2019-05-24T00:00:00Z,1059,1588,75516,529,0.007005138,0.021028656,0.014023518,2019,VFC
2010-02-26T00:00:00Z,1287,1408,63899,121,0.001893613,0.022034774,0.02014116,2010,VLO
2011-02-25T00:00:00Z,958,1157,54826,199,0.003629665,0.021103126,0.017473461,2011,VLO
2012-02-24T00:00:00Z,872,1117,51810,245,0.004728817,0.021559544,0.016830728,2012,VLO
2013-02-28T00:00:00Z,943,1150,54283,207,0.003813349,0.02118527,0.017371921,2013,VLO
2014-02-27T00:00:00Z,963,1104,52888,141,0.002666011,0.0208743,0.018208289,2014,VLO
2015-02-26T00:00:00Z,919,1029,48907,110,0.002249167,0.021039933,0.018790766,2015,VLO
2016-02-25T00:00:00Z,904,1098,49742,194,0.003900125,0.022073901,0.018173777,2016,VLO
2017-02-23T00:00:00Z,895,1076,51050,181,0.003545544,0.021077375,0.017531832,2017,VLO
2018-02-28T00:00:00Z,873,1126,53314,253,0.00474547,0.021120156,0.016374686,2018,VLO
2019-02-28T00:00:00Z,844,1245,56220,401,0.007132693,0.022145144,0.015012451,2019,VLO
2011-11-23T00:00:00Z,1559,1816,85958,257,0.002989832,0.021126597,0.018136764,2011,VAR
2012-11-21T00:00:00Z,1575,1815,87849,240,0.002731961,0.020660451,0.017928491,2012,VAR
2013-11-26T00:00:00Z,1653,1896,86516,243,0.002808729,0.021915021,0.019106292,2013,VAR
2014-11-25T00:00:00Z,1594,1974,84368,380,0.004504077,0.023397497,0.018893419,2014,VAR
2015-11-25T00:00:00Z,1665,2034,86333,369,0.004274148,0.023559937,0.019285789,2015,VAR
2016-11-23T00:00:00Z,1704,2094,90128,390,0.004327179,0.023233623,0.018906444,2016,VAR
2017-11-27T00:00:00Z,1608,1946,81687,338,0.004137745,0.02382264,0.019684895,2017,VAR
2018-11-26T00:00:00Z,1578,2009,85022,431,0.005069276,0.023629178,0.018559902,2018,VAR
2012-02-22T00:00:00Z,1622,2172,116712,550,0.004712455,0.018609912,0.013897457,2012,VTR
2013-02-19T00:00:00Z,1587,2095,117250,508,0.004332623,0.017867804,0.013535181,2013,VTR
2014-02-18T00:00:00Z,1509,1933,94716,424,0.00447654,0.020408379,0.015931838,2014,VTR
2015-02-13T00:00:00Z,1567,1944,97479,377,0.0038675,0.019942757,0.016075257,2015,VTR
2016-02-12T00:00:00Z,1569,2046,98772,477,0.004829304,0.020714372,0.015885069,2016,VTR
2017-02-14T00:00:00Z,1588,2070,101036,482,0.004770577,0.020487747,0.01571717,2017,VTR
2018-02-09T00:00:00Z,1451,1857,89781,406,0.004522115,0.020683664,0.016161549,2018,VTR
2019-02-08T00:00:00Z,1446,1836,95765,390,0.004072469,0.019171931,0.015099462,2019,VTR
2010-02-26T00:00:00Z,1198,1427,69231,229,0.003307767,0.020612154,0.017304387,2010,VRSN
2011-02-24T00:00:00Z,1051,1264,60030,213,0.003548226,0.021056139,0.017507913,2011,VRSN
2012-02-24T00:00:00Z,882,1056,50802,174,0.003425062,0.020786583,0.017361521,2012,VRSN
2013-02-28T00:00:00Z,870,1023,50293,153,0.003042173,0.020340803,0.01729863,2013,VRSN
2014-02-21T00:00:00Z,1002,1167,55707,165,0.002961926,0.020948893,0.017986968,2014,VRSN
2015-02-13T00:00:00Z,1001,1099,53621,98,0.001827642,0.020495701,0.018668059,2015,VRSN
2016-02-19T00:00:00Z,761,895,42856,134,0.00312675,0.02088389,0.01775714,2016,VRSN
2017-02-17T00:00:00Z,743,893,40148,150,0.003736176,0.022242702,0.018506526,2017,VRSN
2018-02-16T00:00:00Z,712,893,39936,181,0.004532252,0.022360777,0.017828526,2018,VRSN
2019-02-15T00:00:00Z,684,833,38904,149,0.00382994,0.02141168,0.01758174,2019,VRSN
2010-03-09T00:00:00Z,1039,1305,58697,266,0.004531748,0.022232823,0.017701075,2010,VRSK
2011-02-28T00:00:00Z,1008,1281,59165,273,0.004614214,0.021651314,0.0170371,2011,VRSK
2012-02-28T00:00:00Z,1010,1319,61170,309,0.005051496,0.021562858,0.016511362,2012,VRSK
2013-02-26T00:00:00Z,1095,1297,59679,202,0.003384775,0.021732938,0.018348163,2013,VRSK
2014-02-25T00:00:00Z,1277,1317,61700,40,0.000648298,0.021345219,0.020696921,2014,VRSK
2015-02-24T00:00:00Z,1113,1266,57534,153,0.002659297,0.02200438,0.019345083,2015,VRSK
2016-02-24T00:00:00Z,1094,1212,55933,118,0.002109667,0.021668782,0.019559115,2016,VRSK
2017-02-21T00:00:00Z,1091,1254,56795,163,0.002869971,0.022079408,0.019209437,2017,VRSK
2018-02-20T00:00:00Z,1066,1335,58457,269,0.004601673,0.022837299,0.018235626,2018,VRSK
2019-02-19T00:00:00Z,938,1302,58548,364,0.006217121,0.022238164,0.016021043,2019,VRSK
2010-02-26T00:00:00Z,156,429,20059,273,0.013609851,0.021386909,0.007777058,2010,VZ
2011-02-28T00:00:00Z,169,398,18988,229,0.012060249,0.020960607,0.008900358,2011,VZ
2012-02-24T00:00:00Z,179,392,17332,213,0.012289407,0.022617124,0.010327718,2012,VZ
2013-02-26T00:00:00Z,206,391,17364,185,0.010654227,0.022517853,0.011863626,2013,VZ
2014-02-27T00:00:00Z,255,453,19933,198,0.009933276,0.022726133,0.012792856,2014,VZ
2015-02-23T00:00:00Z,260,435,19963,175,0.008766218,0.021790312,0.013024095,2015,VZ
2016-02-23T00:00:00Z,251,436,19888,185,0.009302092,0.021922767,0.012620676,2016,VZ
2017-02-21T00:00:00Z,245,420,19987,175,0.008755691,0.021013659,0.012257968,2017,VZ
2018-02-23T00:00:00Z,249,437,20529,188,0.009157777,0.02128696,0.012129183,2018,VZ
2019-02-15T00:00:00Z,263,447,20180,184,0.009117939,0.022150644,0.013032706,2019,VZ
2010-02-19T00:00:00Z,1031,1553,69632,522,0.007496553,0.022302964,0.014806411,2010,VRTX
2011-02-17T00:00:00Z,1060,1574,70338,514,0.007307572,0.022377662,0.01507009,2011,VRTX
2012-02-22T00:00:00Z,1158,1558,74454,400,0.005372445,0.020925672,0.015553227,2012,VRTX
2013-03-01T00:00:00Z,1256,1610,76429,354,0.00463175,0.021065302,0.016433553,2013,VRTX
2014-02-11T00:00:00Z,1210,1517,73867,307,0.004156118,0.020536911,0.016380793,2014,VRTX
2015-02-13T00:00:00Z,1287,1524,71978,237,0.003292673,0.021173136,0.017880463,2015,VRTX
2016-02-16T00:00:00Z,1312,1573,73346,261,0.003558476,0.021446296,0.017887819,2016,VRTX
2017-02-23T00:00:00Z,1293,1613,75905,320,0.004215796,0.021250247,0.017034451,2017,VRTX
2018-02-15T00:00:00Z,1271,1683,78877,412,0.005223322,0.021337018,0.016113696,2018,VRTX
2019-02-13T00:00:00Z,1216,1684,76527,468,0.006115489,0.022005305,0.015889817,2019,VRTX
2010-02-11T00:00:00Z,712,1482,60678,770,0.012689937,0.024424009,0.011734072,2010,VIAB
2011-11-10T00:00:00Z,760,1397,60906,637,0.01045874,0.022936985,0.012478245,2011,VIAB
2012-11-15T00:00:00Z,796,1488,62659,692,0.011043904,0.023747586,0.012703682,2012,VIAB
2013-11-14T00:00:00Z,720,1362,58041,642,0.011061146,0.02346617,0.012405024,2013,VIAB
2014-11-13T00:00:00Z,604,1229,52653,625,0.011870169,0.0233415,0.011471331,2014,VIAB
2015-11-12T00:00:00Z,630,1302,54943,672,0.012230857,0.023697286,0.011466429,2015,VIAB
2016-11-09T00:00:00Z,642,1348,57018,706,0.012382055,0.023641657,0.011259602,2016,VIAB
2017-11-16T00:00:00Z,629,1410,56554,781,0.01380981,0.024931923,0.011122113,2017,VIAB
2018-11-16T00:00:00Z,641,1519,58169,878,0.01509395,0.026113566,0.011019615,2018,VIAB
2009-11-20T00:00:00Z,938,1328,66641,390,0.005852253,0.019927672,0.014075419,2009,V
2010-11-19T00:00:00Z,1018,1502,72350,484,0.006689703,0.020760194,0.014070491,2010,V
2011-11-18T00:00:00Z,1046,1555,71985,509,0.007070918,0.021601723,0.014530805,2011,V
2012-11-16T00:00:00Z,953,1415,66966,462,0.006899023,0.021130126,0.014231102,2012,V
2013-11-22T00:00:00Z,889,1239,60078,350,0.00582576,0.02062319,0.01479743,2013,V
2014-11-21T00:00:00Z,913,1286,62551,373,0.005963134,0.020559224,0.01459609,2014,V
2015-11-20T00:00:00Z,1009,1303,65485,294,0.004489578,0.019897686,0.015408109,2015,V
2016-11-15T00:00:00Z,1043,1459,67961,416,0.006121158,0.021468195,0.015347037,2016,V
2017-11-17T00:00:00Z,1000,1435,65262,435,0.006665441,0.021988293,0.015322853,2017,V
2018-11-16T00:00:00Z,920,1383,63100,463,0.007337559,0.021917591,0.014580032,2018,V
2014-02-24T00:00:00Z,974,1308,73203,334,0.004562655,0.01786812,0.013305466,2014,VNO
2015-02-17T00:00:00Z,949,1252,72190,303,0.004197257,0.017343122,0.013145865,2015,VNO
2016-02-16T00:00:00Z,907,1230,68035,323,0.004747556,0.01807893,0.013331374,2016,VNO
2017-02-13T00:00:00Z,995,1542,77947,547,0.007017589,0.019782673,0.012765084,2017,VNO
2018-02-12T00:00:00Z,974,1452,76692,478,0.006232723,0.018932874,0.012700151,2018,VNO
2019-02-11T00:00:00Z,958,1433,75545,475,0.006287643,0.018968827,0.012681183,2019,VNO
2010-02-26T00:00:00Z,850,1357,51806,507,0.009786511,0.026193877,0.016407366,2010,VMC
2011-02-28T00:00:00Z,864,1372,51097,508,0.009941875,0.026850891,0.016909016,2011,VMC
2012-02-29T00:00:00Z,910,1520,54785,610,0.011134435,0.027744821,0.016610386,2012,VMC
2013-02-28T00:00:00Z,816,1448,51931,632,0.012169995,0.027883153,0.015713158,2013,VMC
2014-02-26T00:00:00Z,794,1400,51217,606,0.011832009,0.027334674,0.015502665,2014,VMC
2015-02-27T00:00:00Z,846,1343,50296,497,0.009881502,0.026701925,0.016820423,2015,VMC
2016-02-25T00:00:00Z,922,1388,52830,466,0.008820746,0.026272951,0.017452205,2016,VMC
2017-02-24T00:00:00Z,915,1378,53409,463,0.008668951,0.025800895,0.017131944,2017,VMC
2018-02-27T00:00:00Z,974,1456,56707,482,0.008499832,0.025675842,0.01717601,2018,VMC
2019-02-26T00:00:00Z,888,1383,54903,495,0.009015901,0.02518988,0.01617398,2019,VMC
2010-02-24T00:00:00Z,653,808,41117,155,0.00376973,0.019651239,0.015881509,2010,WAB
2011-02-25T00:00:00Z,665,777,40256,112,0.002782194,0.019301471,0.016519277,2011,WAB
2012-02-24T00:00:00Z,657,785,41391,128,0.00309246,0.018965476,0.015873016,2012,WAB
2013-02-22T00:00:00Z,633,782,41227,149,0.003614136,0.018968152,0.015354016,2013,WAB
2014-02-21T00:00:00Z,602,792,41310,190,0.004599371,0.019172113,0.014572743,2014,WAB
2015-02-20T00:00:00Z,595,785,40443,190,0.00469797,0.019410034,0.014712064,2015,WAB
2016-02-19T00:00:00Z,586,761,40743,175,0.004295216,0.018678055,0.014382839,2016,WAB
2017-02-28T00:00:00Z,668,944,47491,276,0.005811627,0.01987745,0.014065823,2017,WAB
2018-02-26T00:00:00Z,706,1002,47273,296,0.006261502,0.021196032,0.014934529,2018,WAB
2019-02-27T00:00:00Z,855,1097,54381,242,0.004450084,0.020172487,0.015722403,2019,WAB
2010-03-30T00:00:00Z,215,282,16890,67,0.003966844,0.01669627,0.012729426,2010,WMT
2011-03-30T00:00:00Z,214,281,17174,67,0.003901246,0.016361942,0.012460696,2011,WMT
2012-03-27T00:00:00Z,231,303,17760,72,0.004054054,0.017060811,0.013006757,2012,WMT
2013-03-26T00:00:00Z,286,324,19030,38,0.001996847,0.017025749,0.015028902,2013,WMT
2014-03-21T00:00:00Z,302,370,20402,68,0.003333007,0.018135477,0.01480247,2014,WMT
2015-04-01T00:00:00Z,319,402,22016,83,0.003769985,0.018259448,0.014489462,2015,WMT
2016-03-30T00:00:00Z,355,417,23214,62,0.002670802,0.017963298,0.015292496,2016,WMT
2017-03-31T00:00:00Z,362,435,23577,73,0.003096238,0.018450185,0.015353947,2017,WMT
2018-03-30T00:00:00Z,806,1114,54454,308,0.00565615,0.020457634,0.014801484,2018,WMT
2019-03-28T00:00:00Z,835,1083,53435,248,0.004641153,0.020267615,0.015626462,2019,WMT
2015-10-28T00:00:00Z,543,1002,43963,459,0.010440598,0.022791893,0.012351295,2015,WBA
2016-10-20T00:00:00Z,1036,1494,69810,458,0.006560665,0.021400945,0.014840281,2016,WBA
2017-10-25T00:00:00Z,1011,1465,69618,454,0.006521302,0.021043408,0.014522106,2017,WBA
2018-10-11T00:00:00Z,1064,1474,68884,410,0.005952035,0.021398293,0.015446257,2018,WBA
2011-02-17T00:00:00Z,1474,1690,76280,216,0.002831673,0.022155218,0.019323545,2011,WM
2012-02-16T00:00:00Z,1594,1751,82266,157,0.001908443,0.021284613,0.01937617,2012,WM
2013-02-14T00:00:00Z,1661,1835,83749,174,0.002077637,0.021910709,0.019833073,2013,WM
2014-02-18T00:00:00Z,1757,1953,87463,196,0.002240948,0.022329442,0.020088495,2014,WM
2015-02-17T00:00:00Z,1664,1906,83912,242,0.002883974,0.022714272,0.019830298,2015,WM
2016-02-18T00:00:00Z,1604,1836,81109,232,0.002860348,0.022636206,0.019775857,2016,WM
2017-02-16T00:00:00Z,562,451,25130,-111,-0.004417031,0.017946677,0.022363709,2017,WM
2018-02-15T00:00:00Z,1475,1655,73058,180,0.002463796,0.022653234,0.020189439,2018,WM
2019-02-14T00:00:00Z,1472,1535,70281,63,0.000896402,0.021840896,0.020944494,2019,WM
2011-02-25T00:00:00Z,595,914,44461,319,0.007174827,0.020557342,0.013382515,2011,WAT
2012-02-24T00:00:00Z,528,851,41580,323,0.007768158,0.02046657,0.012698413,2012,WAT
2013-02-26T00:00:00Z,570,842,42775,272,0.006358854,0.019684395,0.013325541,2013,WAT
2014-02-27T00:00:00Z,576,870,42852,294,0.006860823,0.020302436,0.013441613,2014,WAT
2015-02-27T00:00:00Z,554,888,44076,334,0.00757782,0.020147019,0.012569199,2015,WAT
2016-02-26T00:00:00Z,576,945,45502,369,0.008109534,0.020768318,0.012658784,2016,WAT
2017-02-24T00:00:00Z,668,1046,49103,378,0.007698104,0.021302161,0.013604057,2017,WAT
2018-02-27T00:00:00Z,733,1111,52266,378,0.007232235,0.021256649,0.014024414,2018,WAT
2019-02-26T00:00:00Z,759,1108,54022,349,0.006460331,0.020510163,0.014049832,2019,WAT
2010-02-26T00:00:00Z,791,1238,63282,447,0.00706362,0.019563225,0.012499605,2010,WEC
2011-02-25T00:00:00Z,807,1148,59300,341,0.005750422,0.019359191,0.013608769,2011,WEC
2012-02-28T00:00:00Z,827,1190,62440,363,0.005813581,0.019058296,0.013244715,2012,WEC
2013-02-27T00:00:00Z,788,1097,59320,309,0.005209036,0.01849292,0.013283884,2013,WEC
2014-02-27T00:00:00Z,728,1094,58168,366,0.006292119,0.018807592,0.012515472,2014,WEC
2015-02-27T00:00:00Z,718,1101,58534,383,0.006543206,0.018809581,0.012266375,2015,WEC
2016-02-26T00:00:00Z,854,1472,72687,618,0.008502208,0.020251214,0.011749006,2016,WEC
2017-02-28T00:00:00Z,830,1562,74519,732,0.009822998,0.020961097,0.011138099,2017,WEC
2018-02-28T00:00:00Z,918,1666,80857,748,0.0092509,0.020604277,0.011353377,2018,WEC
2019-02-26T00:00:00Z,944,1694,84725,750,0.008852169,0.019994099,0.01114193,2019,WEC
2010-02-18T00:00:00Z,1274,1833,75530,559,0.007401033,0.024268503,0.01686747,2010,WCG
2011-02-16T00:00:00Z,1307,1769,76354,462,0.006050764,0.0231684,0.017117636,2011,WCG
2012-02-15T00:00:00Z,1414,1846,83431,432,0.005177931,0.022126068,0.016948137,2012,WCG
2013-02-13T00:00:00Z,1158,1705,72548,547,0.007539836,0.023501682,0.015961846,2013,WCG
2014-02-14T00:00:00Z,1212,1818,79391,606,0.007633107,0.022899321,0.015266214,2014,WCG
2015-02-17T00:00:00Z,1230,1895,82089,665,0.008100964,0.023084701,0.014983737,2015,WCG
2016-02-12T00:00:00Z,1180,1796,76425,616,0.00806019,0.023500164,0.015439974,2016,WCG
2017-02-13T00:00:00Z,1138,1801,73848,663,0.008977901,0.024387932,0.015410031,2017,WCG
2018-02-16T00:00:00Z,1208,1904,77406,696,0.008991551,0.024597576,0.015606025,2018,WCG
2019-02-12T00:00:00Z,1253,1945,79266,692,0.008730099,0.024537633,0.015807534,2019,WCG
2010-02-26T00:00:00Z,160,242,13859,82,0.005916733,0.017461577,0.011544845,2010,WFC
2011-02-25T00:00:00Z,182,327,15635,145,0.009274065,0.020914615,0.01164055,2011,WFC
2012-02-28T00:00:00Z,189,322,15594,133,0.008528921,0.020648968,0.012120046,2012,WFC
2013-02-27T00:00:00Z,194,249,13966,55,0.003938135,0.017829013,0.013890878,2013,WFC
2014-02-26T00:00:00Z,160,284,13872,124,0.00893887,0.020472895,0.011534025,2014,WFC
2015-02-25T00:00:00Z,138,266,13296,128,0.009626955,0.020006017,0.010379061,2015,WFC
2016-02-24T00:00:00Z,130,272,13525,142,0.010499076,0.020110906,0.00961183,2016,WFC
2017-03-01T00:00:00Z,116,241,12443,125,0.010045809,0.01936832,0.009322511,2017,WFC
2018-03-01T00:00:00Z,116,259,12748,143,0.011217446,0.020316912,0.009099467,2018,WFC
2019-02-27T00:00:00Z,116,209,11245,93,0.008270342,0.018586038,0.010315696,2019,WFC
2011-02-25T00:00:00Z,1170,1556,80018,386,0.004823915,0.019445625,0.01462171,2011,WELL
2012-02-17T00:00:00Z,1198,1570,80755,372,0.004606526,0.019441521,0.014834995,2012,WELL
2013-02-26T00:00:00Z,1185,1516,79926,331,0.004141331,0.018967545,0.014826214,2013,WELL
2014-02-21T00:00:00Z,1366,1662,91833,296,0.003223242,0.018098069,0.014874827,2014,WELL
2015-02-20T00:00:00Z,1308,1596,90234,288,0.003191702,0.017687346,0.014495645,2015,WELL
2016-02-18T00:00:00Z,1330,1672,94800,342,0.003607595,0.017637131,0.014029536,2016,WELL
2017-02-22T00:00:00Z,1179,1543,86910,364,0.004188241,0.017753998,0.013565758,2017,WELL
2018-02-28T00:00:00Z,1047,1248,75679,201,0.002655955,0.016490704,0.013834749,2018,WELL
2019-02-25T00:00:00Z,1180,1572,92640,392,0.004231434,0.016968912,0.012737478,2019,WELL
2009-08-14T00:00:00Z,1091,1202,51638,111,0.00214958,0.023277431,0.021127852,2009,WDC
2010-08-13T00:00:00Z,1077,1153,50055,76,0.00151833,0.023034662,0.021516332,2010,WDC
2011-08-12T00:00:00Z,1053,1034,47144,-19,-0.000403021,0.021932802,0.022335822,2011,WDC
2012-08-20T00:00:00Z,1165,1317,56990,152,0.002667135,0.023109317,0.020442183,2012,WDC
2013-08-19T00:00:00Z,1084,1286,56636,202,0.003566636,0.022706406,0.01913977,2013,WDC
2014-08-15T00:00:00Z,1095,1298,57365,203,0.003538743,0.022627037,0.019088294,2014,WDC
2015-08-21T00:00:00Z,1100,1208,52939,108,0.002040084,0.022818716,0.020778632,2015,WDC
2016-08-29T00:00:00Z,1441,1611,72976,170,0.002329533,0.022075751,0.019746218,2016,WDC
2017-08-29T00:00:00Z,1508,1624,71488,116,0.00162265,0.022717099,0.021094449,2017,WDC
2018-08-24T00:00:00Z,1324,1453,67646,129,0.001906986,0.021479467,0.01957248,2018,WDC
2010-02-26T00:00:00Z,1152,1570,73696,418,0.00567195,0.021303734,0.015631785,2010,WU
2011-02-25T00:00:00Z,1194,1575,73501,381,0.005183603,0.02142828,0.016244677,2011,WU
2012-02-24T00:00:00Z,1260,1638,76990,378,0.004909729,0.02127549,0.016365762,2012,WU
2013-02-22T00:00:00Z,1297,1650,76853,353,0.004593184,0.021469559,0.016876374,2013,WU
2014-02-24T00:00:00Z,1544,1687,81779,143,0.001748615,0.020628768,0.018880153,2014,WU
2015-02-20T00:00:00Z,1541,1649,80406,108,0.001343183,0.02050842,0.019165236,2015,WU
2016-02-19T00:00:00Z,1632,1653,81013,21,0.000259218,0.020404133,0.020144915,2016,WU
2017-02-22T00:00:00Z,1720,1701,85921,-19,-0.000221133,0.019797256,0.020018389,2017,WU
2018-02-22T00:00:00Z,1742,1709,88441,-33,-0.00037313,0.019323617,0.019696747,2018,WU
2019-02-21T00:00:00Z,1738,1758,88320,20,0.000226449,0.019904891,0.019678442,2019,WU
2018-11-16T00:00:00Z,1205,1962,87346,757,0.008666682,0.022462391,0.013795709,2018,WRK
2011-02-25T00:00:00Z,856,1341,61574,485,0.007876701,0.021778673,0.013901972,2011,WY
2012-02-22T00:00:00Z,854,1262,59093,408,0.006904371,0.021356167,0.014451796,2012,WY
2013-02-19T00:00:00Z,746,1230,55724,484,0.008685665,0.022073074,0.013387409,2013,WY
2014-02-18T00:00:00Z,752,1241,56322,489,0.00868222,0.022034019,0.013351799,2014,WY
2015-02-13T00:00:00Z,771,1186,53489,415,0.007758605,0.022172783,0.014414179,2015,WY
2016-02-17T00:00:00Z,851,1261,58148,410,0.007050973,0.021686043,0.014635069,2016,WY
2017-02-24T00:00:00Z,882,1462,67148,580,0.008637636,0.0217728,0.013135164,2017,WY
2018-02-16T00:00:00Z,833,1420,64293,587,0.009130076,0.022086386,0.012956309,2018,WY
2019-02-15T00:00:00Z,807,1274,59054,467,0.007908016,0.021573475,0.013665459,2019,WY
2011-02-14T00:00:00Z,630,1049,41556,419,0.01008278,0.025243046,0.015160266,2011,WHR
2012-02-22T00:00:00Z,605,1035,37866,430,0.011355834,0.027333228,0.015977394,2012,WHR
2013-02-19T00:00:00Z,645,1088,39702,443,0.011158128,0.027404161,0.016246033,2013,WHR
2014-02-18T00:00:00Z,646,1077,40500,431,0.010641975,0.026592593,0.015950617,2014,WHR
2015-02-26T00:00:00Z,674,1141,44966,467,0.010385625,0.025374728,0.014989103,2015,WHR
2016-02-16T00:00:00Z,692,1134,45616,442,0.009689583,0.024859698,0.015170116,2016,WHR
2017-02-13T00:00:00Z,651,1024,39404,373,0.009466044,0.025987209,0.016521165,2017,WHR
2018-02-13T00:00:00Z,682,1176,43722,494,0.01129866,0.026897214,0.015598555,2018,WHR
2019-02-12T00:00:00Z,783,1347,50893,564,0.011082074,0.026467294,0.01538522,2019,WHR
2012-02-28T00:00:00Z,1465,1370,74771,-95,-0.001270546,0.018322612,0.019593158,2012,WMB
2013-02-27T00:00:00Z,1419,1452,82536,33,0.000399826,0.017592323,0.017192498,2013,WMB
2014-02-26T00:00:00Z,1322,1442,78651,120,0.001525728,0.01833416,0.016808432,2014,WMB
2015-02-25T00:00:00Z,1415,1593,86912,178,0.002048049,0.018328884,0.016280836,2015,WMB
2016-02-26T00:00:00Z,1653,2239,113297,586,0.005172246,0.019762218,0.014589971,2016,WMB
2017-02-22T00:00:00Z,1363,1592,86444,229,0.002649114,0.018416547,0.015767433,2017,WMB
2018-02-22T00:00:00Z,1328,1606,80730,278,0.003443577,0.019893472,0.016449895,2018,WMB
2019-02-21T00:00:00Z,1270,1547,79920,277,0.003465966,0.019356857,0.015890891,2019,WMB
2013-02-28T00:00:00Z,1390,1682,71317,292,0.004094395,0.02358484,0.019490444,2013,WLTW
2014-02-27T00:00:00Z,1535,1842,80182,307,0.00382879,0.022972737,0.019143948,2014,WLTW
2015-02-24T00:00:00Z,1367,1593,71349,226,0.003167529,0.022326872,0.019159344,2015,WLTW
2016-02-29T00:00:00Z,1874,2154,94790,280,0.002953898,0.022723916,0.019770018,2016,WLTW
2017-03-01T00:00:00Z,1655,2218,93581,563,0.006016178,0.023701392,0.017685214,2017,WLTW
2018-02-28T00:00:00Z,1638,2494,100366,856,0.008528785,0.024849052,0.016320268,2018,WLTW
2019-02-27T00:00:00Z,1618,2483,98192,865,0.008809272,0.025287192,0.016477921,2019,WLTW
2011-03-01T00:00:00Z,1158,1183,66947,25,0.00037343,0.017670695,0.017297265,2011,WYNN
2012-02-29T00:00:00Z,1230,1258,67789,28,0.000413046,0.018557583,0.018144537,2012,WYNN
2013-03-01T00:00:00Z,1481,1619,81005,138,0.001703599,0.019986421,0.018282822,2013,WYNN
2014-02-28T00:00:00Z,1473,1618,78648,145,0.001843658,0.020572678,0.01872902,2014,WYNN
2015-03-02T00:00:00Z,1543,1742,82853,199,0.002401844,0.021025189,0.018623345,2015,WYNN
2016-02-29T00:00:00Z,1457,1708,78495,251,0.003197656,0.021759348,0.018561692,2016,WYNN
2017-02-24T00:00:00Z,1393,1647,76219,254,0.003332502,0.021608785,0.018276283,2017,WYNN
2018-02-28T00:00:00Z,1317,1646,74895,329,0.004392817,0.021977435,0.017584618,2018,WYNN
2019-02-28T00:00:00Z,1337,1565,72568,228,0.003141881,0.021565979,0.018424099,2019,WYNN
2010-02-26T00:00:00Z,1258,1918,94844,660,0.006958795,0.020222681,0.013263886,2010,XEL
2011-02-28T00:00:00Z,1252,1869,93401,617,0.006605925,0.020010492,0.013404567,2011,XEL
2012-02-24T00:00:00Z,1218,1720,90617,502,0.005539799,0.018980986,0.013441187,2012,XEL
2013-02-22T00:00:00Z,1270,1870,95303,600,0.006295709,0.019621628,0.013325918,2013,XEL
2014-02-21T00:00:00Z,1308,1909,97183,601,0.006184209,0.019643353,0.013459144,2014,XEL
2015-02-20T00:00:00Z,1262,1894,95655,632,0.006607078,0.019800324,0.013193247,2015,XEL
2016-02-19T00:00:00Z,1195,1813,91946,618,0.006721336,0.019718095,0.012996759,2016,XEL
2017-02-24T00:00:00Z,1179,1779,90100,600,0.006659267,0.019744728,0.013085461,2017,XEL
2018-02-23T00:00:00Z,1162,1740,89379,578,0.006466843,0.01946766,0.013000817,2018,XEL
2019-02-22T00:00:00Z,870,1307,62879,437,0.006949856,0.020785954,0.013836098,2019,XEL
2011-02-23T00:00:00Z,252,469,21513,217,0.010086924,0.021800772,0.011713847,2011,XRX
2012-02-23T00:00:00Z,218,470,20441,252,0.012328164,0.022993004,0.01066484,2012,XRX
2013-02-21T00:00:00Z,236,514,21590,278,0.012876332,0.023807318,0.010930987,2013,XRX
2014-02-21T00:00:00Z,1025,1787,70432,762,0.010818946,0.02537199,0.014553044,2014,XRX
2015-02-24T00:00:00Z,1159,1808,74183,649,0.008748635,0.024372161,0.015623526,2015,XRX
2016-02-19T00:00:00Z,1187,1861,75563,674,0.008919709,0.024628456,0.015708746,2016,XRX
2017-02-27T00:00:00Z,1159,1682,69095,523,0.007569289,0.024343295,0.016774007,2017,XRX
2018-02-23T00:00:00Z,1300,1929,80391,629,0.007824259,0.023995223,0.016170964,2018,XRX
2019-02-25T00:00:00Z,1220,1993,80581,773,0.009592832,0.024732877,0.015140045,2019,XRX
2010-06-01T00:00:00Z,826,1109,48799,283,0.005799299,0.022725876,0.016926576,2010,XLNX
2011-05-31T00:00:00Z,890,1099,50044,209,0.004176325,0.021960675,0.01778435,2011,XLNX
2012-05-25T00:00:00Z,882,1062,48771,180,0.003690718,0.021775235,0.018084517,2012,XLNX
2013-05-23T00:00:00Z,825,1003,45352,178,0.003924854,0.022115893,0.018191039,2013,XLNX
2014-05-16T00:00:00Z,820,987,45130,167,0.003700421,0.021870153,0.018169732,2014,XLNX
2015-05-13T00:00:00Z,781,976,44299,195,0.004401905,0.0220321,0.017630195,2015,XLNX
2016-05-17T00:00:00Z,785,1023,45900,238,0.005185185,0.022287582,0.017102397,2016,XLNX
2017-05-15T00:00:00Z,796,1051,45149,255,0.005647966,0.023278478,0.017630512,2017,XLNX
2018-05-15T00:00:00Z,812,1081,47343,269,0.005681938,0.022833365,0.017151427,2018,XLNX
2019-05-10T00:00:00Z,775,1099,46291,324,0.006999201,0.023741116,0.016741915,2019,XLNX
2012-02-28T00:00:00Z,625,1206,51727,581,0.011232045,0.02331471,0.012082665,2012,XYL
2013-02-25T00:00:00Z,700,1357,54136,657,0.012136102,0.025066499,0.012930398,2013,XYL
2014-02-27T00:00:00Z,744,1487,55533,743,0.013379432,0.026776871,0.013397439,2014,XYL
2015-02-26T00:00:00Z,738,1475,54084,737,0.013626951,0.027272391,0.01364544,2015,XYL
2016-02-26T00:00:00Z,809,1409,52102,600,0.011515873,0.027043108,0.015527235,2016,XYL
2017-02-23T00:00:00Z,854,1450,54753,596,0.010885248,0.026482567,0.015597319,2017,XYL
2018-02-23T00:00:00Z,881,1593,59490,712,0.011968398,0.02677761,0.014809212,2018,XYL
2019-02-22T00:00:00Z,903,1639,61494,736,0.011968647,0.026653007,0.014684359,2019,XYL
2010-02-17T00:00:00Z,761,1148,54357,387,0.007119598,0.021119635,0.014000037,2010,YUM
2011-02-15T00:00:00Z,858,1237,57695,379,0.006569027,0.021440333,0.014871306,2011,YUM
2012-02-21T00:00:00Z,793,1202,55643,409,0.00735043,0.021601998,0.014251568,2012,YUM
2013-02-20T00:00:00Z,805,1211,55847,406,0.007269862,0.021684244,0.014414382,2013,YUM
2014-02-18T00:00:00Z,912,1354,58709,442,0.007528658,0.023062903,0.015534245,2014,YUM
2015-02-17T00:00:00Z,780,1120,49518,340,0.00686619,0.022618038,0.015751848,2015,YUM
2016-02-16T00:00:00Z,795,1144,51169,349,0.006820536,0.022357287,0.015536751,2016,YUM
2017-02-22T00:00:00Z,939,1265,58587,326,0.005564374,0.021591821,0.016027446,2017,YUM
2018-02-22T00:00:00Z,864,1281,60185,417,0.006928637,0.021284373,0.014355736,2018,YUM
2019-02-21T00:00:00Z,890,1280,63726,390,0.006119951,0.020085993,0.013966042,2019,YUM
2010-02-25T00:00:00Z,718,1136,45214,418,0.009244924,0.025124961,0.015880037,2010,ZBH
2011-02-25T00:00:00Z,779,1140,46996,361,0.007681505,0.024257384,0.016575879,2011,ZBH
2012-02-27T00:00:00Z,841,1147,48782,306,0.006272806,0.023512771,0.017239966,2012,ZBH
2013-02-27T00:00:00Z,800,1080,45117,280,0.006206086,0.023937762,0.017731675,2013,ZBH
2014-02-28T00:00:00Z,832,1094,45694,262,0.005733794,0.023941874,0.01820808,2014,ZBH
2015-02-23T00:00:00Z,910,1165,49774,255,0.005123157,0.023405794,0.018282638,2015,ZBH
2016-02-29T00:00:00Z,960,1128,53479,168,0.00314142,0.021092391,0.017950971,2016,ZBH
2017-03-01T00:00:00Z,1028,1174,54675,146,0.002670325,0.021472337,0.018802012,2017,ZBH
2018-02-27T00:00:00Z,1066,1302,55747,236,0.004233412,0.023355517,0.019122105,2018,ZBH
2019-02-26T00:00:00Z,1053,1221,55590,168,0.003022126,0.021964382,0.018942256,2019,ZBH
2010-03-01T00:00:00Z,2144,2243,97745,99,0.00101284,0.022947465,0.021934626,2010,ZION
2011-03-01T00:00:00Z,1716,1812,80805,96,0.001188045,0.022424355,0.02123631,2011,ZION
2012-02-29T00:00:00Z,1813,2013,88263,200,0.002265955,0.022806839,0.020540883,2012,ZION
2013-02-28T00:00:00Z,1740,2012,87802,272,0.003097879,0.022915196,0.019817316,2013,ZION
2014-03-03T00:00:00Z,1814,2040,88026,226,0.002567423,0.023174971,0.020607548,2014,ZION
2015-02-27T00:00:00Z,1848,1944,85644,96,0.001120919,0.022698613,0.021577694,2015,ZION
2016-02-29T00:00:00Z,1685,1710,79703,25,0.000313664,0.02145465,0.021140986,2016,ZION
2017-02-28T00:00:00Z,1659,1692,80612,33,0.000409368,0.020989431,0.020580063,2017,ZION
2018-03-01T00:00:00Z,1553,1716,79422,163,0.002052328,0.021606104,0.019553776,2018,ZION
2019-02-26T00:00:00Z,1466,1780,76654,314,0.004096329,0.023221228,0.019124899,2019,ZION
2013-03-28T00:00:00Z,1390,2296,99587,906,0.009097573,0.023055218,0.013957645,2013,ZTS
2014-03-26T00:00:00Z,1221,1946,87108,725,0.008323001,0.022340084,0.014017082,2014,ZTS
2015-02-27T00:00:00Z,1319,2097,92454,778,0.008414996,0.02268155,0.014266554,2015,ZTS
2016-02-24T00:00:00Z,1403,2114,93800,711,0.007579957,0.022537313,0.014957356,2016,ZTS
2017-02-16T00:00:00Z,1300,1809,77438,509,0.006573,0.023360624,0.016787624,2017,ZTS
2018-02-15T00:00:00Z,1349,1762,77610,413,0.005321479,0.02270326,0.017381781,2018,ZTS
2019-02-14T00:00:00Z,1333,1787,78175,454,0.005807483,0.02285897,0.017051487,2019,ZTS
2010-03-01T00:00:00Z,1598,1221,62959,-377,-0.005988024,0.019393574,0.025381598,2010,BRK.B
2011-02-28T00:00:00Z,1535,1272,63457,-263,-0.004144539,0.02004507,0.024189609,2011,BRK.B
2012-02-27T00:00:00Z,1493,1292,63506,-201,-0.003165055,0.020344534,0.02350959,2012,BRK.B
2013-03-01T00:00:00Z,1485,1344,65038,-141,-0.002167963,0.020664842,0.022832805,2013,BRK.B
2014-03-03T00:00:00Z,1483,1348,66398,-135,-0.002033194,0.020301816,0.02233501,2014,BRK.B
2015-03-02T00:00:00Z,1450,1364,66669,-86,-0.001289955,0.020459284,0.021749239,2015,BRK.B
2016-02-29T00:00:00Z,1487,1413,68354,-74,-0.001082599,0.020671797,0.021754396,2016,BRK.B
2017-02-27T00:00:00Z,1456,1387,67244,-69,-0.001026114,0.020626376,0.021652489,2017,BRK.B
2018-02-26T00:00:00Z,1414,1353,66207,-61,-0.000921353,0.020435906,0.021357258,2018,BRK.B
2019-02-25T00:00:00Z,1448,1428,67958,-20,-0.000294299,0.021012979,0.021307278,2019,BRK.B
2010-06-25T00:00:00Z,187,175,10045,-12,-0.001194624,0.017421603,0.018616227,2010,BF.B
2011-06-27T00:00:00Z,205,189,10556,-16,-0.001515726,0.017904509,0.019420235,2011,BF.B
2012-06-27T00:00:00Z,685,974,37869,289,0.007631572,0.025720246,0.018088674,2012,BF.B
2013-06-27T00:00:00Z,692,915,36848,223,0.006051889,0.024831741,0.018779852,2013,BF.B
2014-06-20T00:00:00Z,719,972,39406,253,0.006420342,0.024666294,0.018245952,2014,BF.B
2015-06-18T00:00:00Z,725,993,40455,268,0.006624645,0.024545792,0.017921147,2015,BF.B
2016-06-16T00:00:00Z,725,1053,41901,328,0.007827975,0.025130665,0.01730269,2016,BF.B
2017-06-15T00:00:00Z,776,1082,44093,306,0.006939877,0.024539042,0.017599165,2017,BF.B
2018-06-13T00:00:00Z,790,1155,47984,365,0.007606702,0.024070524,0.016463821,2018,BF.B