filing_date,negative,positive,words,sentiment,sentiment.ratio,positive.ratio,negative.ratio,Year,TICKER
2009-06-29T00:00:00Z,801,1783,69926,982,0.014043417,0.025498384,0.011454967,2009,ORCL
2010-07-01T00:00:00Z,964,2034,80978,1070,0.013213465,0.025117933,0.011904468,2010,ORCL
2011-06-28T00:00:00Z,1027,2002,77135,975,0.012640176,0.025954495,0.013314319,2011,ORCL
2012-06-26T00:00:00Z,1068,2002,78031,934,0.011969602,0.02565647,0.013686868,2012,ORCL
2013-06-26T00:00:00Z,1134,1976,77894,842,0.010809562,0.025367808,0.014558246,2013,ORCL
2014-06-26T00:00:00Z,1263,2068,81123,805,0.009923203,0.025492154,0.015568951,2014,ORCL
2015-06-25T00:00:00Z,1343,2161,82896,818,0.009867786,0.026068809,0.016201023,2015,ORCL
2016-06-22T00:00:00Z,1517,2128,81833,611,0.007466426,0.026004179,0.018537754,2016,ORCL
2017-06-27T00:00:00Z,1431,2048,79469,617,0.007764034,0.025771055,0.018007022,2017,ORCL
2018-06-22T00:00:00Z,1358,1806,75318,448,0.005948113,0.023978332,0.018030219,2018,ORCL
2009-07-30T00:00:00Z,610,1105,46155,495,0.010724732,0.023941068,0.013216336,2009,MSFT
2010-07-30T00:00:00Z,608,1086,44132,478,0.010831143,0.024607994,0.013776851,2010,MSFT
2011-07-28T00:00:00Z,625,1074,44829,449,0.010015838,0.023957706,0.013941868,2011,MSFT
2012-07-26T00:00:00Z,671,1158,46530,487,0.010466366,0.02488717,0.014420804,2012,MSFT
2013-07-30T00:00:00Z,705,1147,47233,442,0.009357864,0.024283869,0.014926005,2013,MSFT
2014-07-31T00:00:00Z,787,1227,50791,440,0.008662952,0.024157823,0.015494871,2014,MSFT
2015-07-31T00:00:00Z,815,1244,50482,429,0.008498079,0.024642447,0.016144368,2015,MSFT
2016-07-28T00:00:00Z,859,1304,51858,445,0.008581125,0.02514559,0.016564464,2016,MSFT
2017-08-02T00:00:00Z,883,1308,50919,425,0.00834659,0.025687857,0.017341268,2017,MSFT
2018-08-03T00:00:00Z,915,1268,52095,353,0.006776082,0.024340148,0.017564066,2018,MSFT
2010-02-12T00:00:00Z,760,1196,54639,436,0.007979648,0.021889127,0.013909479,2010,HON
2011-02-11T00:00:00Z,806,1219,57687,413,0.007159325,0.021131277,0.013971952,2011,HON
2012-02-17T00:00:00Z,841,1286,58818,445,0.007565711,0.021864055,0.014298344,2012,HON
2013-02-15T00:00:00Z,840,1349,61487,509,0.008278173,0.021939597,0.013661424,2013,HON
2014-02-14T00:00:00Z,851,1371,61145,520,0.008504375,0.022422111,0.013917737,2014,HON
2015-02-13T00:00:00Z,534,871,38905,337,0.008662126,0.022387868,0.013725742,2015,HON
2016-02-12T00:00:00Z,553,868,38627,315,0.008154918,0.022471328,0.014316411,2016,HON
2017-02-10T00:00:00Z,594,986,42940,392,0.009129017,0.022962273,0.013833256,2017,HON
2018-02-09T00:00:00Z,654,1039,45706,385,0.008423402,0.022732245,0.014308843,2018,HON
2019-02-08T00:00:00Z,682,1128,48148,446,0.009263105,0.023427764,0.014164659,2019,HON
2010-02-25T00:00:00Z,78,199,11823,121,0.010234289,0.016831599,0.00659731,2010,T
2011-03-01T00:00:00Z,76,187,10906,111,0.010177884,0.017146525,0.006968641,2011,T
2012-02-24T00:00:00Z,72,200,11436,128,0.011192725,0.017488632,0.006295908,2012,T
2013-02-22T00:00:00Z,87,207,12637,120,0.009495925,0.01638047,0.006884545,2013,T
2014-02-21T00:00:00Z,87,201,12444,114,0.009161041,0.016152363,0.006991321,2014,T
2015-02-20T00:00:00Z,80,200,12444,120,0.009643202,0.016072003,0.006428801,2015,T
2016-02-18T00:00:00Z,85,242,13899,157,0.011295777,0.017411325,0.006115548,2016,T
2017-02-17T00:00:00Z,88,243,13878,155,0.011168756,0.017509728,0.006340971,2017,T
2018-02-20T00:00:00Z,88,246,13635,158,0.011587825,0.018041804,0.006453979,2018,T
2019-02-20T00:00:00Z,106,257,15559,151,0.009704994,0.016517771,0.006812777,2019,T
2011-08-25T00:00:00Z,583,890,41511,307,0.00739563,0.0214401,0.01404447,2011,ADM
2012-08-27T00:00:00Z,634,953,45333,319,0.007036816,0.021022213,0.013985397,2012,ADM
2014-02-26T00:00:00Z,758,1089,52579,331,0.006295289,0.020711691,0.014416402,2014,ADM
2015-02-20T00:00:00Z,806,1109,52506,303,0.005770769,0.021121396,0.015350627,2015,ADM
2016-02-19T00:00:00Z,877,1124,51155,247,0.004828463,0.021972437,0.017143974,2016,ADM
2017-02-17T00:00:00Z,877,1200,52037,323,0.006207122,0.023060515,0.016853393,2017,ADM
2018-02-16T00:00:00Z,888,1226,53159,338,0.006358284,0.023062887,0.016704603,2018,ADM
2019-02-19T00:00:00Z,902,1228,53757,326,0.006064327,0.022843537,0.01677921,2019,ADM
2010-02-26T00:00:00Z,502,593,31012,91,0.002934348,0.01912163,0.016187282,2010,FISV
2011-02-24T00:00:00Z,527,599,31941,72,0.002254156,0.018753326,0.01649917,2011,FISV
2012-02-24T00:00:00Z,508,601,31830,93,0.002921772,0.018881558,0.015959786,2012,FISV
2013-02-22T00:00:00Z,522,608,31743,86,0.002709259,0.019153829,0.01644457,2013,FISV
2014-02-20T00:00:00Z,546,645,33830,99,0.002926397,0.019065918,0.016139521,2014,FISV
2015-02-20T00:00:00Z,495,643,33398,148,0.004431403,0.01925265,0.014821247,2015,FISV
2016-02-19T00:00:00Z,468,655,31919,187,0.00585858,0.020520693,0.014662113,2016,FISV
2017-02-23T00:00:00Z,446,687,32135,241,0.007499611,0.021378559,0.013878948,2017,FISV
2018-02-22T00:00:00Z,457,762,34247,305,0.00890589,0.022250124,0.013344235,2018,FISV
2019-02-21T00:00:00Z,670,1069,47726,399,0.008360223,0.022398693,0.01403847,2019,FISV
2002-03-15T00:00:00Z,379,648,30149,269,0.008922352,0.02149325,0.012570898,2002,CF
2003-03-14T00:00:00Z,439,771,35324,332,0.009398709,0.02182652,0.012427811,2003,CF
2004-03-12T00:00:00Z,409,660,32611,251,0.007696789,0.02023857,0.01254178,2004,CF
2011-02-25T00:00:00Z,1237,1377,71788,140,0.001950187,0.019181479,0.017231292,2011,BKNG
2012-02-27T00:00:00Z,1108,1381,67847,273,0.004023759,0.020354621,0.016330862,2012,BKNG
2013-02-27T00:00:00Z,1226,1539,73171,313,0.004277651,0.021032923,0.016755272,2013,BKNG
2014-02-20T00:00:00Z,1283,1740,76893,457,0.005943324,0.022628848,0.016685524,2014,BKNG
2015-02-19T00:00:00Z,1358,1559,76513,201,0.002627005,0.020375622,0.017748618,2015,BKNG
2016-02-17T00:00:00Z,1376,1536,76715,160,0.002085642,0.02002216,0.017936518,2016,BKNG
2017-02-27T00:00:00Z,1248,1421,71977,173,0.002403546,0.019742418,0.017338872,2017,BKNG
2018-02-27T00:00:00Z,1287,1545,76902,258,0.003354919,0.020090505,0.016735586,2018,BKNG
2019-02-27T00:00:00Z,1216,1458,74443,242,0.003250809,0.019585455,0.016334645,2019,BKNG
2015-02-20T00:00:00Z,1271,1233,62738,-38,-0.000605694,0.019653161,0.020258854,2015,BNK
2016-02-19T00:00:00Z,1450,1541,77961,91,0.00116725,0.019766293,0.018599043,2016,BNK
2010-02-22T00:00:00Z,491,829,37750,338,0.008953642,0.021960265,0.013006623,2010,CERN
2011-02-16T00:00:00Z,524,917,37471,393,0.010488111,0.024472259,0.013984148,2011,CERN
2012-02-15T00:00:00Z,504,857,36650,353,0.009631651,0.023383356,0.013751705,2012,CERN
2013-02-08T00:00:00Z,553,868,37659,315,0.008364534,0.023048939,0.014684405,2013,CERN
2014-02-05T00:00:00Z,582,871,38431,289,0.007519971,0.022663995,0.015144024,2014,CERN
2015-02-11T00:00:00Z,604,880,39596,276,0.006970401,0.022224467,0.015254066,2015,CERN
2016-02-17T00:00:00Z,639,971,43287,332,0.007669739,0.022431677,0.014761938,2016,CERN
2017-02-10T00:00:00Z,655,1003,44449,348,0.007829198,0.022565187,0.01473599,2017,CERN
2018-02-12T00:00:00Z,682,1057,45188,375,0.008298663,0.023391166,0.015092502,2018,CERN
2019-02-08T00:00:00Z,716,1044,43962,328,0.007460989,0.023747782,0.016286793,2019,CERN
2010-02-26T00:00:00Z,1315,1984,84325,669,0.00793359,0.023528017,0.015594426,2010,KO
2011-02-28T00:00:00Z,1542,2398,104949,856,0.008156343,0.022849193,0.014692851,2011,KO
2012-02-23T00:00:00Z,1519,2455,105899,936,0.00883861,0.023182466,0.014343856,2012,KO
2013-02-27T00:00:00Z,1602,2555,111803,953,0.008523922,0.022852696,0.014328775,2013,KO
2014-02-27T00:00:00Z,1463,2339,98442,876,0.008898641,0.023760184,0.014861543,2014,KO
2015-02-25T00:00:00Z,1493,2238,97894,745,0.007610272,0.022861462,0.01525119,2015,KO
2016-02-25T00:00:00Z,1591,2299,105646,708,0.006701626,0.021761354,0.015059728,2016,KO
2017-02-24T00:00:00Z,1562,2292,106034,730,0.006884584,0.021615708,0.014731124,2017,KO
2018-02-23T00:00:00Z,1618,2319,104841,701,0.006686315,0.022119209,0.015432894,2018,KO
2019-02-21T00:00:00Z,1713,2398,106666,685,0.006421915,0.022481391,0.016059475,2019,KO
2011-02-24T00:00:00Z,1123,1452,67354,329,0.004884639,0.02155774,0.0166731,2011,CDN
2012-02-24T00:00:00Z,917,1211,57863,294,0.005080967,0.020928745,0.015847778,2012,CDN
2013-02-21T00:00:00Z,828,1224,56729,396,0.006980557,0.021576266,0.014595709,2013,CDN
2014-02-20T00:00:00Z,779,1170,53356,391,0.007328136,0.021928181,0.014600045,2014,CDN
2015-02-20T00:00:00Z,783,1127,51238,344,0.006713767,0.021995394,0.015281627,2015,CDN
2016-02-18T00:00:00Z,722,1029,46897,307,0.006546261,0.021941702,0.015395441,2016,CDN
2017-02-10T00:00:00Z,690,1066,48366,376,0.007774056,0.022040276,0.01426622,2017,CDN
2018-02-20T00:00:00Z,704,1071,50001,367,0.007339853,0.021419572,0.014079718,2018,CDN
2019-02-27T00:00:00Z,723,1052,48723,329,0.006752458,0.021591446,0.014838988,2019,CDN
2011-02-24T00:00:00Z,1123,1452,67354,329,0.004884639,0.02155774,0.0166731,2011,CDNS
2012-02-24T00:00:00Z,917,1211,57863,294,0.005080967,0.020928745,0.015847778,2012,CDNS
2013-02-21T00:00:00Z,828,1224,56729,396,0.006980557,0.021576266,0.014595709,2013,CDNS
2014-02-20T00:00:00Z,779,1170,53356,391,0.007328136,0.021928181,0.014600045,2014,CDNS
2015-02-20T00:00:00Z,783,1127,51238,344,0.006713767,0.021995394,0.015281627,2015,CDNS
2016-02-18T00:00:00Z,722,1029,46897,307,0.006546261,0.021941702,0.015395441,2016,CDNS
2017-02-10T00:00:00Z,690,1066,48366,376,0.007774056,0.022040276,0.01426622,2017,CDNS
2018-02-20T00:00:00Z,704,1071,50001,367,0.007339853,0.021419572,0.014079718,2018,CDNS
2019-02-27T00:00:00Z,723,1052,48723,329,0.006752458,0.021591446,0.014838988,2019,CDNS
2010-02-22T00:00:00Z,910,1357,77157,447,0.005793382,0.017587516,0.011794134,2010,ED
2011-02-22T00:00:00Z,886,1364,77830,478,0.006141591,0.017525376,0.011383785,2011,ED
2012-02-21T00:00:00Z,863,1326,75947,463,0.006096357,0.017459544,0.011363187,2012,ED
2013-02-21T00:00:00Z,883,1313,78343,430,0.005488684,0.016759634,0.01127095,2013,ED
2014-02-21T00:00:00Z,909,1369,80826,460,0.005691238,0.016937619,0.011246381,2014,ED
2015-02-19T00:00:00Z,910,1355,78307,445,0.005682761,0.017303689,0.011620928,2015,ED
2016-02-18T00:00:00Z,928,1351,75812,423,0.005579592,0.017820398,0.012240806,2016,ED
2017-02-16T00:00:00Z,931,1440,78287,509,0.006501718,0.018393858,0.01189214,2017,ED
2018-02-15T00:00:00Z,941,1483,82772,542,0.006548108,0.017916687,0.011368579,2018,ED
2019-02-21T00:00:00Z,1084,1587,91079,503,0.005522678,0.017424434,0.011901756,2019,ED
2010-02-22T00:00:00Z,491,829,37750,338,0.008953642,0.021960265,0.013006623,2010,CELG
2011-02-16T00:00:00Z,524,917,37471,393,0.010488111,0.024472259,0.013984148,2011,CELG
2012-02-15T00:00:00Z,504,857,36650,353,0.009631651,0.023383356,0.013751705,2012,CELG
2013-02-08T00:00:00Z,553,868,37659,315,0.008364534,0.023048939,0.014684405,2013,CELG
2014-02-05T00:00:00Z,582,871,38431,289,0.007519971,0.022663995,0.015144024,2014,CELG
2015-02-11T00:00:00Z,604,880,39596,276,0.006970401,0.022224467,0.015254066,2015,CELG
2016-02-17T00:00:00Z,639,971,43287,332,0.007669739,0.022431677,0.014761938,2016,CELG
2017-02-10T00:00:00Z,655,1003,44449,348,0.007829198,0.022565187,0.01473599,2017,CELG
2018-02-12T00:00:00Z,682,1057,45188,375,0.008298663,0.023391166,0.015092502,2018,CELG
2019-02-08T00:00:00Z,716,1044,43962,328,0.007460989,0.023747782,0.016286793,2019,CELG
2010-02-22T00:00:00Z,613,1208,45609,595,0.013045671,0.026486001,0.01344033,2010,XRAY
2011-02-18T00:00:00Z,646,1220,46119,574,0.012446063,0.026453306,0.014007242,2011,XRAY
2012-02-24T00:00:00Z,750,1315,52513,565,0.010759241,0.025041418,0.014282178,2012,XRAY
2013-02-20T00:00:00Z,679,1292,48860,613,0.01254605,0.026442898,0.013896848,2013,XRAY
2014-02-20T00:00:00Z,754,1363,51746,609,0.011769026,0.0263402,0.014571175,2014,XRAY
2015-02-20T00:00:00Z,773,1401,52749,628,0.011905439,0.026559745,0.014654306,2015,XRAY
2016-02-12T00:00:00Z,868,1524,58392,656,0.011234416,0.026099466,0.01486505,2016,XRAY
2017-03-01T00:00:00Z,954,1750,66642,796,0.011944419,0.026259716,0.014315297,2017,XRAY
2018-03-15T00:00:00Z,1105,1900,73092,795,0.010876703,0.025994637,0.015117934,2018,XRAY
2019-03-08T00:00:00Z,1090,1834,71453,744,0.010412439,0.025667222,0.015254783,2019,XRAY
2011-02-09T00:00:00Z,389,543,30526,154,0.00504488,0.017788115,0.012743235,2011,FAST
2012-02-09T00:00:00Z,382,556,30600,174,0.005686275,0.018169935,0.01248366,2012,FAST
2013-02-07T00:00:00Z,393,577,30613,184,0.006010518,0.018848202,0.012837683,2013,FAST
2014-02-06T00:00:00Z,401,593,31261,192,0.006141838,0.018969323,0.012827485,2014,FAST
2015-02-05T00:00:00Z,398,552,31100,154,0.004951768,0.017749196,0.012797428,2015,FAST
2016-02-05T00:00:00Z,452,578,33070,126,0.0038101,0.017478077,0.013667977,2016,FAST
2017-02-06T00:00:00Z,470,663,35438,193,0.005446131,0.018708731,0.013262599,2017,FAST
2018-02-05T00:00:00Z,475,655,34882,180,0.005160255,0.018777593,0.013617338,2018,FAST
2019-02-06T00:00:00Z,471,667,35085,196,0.005586433,0.019010973,0.01342454,2019,FAST
2010-02-23T00:00:00Z,1093,1721,72671,628,0.008641687,0.023682074,0.015040387,2010,DTE
2011-02-18T00:00:00Z,1081,1652,72772,571,0.007846424,0.022701039,0.014854614,2011,DTE
2012-02-16T00:00:00Z,971,1518,66491,547,0.008226677,0.022830157,0.01460348,2012,DTE
2013-02-20T00:00:00Z,887,1374,62106,487,0.007841432,0.022123466,0.014282034,2013,DTE
2014-02-14T00:00:00Z,924,1386,62394,462,0.007404558,0.022213674,0.014809116,2014,DTE
2015-02-13T00:00:00Z,877,1308,59329,431,0.007264576,0.022046554,0.014781978,2015,DTE
2016-02-10T00:00:00Z,979,1539,71491,560,0.007833154,0.021527185,0.013694031,2016,DTE
2017-02-09T00:00:00Z,1019,1588,74981,569,0.007588589,0.021178699,0.013590109,2017,DTE
2018-02-16T00:00:00Z,975,1530,74177,555,0.007482104,0.02062634,0.013144236,2018,DTE
2019-02-07T00:00:00Z,1003,1557,76469,554,0.007244766,0.020361192,0.013116426,2019,DTE
2010-03-01T00:00:00Z,1748,2009,92431,261,0.002823728,0.021735132,0.018911404,2010,SIVB
2011-02-25T00:00:00Z,1674,2045,91212,371,0.004067447,0.022420296,0.018352848,2011,SIVB
2012-02-28T00:00:00Z,1587,2009,86120,422,0.004900139,0.023327915,0.018427775,2012,SIVB
2013-02-27T00:00:00Z,1500,1977,83962,477,0.005681141,0.023546366,0.017865225,2013,SIVB
2014-02-27T00:00:00Z,1563,2068,86704,505,0.005824414,0.023851264,0.01802685,2014,SIVB
2015-02-26T00:00:00Z,1679,2105,89517,426,0.004758873,0.023515087,0.018756214,2015,SIVB
2016-02-26T00:00:00Z,1827,2255,95316,428,0.004490327,0.023658148,0.019167821,2016,SIVB
2017-02-28T00:00:00Z,1842,2225,95493,383,0.004010765,0.023300137,0.019289372,2017,SIVB
2018-02-28T00:00:00Z,1877,2233,97516,356,0.003650683,0.022898806,0.019248123,2018,SIVB
2019-02-28T00:00:00Z,1900,2265,100260,365,0.003640535,0.022591263,0.018950728,2019,SIVB
2011-02-25T00:00:00Z,709,1101,56819,392,0.006899101,0.019377321,0.01247822,2011,XOM
2012-02-24T00:00:00Z,693,1053,55047,360,0.006539866,0.019129108,0.012589242,2012,XOM
2013-02-27T00:00:00Z,659,1061,51801,402,0.007760468,0.02048223,0.012721762,2013,XOM
2014-02-26T00:00:00Z,637,1033,51493,396,0.007690366,0.020060979,0.012370613,2014,XOM
2015-02-25T00:00:00Z,665,1044,52361,379,0.007238212,0.019938504,0.012700292,2015,XOM
2016-02-24T00:00:00Z,689,1054,53956,365,0.006764771,0.019534435,0.012769664,2016,XOM
2017-02-22T00:00:00Z,698,1106,56321,408,0.00724419,0.019637435,0.012393246,2017,XOM
2018-02-28T00:00:00Z,740,1198,58392,458,0.00784354,0.020516509,0.012672969,2018,XOM
2019-02-27T00:00:00Z,738,1184,56677,446,0.007869153,0.020890308,0.013021155,2019,XOM
2006-03-15T00:00:00Z,1008,1065,73201,57,0.000778678,0.014548982,0.013770304,2006,MGG
2007-02-28T00:00:00Z,1220,1364,83025,144,0.001734417,0.016428787,0.014694369,2007,MGG
2008-02-28T00:00:00Z,1238,1355,79904,117,0.001464257,0.016957849,0.015493592,2008,MGG
2009-02-26T00:00:00Z,1156,1254,68969,98,0.001420928,0.018182082,0.016761154,2009,MGG
2010-02-26T00:00:00Z,915,1191,54141,276,0.0050978,0.021998116,0.016900316,2010,MGM
2011-02-28T00:00:00Z,965,1276,59324,311,0.005242398,0.021509001,0.016266604,2011,MGM
2012-02-29T00:00:00Z,1222,1819,73631,597,0.008107998,0.024704269,0.016596271,2012,MGM
2013-03-01T00:00:00Z,1237,1826,73669,589,0.007995222,0.024786545,0.016791323,2013,MGM
2014-03-03T00:00:00Z,1270,1822,73362,552,0.007524331,0.024835746,0.017311415,2014,MGM
2015-03-02T00:00:00Z,1125,1609,68449,484,0.007070958,0.023506552,0.016435594,2015,MGM
2016-02-29T00:00:00Z,1095,1649,68453,554,0.008093144,0.024089521,0.015996377,2016,MGM
2017-03-01T00:00:00Z,1143,1936,78201,793,0.010140535,0.024756717,0.014616181,2017,MGM
2018-03-01T00:00:00Z,1052,1700,69284,648,0.009352809,0.02453669,0.015183881,2018,MGM
2019-02-27T00:00:00Z,991,1545,64896,554,0.008536736,0.023807322,0.015270587,2019,MGM
2010-08-19T00:00:00Z,829,994,45244,165,0.003646892,0.021969764,0.018322872,2010,MXIM
2011-08-08T00:00:00Z,755,892,41594,137,0.003293744,0.021445401,0.018151656,2011,MXIM
2012-08-17T00:00:00Z,768,817,38583,49,0.001269989,0.021175129,0.01990514,2012,MXIM
2013-08-13T00:00:00Z,758,877,38506,119,0.003090427,0.022775671,0.019685244,2013,MXIM
2014-08-18T00:00:00Z,771,871,39986,100,0.002500875,0.021782624,0.019281749,2014,MXIM
2015-08-18T00:00:00Z,804,1020,43252,216,0.004993989,0.023582724,0.018588736,2015,MXIM
2016-08-12T00:00:00Z,826,989,43018,163,0.003789112,0.022990376,0.019201265,2016,MXIM
2017-08-11T00:00:00Z,777,992,42033,215,0.005115029,0.023600504,0.018485476,2017,MXIM
2018-08-17T00:00:00Z,793,954,41474,161,0.00388195,0.023002363,0.019120413,2018,MXIM
2010-08-19T00:00:00Z,829,994,45244,165,0.003646892,0.021969764,0.018322872,2010,
2011-08-08T00:00:00Z,755,892,41594,137,0.003293744,0.021445401,0.018151656,2011,
2012-08-17T00:00:00Z,768,817,38583,49,0.001269989,0.021175129,0.01990514,2012,
2013-08-13T00:00:00Z,758,877,38506,119,0.003090427,0.022775671,0.019685244,2013,
2014-08-18T00:00:00Z,771,871,39986,100,0.002500875,0.021782624,0.019281749,2014,
2015-08-18T00:00:00Z,804,1020,43252,216,0.004993989,0.023582724,0.018588736,2015,
2016-08-12T00:00:00Z,826,989,43018,163,0.003789112,0.022990376,0.019201265,2016,
2017-08-11T00:00:00Z,777,992,42033,215,0.005115029,0.023600504,0.018485476,2017,
2018-08-17T00:00:00Z,793,954,41474,161,0.00388195,0.023002363,0.019120413,2018,
2011-02-17T00:00:00Z,1474,1690,76281,216,0.002831636,0.022154927,0.019323292,2011,WM
2012-02-16T00:00:00Z,1594,1751,82269,157,0.001908374,0.021283837,0.019375463,2012,WM
2013-02-14T00:00:00Z,1661,1835,83751,174,0.002077587,0.021910186,0.019832599,2013,WM
2014-02-18T00:00:00Z,1757,1953,87464,196,0.002240922,0.022329187,0.020088265,2014,WM
2015-02-17T00:00:00Z,1664,1906,83912,242,0.002883974,0.022714272,0.019830298,2015,WM
2016-02-18T00:00:00Z,1604,1836,81109,232,0.002860348,0.022636206,0.019775857,2016,WM
2017-02-16T00:00:00Z,1576,1754,78627,178,0.002263853,0.022307859,0.020044005,2017,WM
2018-02-15T00:00:00Z,1475,1655,73059,180,0.002463762,0.022652924,0.020189162,2018,WM
2019-02-14T00:00:00Z,1472,1535,70282,63,0.000896389,0.021840585,0.020944196,2019,WM
2010-02-19T00:00:00Z,520,1148,46384,628,0.013539151,0.024749914,0.011210762,2010,GD
2011-02-18T00:00:00Z,520,1179,45599,659,0.014452071,0.02585583,0.011403759,2011,GD
2012-02-17T00:00:00Z,505,1098,45752,593,0.012961182,0.023998951,0.011037769,2012,GD
2013-02-08T00:00:00Z,560,1083,43222,523,0.012100319,0.025056684,0.012956365,2013,GD
2014-02-07T00:00:00Z,532,1034,40421,502,0.012419287,0.025580762,0.013161475,2014,GD
2015-02-09T00:00:00Z,494,1003,39388,509,0.012922718,0.025464609,0.012541891,2015,GD
2016-02-08T00:00:00Z,478,1066,41066,588,0.014318414,0.025958214,0.011639799,2016,GD
2017-02-06T00:00:00Z,487,1126,44132,639,0.014479289,0.025514366,0.011035077,2017,GD
2018-02-12T00:00:00Z,498,1165,45853,667,0.014546486,0.02540728,0.010860794,2018,GD
2019-02-13T00:00:00Z,535,1286,49392,751,0.015204891,0.026036605,0.010831714,2019,GD
2010-02-19T00:00:00Z,1502,1805,88827,303,0.003411125,0.020320398,0.016909273,2010,GE
2011-02-25T00:00:00Z,1779,1972,102399,193,0.001884784,0.019258001,0.017373217,2011,GE
2012-02-24T00:00:00Z,1767,1942,100737,175,0.001737197,0.019277922,0.017540725,2012,GE
2013-02-26T00:00:00Z,1827,1953,102065,126,0.001234507,0.019134865,0.017900358,2013,GE
2014-02-27T00:00:00Z,1835,1957,102901,122,0.001185606,0.01901828,0.017832674,2014,GE
2015-02-27T00:00:00Z,1740,1934,97668,194,0.001986321,0.019801777,0.017815456,2015,GE
2016-02-26T00:00:00Z,1706,1938,94991,232,0.002442337,0.020401933,0.017959596,2016,GE
2017-02-24T00:00:00Z,1679,2073,100690,394,0.003913,0.020587943,0.016674943,2017,GE
2018-02-23T00:00:00Z,1685,2262,106201,577,0.005433094,0.021299234,0.015866141,2018,GE
2019-02-26T00:00:00Z,1738,2404,106003,666,0.006282841,0.022678603,0.016395762,2019,GE
2012-02-24T00:00:00Z,861,1217,52090,356,0.006834325,0.023363409,0.016529084,2012,LH
2013-02-26T00:00:00Z,841,1225,53624,384,0.007160973,0.022844249,0.015683276,2013,LH
2014-02-25T00:00:00Z,946,1257,56682,311,0.005486751,0.022176352,0.016689602,2014,LH
2015-02-26T00:00:00Z,1216,1589,72220,373,0.005164774,0.022002215,0.016837441,2015,LH
2016-02-29T00:00:00Z,1372,1675,82068,303,0.00369206,0.020409904,0.016717844,2016,LH
2017-02-27T00:00:00Z,1362,1722,81720,360,0.004405286,0.021071953,0.016666667,2017,LH
2018-02-27T00:00:00Z,1457,1918,87884,461,0.005245551,0.021824223,0.016578672,2018,LH
2019-02-28T00:00:00Z,1573,1975,92390,402,0.00435112,0.021376772,0.017025652,2019,LH
2010-03-01T00:00:00Z,1169,1727,75353,558,0.007405146,0.022918796,0.015513649,2010,PBCT
2011-03-01T00:00:00Z,1456,1949,85697,493,0.005752827,0.02274292,0.016990093,2011,PBCT
2012-02-29T00:00:00Z,1610,1984,91769,374,0.00407545,0.021619501,0.017544051,2012,PBCT
2013-03-01T00:00:00Z,1697,2019,94418,322,0.003410367,0.021383634,0.017973268,2013,PBCT
2014-03-03T00:00:00Z,1551,1960,90239,409,0.004532408,0.021720099,0.01718769,2014,PBCT
2015-03-02T00:00:00Z,1469,1947,87024,478,0.005492738,0.022373138,0.016880401,2015,PBCT
2016-02-29T00:00:00Z,1420,1820,86129,400,0.004644196,0.021131094,0.016486898,2016,PBCT
2017-03-01T00:00:00Z,1451,1870,88217,419,0.004749651,0.021197728,0.016448077,2017,PBCT
2018-03-01T00:00:00Z,1484,2004,92240,520,0.005637467,0.021725932,0.016088465,2018,PBCT
2019-03-01T00:00:00Z,1582,2006,93157,424,0.004551456,0.02153354,0.016982084,2019,PBCT
2006-03-28T00:00:00Z,1511,1968,88756,457,0.005148948,0.022173149,0.017024201,2006,GM
2007-03-15T00:00:00Z,2436,3371,143720,935,0.006505706,0.02345533,0.016949624,2007,GM
2008-02-28T00:00:00Z,2502,3712,150643,1210,0.008032235,0.024641039,0.016608804,2008,GM
2009-03-05T00:00:00Z,3930,6119,241427,2189,0.009066923,0.025345135,0.016278212,2009,GM
2013-05-21T00:00:00Z,456,2018,42467,1562,0.036781501,0.04751925,0.010737749,2013,GM
2014-05-22T00:00:00Z,451,2178,49677,1727,0.034764579,0.043843227,0.009078648,2014,GM
2015-05-22T00:00:00Z,569,2271,53396,1702,0.031875047,0.042531276,0.010656229,2015,GM
2016-05-25T00:00:00Z,582,2324,52134,1742,0.033413895,0.044577435,0.01116354,2016,GM
2017-05-25T00:00:00Z,686,2435,54757,1749,0.031941122,0.0444692,0.012528079,2017,GM
2018-06-11T00:00:00Z,687,2502,56489,1815,0.032130149,0.044291809,0.01216166,2018,GM
2011-03-18T00:00:00Z,1165,1586,83229,421,0.005058333,0.019055858,0.013997525,2011,LYB
2012-02-29T00:00:00Z,1208,1725,87179,517,0.005930327,0.019786875,0.013856548,2012,LYB
2013-02-12T00:00:00Z,979,1283,64382,304,0.004721817,0.01992793,0.015206114,2013,LYB
2014-02-20T00:00:00Z,973,1279,62492,306,0.004896627,0.02046662,0.015569993,2014,LYB
2015-02-17T00:00:00Z,1079,1435,67170,356,0.005299985,0.021363704,0.016063719,2015,LYB
2016-02-16T00:00:00Z,1215,1509,71184,294,0.004130142,0.021198584,0.017068442,2016,LYB
2017-02-17T00:00:00Z,1133,1461,66369,328,0.004942066,0.022013289,0.017071223,2017,LYB
2018-02-22T00:00:00Z,1092,1482,65606,390,0.005944578,0.022589397,0.016644819,2018,LYB
2019-02-21T00:00:00Z,1030,1566,68053,536,0.007876214,0.023011476,0.015135262,2019,LYB
2011-03-25T00:00:00Z,804,997,52280,193,0.00369166,0.01907039,0.01537873,2011,FLT
2012-02-29T00:00:00Z,879,1233,60040,354,0.005896069,0.020536309,0.01464024,2012,FLT
2013-03-01T00:00:00Z,859,1172,59988,313,0.00521771,0.019537241,0.014319531,2013,FLT
2014-03-03T00:00:00Z,865,1118,61103,253,0.00414055,0.018296974,0.014156424,2014,FLT
2015-03-02T00:00:00Z,1028,1258,66305,230,0.003468818,0.018972928,0.01550411,2015,FLT
2016-02-29T00:00:00Z,1037,1261,66534,224,0.0033667,0.018952716,0.015586016,2016,FLT
2017-03-01T00:00:00Z,1029,1227,66499,198,0.002977488,0.018451405,0.015473917,2017,FLT
2018-03-01T00:00:00Z,1275,1459,76506,184,0.00240504,0.0190704,0.01666536,2018,FLT
2019-03-01T00:00:00Z,1343,1599,82752,256,0.003093581,0.019322796,0.016229215,2019,FLT
2010-02-23T00:00:00Z,184,358,13310,174,0.013072878,0.02689707,0.013824192,2010,IBM
2011-02-22T00:00:00Z,196,386,13872,190,0.013696655,0.027825836,0.014129181,2011,IBM
2012-02-28T00:00:00Z,213,430,14275,217,0.015201401,0.030122592,0.014921191,2012,IBM
2013-02-26T00:00:00Z,223,469,15328,246,0.016049061,0.030597599,0.014548539,2013,IBM
2014-02-25T00:00:00Z,263,475,16039,212,0.013217782,0.029615313,0.016397531,2014,IBM
2015-02-24T00:00:00Z,280,460,16887,180,0.010659087,0.027239889,0.016580802,2015,IBM
2016-02-23T00:00:00Z,292,426,16773,134,0.00798903,0.025397961,0.017408931,2016,IBM
2017-02-28T00:00:00Z,297,403,16444,106,0.00644612,0.024507419,0.018061299,2017,IBM
2018-02-27T00:00:00Z,306,422,16799,116,0.006905173,0.025120543,0.01821537,2018,IBM
2019-02-26T00:00:00Z,303,395,16594,92,0.005544173,0.023803785,0.018259612,2019,IBM
2011-03-01T00:00:00Z,1061,1638,75867,577,0.007605415,0.021590415,0.013985,2011,NLSN
2012-02-22T00:00:00Z,990,1474,69472,484,0.006966836,0.021217181,0.014250345,2012,NLSN
2013-02-22T00:00:00Z,815,1386,66906,571,0.008534362,0.020715631,0.012181269,2013,NLSN
2014-02-21T00:00:00Z,839,1369,66109,530,0.008017063,0.020708224,0.012691162,2014,NLSN
2015-02-20T00:00:00Z,915,1545,72085,630,0.008739682,0.02143303,0.012693348,2015,NLSN
2016-02-19T00:00:00Z,964,1611,72474,647,0.008927339,0.022228661,0.013301322,2016,NLSN
2017-02-17T00:00:00Z,924,1650,70366,726,0.010317483,0.023448825,0.013131342,2017,NLSN
2018-02-08T00:00:00Z,1076,1824,75272,748,0.009937294,0.024232118,0.014294824,2018,NLSN
2019-02-28T00:00:00Z,1202,1940,80202,738,0.009201766,0.024188923,0.014987157,2019,NLSN
2011-02-24T00:00:00Z,975,1499,60944,524,0.008598057,0.024596351,0.015998294,2011,ITT
2012-02-29T00:00:00Z,1335,1851,74575,516,0.006919209,0.02482065,0.017901442,2012,ITT
2013-02-27T00:00:00Z,1413,1882,74626,469,0.006284673,0.025219093,0.01893442,2013,ITT
2014-02-21T00:00:00Z,1290,1890,71724,600,0.008365401,0.026351012,0.017985612,2014,ITT
2015-02-20T00:00:00Z,1187,1751,68141,564,0.008276955,0.025696717,0.017419762,2015,ITT
2016-02-22T00:00:00Z,1134,1470,60068,336,0.005593661,0.024472265,0.018878604,2016,ITT
2017-02-17T00:00:00Z,1113,1439,61360,326,0.005312907,0.02345176,0.018138853,2017,ITT
2018-02-16T00:00:00Z,1067,1422,60534,355,0.005864473,0.023490931,0.017626458,2018,ITT
2019-02-22T00:00:00Z,1074,1446,61840,372,0.006015524,0.023382924,0.0173674,2019,ITT
2010-03-01T00:00:00Z,1202,1096,60300,-106,-0.001757877,0.018175788,0.019933665,2010,HCA
2011-02-17T00:00:00Z,1437,1510,76954,73,0.000948619,0.019622112,0.018673493,2011,HCA
2012-02-24T00:00:00Z,1484,1588,79823,104,0.001302883,0.019894016,0.018591133,2012,HCA
2013-02-27T00:00:00Z,1491,1652,81931,161,0.001965068,0.020163308,0.01819824,2013,HCA
2014-02-26T00:00:00Z,1457,1515,77579,58,0.000747625,0.019528481,0.018780856,2014,HCA
2015-02-26T00:00:00Z,1541,1521,77999,-20,-0.000256414,0.01950025,0.019756664,2015,HCA
2016-02-26T00:00:00Z,1567,1490,76050,-77,-0.001012492,0.019592373,0.020604865,2016,HCA
2017-02-22T00:00:00Z,1464,1399,70607,-65,-0.000920589,0.019813899,0.020734488,2017,HCA
2018-02-23T00:00:00Z,1455,1371,70255,-84,-0.001195644,0.019514625,0.02071027,2018,HCA
2019-02-21T00:00:00Z,1369,1413,71593,44,0.000614585,0.019736566,0.019121981,2019,HCA
2012-03-29T00:00:00Z,1252,1550,68532,298,0.004348334,0.022617172,0.018268838,2012,HII
2013-02-27T00:00:00Z,1286,1642,70006,356,0.005085278,0.023455132,0.018369854,2013,HII
2014-02-27T00:00:00Z,1231,1674,68991,443,0.006421127,0.024264034,0.017842907,2014,HII
2015-02-19T00:00:00Z,1254,1697,70017,443,0.006327035,0.024236971,0.017909936,2015,HII
2016-02-18T00:00:00Z,1230,1688,68603,458,0.006676093,0.024605338,0.017929245,2016,HII
2017-02-16T00:00:00Z,1203,1721,67978,518,0.007620112,0.025317014,0.017696902,2017,HII
2018-02-15T00:00:00Z,1166,1673,66948,507,0.007573042,0.024989544,0.017416502,2018,HII
2019-02-14T00:00:00Z,1082,1677,68329,595,0.008707869,0.02454302,0.015835151,2019,HII
2010-02-12T00:00:00Z,1260,1083,63393,-177,-0.002792106,0.017083905,0.019876012,2010,KSU
2011-02-09T00:00:00Z,1348,1122,65283,-226,-0.003461851,0.01718671,0.020648561,2011,KSU
2012-02-08T00:00:00Z,1281,1130,64267,-151,-0.002349573,0.017582896,0.019932469,2012,KSU
2013-02-04T00:00:00Z,1237,1079,61397,-158,-0.002573416,0.017574149,0.020147564,2013,KSU
2014-01-31T00:00:00Z,1314,1122,63402,-192,-0.003028296,0.017696603,0.020724898,2014,KSU
2015-01-30T00:00:00Z,1195,938,55988,-257,-0.004590269,0.01675359,0.021343859,2015,KSU
2016-01-29T00:00:00Z,1127,860,53217,-267,-0.005017194,0.01616025,0.021177443,2016,KSU
2017-01-27T00:00:00Z,1027,801,50369,-226,-0.004486887,0.015902639,0.020389525,2017,KSU
2018-01-26T00:00:00Z,997,870,50610,-127,-0.002509385,0.017190279,0.019699664,2018,KSU
2019-01-25T00:00:00Z,1020,939,50502,-81,-0.001603897,0.018593323,0.02019722,2019,KSU
2012-02-29T00:00:00Z,1164,1461,62968,297,0.004716681,0.023202261,0.01848558,2012,MPC
2013-02-28T00:00:00Z,1193,1483,67888,290,0.004271742,0.021844803,0.017573062,2013,MPC
2014-02-28T00:00:00Z,1226,1575,71434,349,0.004885629,0.022048324,0.017162696,2014,MPC
2015-02-27T00:00:00Z,1277,1689,73899,412,0.005575177,0.022855519,0.017280342,2015,MPC
2016-02-26T00:00:00Z,1508,1994,87500,486,0.005554286,0.022788571,0.017234286,2016,MPC
2017-02-24T00:00:00Z,1508,2140,91961,632,0.006872479,0.023270734,0.016398256,2017,MPC
2018-02-28T00:00:00Z,1422,2056,87502,634,0.007245549,0.023496606,0.016251057,2018,MPC
2019-02-28T00:00:00Z,1538,2019,89438,481,0.005378027,0.022574297,0.01719627,2019,MPC
2012-02-22T00:00:00Z,711,1414,45073,703,0.015596921,0.031371331,0.01577441,2012,FBHS
2013-02-27T00:00:00Z,744,1338,45921,594,0.012935258,0.029136996,0.016201738,2013,FBHS
2014-02-26T00:00:00Z,690,1427,46444,737,0.015868573,0.030725174,0.014856601,2014,FBHS
2015-02-25T00:00:00Z,698,1330,42319,632,0.01493419,0.031427964,0.016493773,2015,FBHS
2016-02-25T00:00:00Z,741,1373,44273,632,0.014275066,0.031012129,0.016737063,2016,FBHS
2017-02-28T00:00:00Z,751,1442,46262,691,0.014936665,0.031170291,0.016233626,2017,FBHS
2018-02-28T00:00:00Z,743,1399,46096,656,0.01423117,0.030349705,0.016118535,2018,FBHS
2019-02-25T00:00:00Z,711,1388,48183,677,0.014050599,0.028806841,0.014756242,2019,FBHS
2011-02-24T00:00:00Z,975,1499,60944,524,0.008598057,0.024596351,0.015998294,2011,XYL
2012-02-29T00:00:00Z,1335,1851,74575,516,0.006919209,0.02482065,0.017901442,2012,XYL
2013-02-27T00:00:00Z,1413,1882,74626,469,0.006284673,0.025219093,0.01893442,2013,XYL
2014-02-21T00:00:00Z,1290,1890,71724,600,0.008365401,0.026351012,0.017985612,2014,XYL
2015-02-20T00:00:00Z,1187,1751,68141,564,0.008276955,0.025696717,0.017419762,2015,XYL
2016-02-22T00:00:00Z,1134,1470,60068,336,0.005593661,0.024472265,0.018878604,2016,XYL
2017-02-17T00:00:00Z,1113,1439,61360,326,0.005312907,0.02345176,0.018138853,2017,XYL
2018-02-16T00:00:00Z,1067,1422,60534,355,0.005864473,0.023490931,0.017626458,2018,XYL
2019-02-22T00:00:00Z,1074,1446,61840,372,0.006015524,0.023382924,0.0173674,2019,XYL
2012-02-17T00:00:00Z,1229,2010,81342,781,0.009601436,0.024710482,0.015109046,2012,DLPH
2013-02-11T00:00:00Z,947,1839,69128,892,0.012903599,0.026602824,0.013699225,2013,DLPH
2014-02-10T00:00:00Z,915,1712,67981,797,0.011723864,0.025183507,0.013459643,2014,DLPH
2015-02-09T00:00:00Z,958,1697,70275,739,0.010515831,0.02414799,0.013632159,2015,DLPH
2016-02-08T00:00:00Z,1197,1891,81842,694,0.008479754,0.023105496,0.014625742,2016,DLPH
2017-02-06T00:00:00Z,1209,2075,87569,866,0.009889344,0.0236956,0.013806256,2017,DLPH
2018-02-05T00:00:00Z,1225,2234,90149,1009,0.011192581,0.024781196,0.013588614,2018,DLPH
2019-02-04T00:00:00Z,1179,2130,85003,951,0.01118784,0.025057939,0.013870099,2019,DLPH
2012-02-17T00:00:00Z,1229,2010,81342,781,0.009601436,0.024710482,0.015109046,2012,APTV
2013-02-11T00:00:00Z,947,1839,69128,892,0.012903599,0.026602824,0.013699225,2013,APTV
2014-02-10T00:00:00Z,915,1712,67981,797,0.011723864,0.025183507,0.013459643,2014,APTV
2015-02-09T00:00:00Z,958,1697,70275,739,0.010515831,0.02414799,0.013632159,2015,APTV
2016-02-08T00:00:00Z,1197,1891,81842,694,0.008479754,0.023105496,0.014625742,2016,APTV
2017-02-06T00:00:00Z,1209,2075,87569,866,0.009889344,0.0236956,0.013806256,2017,APTV
2018-02-05T00:00:00Z,1225,2234,90149,1009,0.011192581,0.024781196,0.013588614,2018,APTV
2019-02-04T00:00:00Z,1179,2130,85003,951,0.01118784,0.025057939,0.013870099,2019,APTV
2013-02-22T00:00:00Z,968,1436,63070,468,0.007420327,0.022768353,0.015348026,2013,PSX
2014-02-21T00:00:00Z,1318,1839,83444,521,0.006243708,0.022038733,0.015795024,2014,PSX
2015-02-20T00:00:00Z,1014,1433,63064,419,0.006644044,0.022722948,0.016078904,2015,PSX
2016-02-19T00:00:00Z,1010,1430,61743,420,0.006802391,0.02316052,0.01635813,2016,PSX
2017-02-17T00:00:00Z,1037,1466,63499,429,0.006756012,0.023086978,0.016330966,2017,PSX
2018-02-23T00:00:00Z,1031,1440,63347,409,0.006456501,0.022731937,0.016275435,2018,PSX
2019-02-22T00:00:00Z,975,1388,61147,413,0.006754215,0.022699397,0.015945181,2019,PSX
2013-02-01T00:00:00Z,735,1162,53217,427,0.008023752,0.021835128,0.013811376,2013,FB
2014-01-31T00:00:00Z,671,1080,49631,409,0.008240817,0.021760593,0.013519776,2014,FB
2015-01-29T00:00:00Z,672,963,45603,291,0.006381159,0.021117032,0.014735873,2015,FB
2016-01-28T00:00:00Z,698,939,45582,241,0.005287175,0.020600237,0.015313062,2016,FB
2017-02-03T00:00:00Z,790,1051,49395,261,0.005283936,0.021277457,0.015993522,2017,FB
2018-02-01T00:00:00Z,789,1045,48222,256,0.00530878,0.021670607,0.016361827,2018,FB
2019-01-31T00:00:00Z,859,1008,49381,149,0.003017355,0.020412709,0.017395354,2019,FB
2012-02-21T00:00:00Z,645,1037,41925,392,0.00935003,0.024734645,0.015384615,2012,PNR
2013-02-26T00:00:00Z,1018,1413,62482,395,0.006321821,0.022614513,0.016292692,2013,PNR
2014-02-25T00:00:00Z,1037,1394,63609,357,0.005612413,0.021915138,0.016302724,2014,PNR
2015-02-24T00:00:00Z,1059,1206,58233,147,0.002524342,0.020709907,0.018185565,2015,PNR
2016-02-26T00:00:00Z,1057,1263,59217,206,0.003478731,0.021328335,0.017849604,2016,PNR
2017-02-21T00:00:00Z,948,1102,53405,154,0.002883625,0.020634772,0.017751147,2017,PNR
2018-02-27T00:00:00Z,910,1084,49897,174,0.003487184,0.021724753,0.018237569,2018,PNR
2019-02-19T00:00:00Z,876,1064,48315,188,0.003891131,0.022022146,0.018131015,2019,PNR
2013-03-01T00:00:00Z,1150,1227,69362,77,0.001110118,0.017689801,0.016579683,2013,FANG
2014-02-19T00:00:00Z,1325,1341,75106,16,0.000213032,0.017854765,0.017641733,2014,FANG
2015-02-20T00:00:00Z,1486,1437,80441,-49,-0.000609142,0.017864025,0.018473167,2015,FANG
2016-02-19T00:00:00Z,1498,1387,80378,-111,-0.001380975,0.017255966,0.01863694,2016,FANG
2017-02-15T00:00:00Z,1675,1588,87605,-87,-0.000993094,0.018126819,0.019119913,2017,FANG
2018-02-15T00:00:00Z,1581,1454,83018,-127,-0.001529789,0.017514274,0.019044063,2018,FANG
2019-02-25T00:00:00Z,1673,1739,95415,66,0.000691715,0.018225646,0.017533931,2019,FANG
2011-02-24T00:00:00Z,975,1499,60944,524,0.008598057,0.024596351,0.015998294,2011,ABBV
2012-02-29T00:00:00Z,1335,1851,74575,516,0.006919209,0.02482065,0.017901442,2012,ABBV
2013-02-27T00:00:00Z,1413,1882,74626,469,0.006284673,0.025219093,0.01893442,2013,ABBV
2014-02-21T00:00:00Z,1290,1890,71724,600,0.008365401,0.026351012,0.017985612,2014,ABBV
2015-02-20T00:00:00Z,1187,1751,68141,564,0.008276955,0.025696717,0.017419762,2015,ABBV
2016-02-22T00:00:00Z,1134,1470,60068,336,0.005593661,0.024472265,0.018878604,2016,ABBV
2017-02-17T00:00:00Z,1113,1439,61360,326,0.005312907,0.02345176,0.018138853,2017,ABBV
2018-02-16T00:00:00Z,1067,1422,60534,355,0.005864473,0.023490931,0.017626458,2018,ABBV
2019-02-22T00:00:00Z,1074,1446,61840,372,0.006015524,0.023382924,0.0173674,2019,ABBV
2013-02-20T00:00:00Z,896,1833,82160,937,0.011404576,0.022310127,0.01090555,2013,NCLH
2014-02-21T00:00:00Z,794,1280,58803,486,0.008264884,0.021767597,0.013502712,2014,NCLH
2015-02-27T00:00:00Z,916,1596,64195,680,0.010592725,0.024861749,0.014269024,2015,NCLH
2016-02-29T00:00:00Z,914,1348,58295,434,0.007444892,0.023123767,0.015678875,2016,NCLH
2017-02-27T00:00:00Z,952,1469,59745,517,0.008653444,0.024587832,0.015934388,2017,NCLH
2018-02-27T00:00:00Z,901,1303,56186,402,0.007154807,0.02319083,0.016036023,2018,NCLH
2019-02-27T00:00:00Z,943,1199,56266,256,0.004549817,0.021309494,0.016759677,2019,NCLH
2011-02-24T00:00:00Z,975,1499,60944,524,0.008598057,0.024596351,0.015998294,2011,ZTS
2012-02-29T00:00:00Z,1335,1851,74575,516,0.006919209,0.02482065,0.017901442,2012,ZTS
2013-02-27T00:00:00Z,1413,1882,74626,469,0.006284673,0.025219093,0.01893442,2013,ZTS
2014-02-21T00:00:00Z,1290,1890,71724,600,0.008365401,0.026351012,0.017985612,2014,ZTS
2015-02-20T00:00:00Z,1187,1751,68141,564,0.008276955,0.025696717,0.017419762,2015,ZTS
2016-02-22T00:00:00Z,1134,1470,60068,336,0.005593661,0.024472265,0.018878604,2016,ZTS
2017-02-17T00:00:00Z,1113,1439,61360,326,0.005312907,0.02345176,0.018138853,2017,ZTS
2018-02-16T00:00:00Z,1067,1422,60534,355,0.005864473,0.023490931,0.017626458,2018,ZTS
2019-02-22T00:00:00Z,1074,1446,61840,372,0.006015524,0.023382924,0.0173674,2019,ZTS
2010-02-22T00:00:00Z,758,1271,51500,513,0.009961165,0.024679612,0.014718447,2010,PEP
2011-02-18T00:00:00Z,740,1331,56294,591,0.010498455,0.023643728,0.013145273,2011,PEP
2012-02-27T00:00:00Z,791,1302,57237,511,0.008927791,0.022747523,0.013819732,2012,PEP
2013-02-21T00:00:00Z,841,1339,58797,498,0.00846982,0.022773271,0.014303451,2013,PEP
2014-02-14T00:00:00Z,1020,1350,61874,330,0.00533342,0.021818534,0.016485115,2014,PEP
2015-02-12T00:00:00Z,997,1369,63200,372,0.005886076,0.021661392,0.015775316,2015,PEP
2016-02-11T00:00:00Z,980,1383,64415,403,0.006256307,0.021470154,0.015213848,2016,PEP
2017-02-15T00:00:00Z,1066,1571,67823,505,0.007445852,0.023163234,0.015717382,2017,PEP
2018-02-13T00:00:00Z,1119,1608,70371,489,0.006948885,0.022850322,0.015901437,2018,PEP
2019-02-15T00:00:00Z,1144,1678,68984,534,0.007740925,0.024324481,0.016583556,2019,PEP
2014-02-26T00:00:00Z,1363,1574,77759,211,0.002713512,0.02024203,0.017528518,2014,MO
2015-02-25T00:00:00Z,1400,1522,74812,122,0.001630754,0.02034433,0.018713575,2015,MO
2016-02-25T00:00:00Z,1567,1698,80697,131,0.001623357,0.021041674,0.019418318,2016,MO
2017-02-27T00:00:00Z,1631,1745,83798,114,0.001360414,0.020823886,0.019463472,2017,MO
2018-02-27T00:00:00Z,1461,1674,77852,213,0.002735961,0.021502338,0.018766377,2018,MO
2019-02-26T00:00:00Z,1039,1435,69920,396,0.005663616,0.020523455,0.01485984,2019,MO
2011-02-24T00:00:00Z,975,1499,60944,524,0.008598057,0.024596351,0.015998294,2011,Q
2012-02-29T00:00:00Z,1335,1851,74575,516,0.006919209,0.02482065,0.017901442,2012,Q
2013-02-27T00:00:00Z,1413,1882,74626,469,0.006284673,0.025219093,0.01893442,2013,Q
2014-02-21T00:00:00Z,1290,1890,71724,600,0.008365401,0.026351012,0.017985612,2014,Q
2015-02-20T00:00:00Z,1187,1751,68141,564,0.008276955,0.025696717,0.017419762,2015,Q
2016-02-22T00:00:00Z,1134,1470,60068,336,0.005593661,0.024472265,0.018878604,2016,Q
2017-02-17T00:00:00Z,1113,1439,61360,326,0.005312907,0.02345176,0.018138853,2017,Q
2018-02-16T00:00:00Z,1067,1422,60534,355,0.005864473,0.023490931,0.017626458,2018,Q
2019-02-22T00:00:00Z,1074,1446,61840,372,0.006015524,0.023382924,0.0173674,2019,Q
2011-02-24T00:00:00Z,975,1499,60944,524,0.008598057,0.024596351,0.015998294,2011,IQV
2012-02-29T00:00:00Z,1335,1851,74575,516,0.006919209,0.02482065,0.017901442,2012,IQV
2013-02-27T00:00:00Z,1413,1882,74626,469,0.006284673,0.025219093,0.01893442,2013,IQV
2014-02-21T00:00:00Z,1290,1890,71724,600,0.008365401,0.026351012,0.017985612,2014,IQV
2015-02-20T00:00:00Z,1187,1751,68141,564,0.008276955,0.025696717,0.017419762,2015,IQV
2016-02-22T00:00:00Z,1134,1470,60068,336,0.005593661,0.024472265,0.018878604,2016,IQV
2017-02-17T00:00:00Z,1113,1439,61360,326,0.005312907,0.02345176,0.018138853,2017,IQV
2018-02-16T00:00:00Z,1067,1422,60534,355,0.005864473,0.023490931,0.017626458,2018,IQV
2019-02-22T00:00:00Z,1074,1446,61840,372,0.006015524,0.023382924,0.0173674,2019,IQV
2011-02-23T00:00:00Z,1030,1618,81098,588,0.007250487,0.01995117,0.012700683,2011,COP
2012-02-21T00:00:00Z,1002,1564,81030,562,0.006935703,0.019301493,0.01236579,2012,COP
2013-02-19T00:00:00Z,1079,1421,76439,342,0.004474156,0.018589987,0.014115831,2013,COP
2014-02-25T00:00:00Z,1071,1462,77564,391,0.005040998,0.018848951,0.013807952,2014,COP
2015-02-24T00:00:00Z,1136,1528,79174,392,0.00495112,0.019299265,0.014348145,2015,COP
2016-02-23T00:00:00Z,1203,1564,80355,361,0.004492564,0.01946363,0.014971066,2016,COP
2017-02-21T00:00:00Z,1239,1602,82235,363,0.004414179,0.019480756,0.015066577,2017,COP
2018-02-20T00:00:00Z,1202,1671,83145,469,0.005640748,0.02009742,0.014456672,2018,COP
2019-02-19T00:00:00Z,1278,1748,90142,470,0.005213996,0.019391627,0.014177631,2019,COP
2011-02-24T00:00:00Z,975,1499,60944,524,0.008598057,0.024596351,0.015998294,2011,PVH
2012-02-29T00:00:00Z,1335,1851,74575,516,0.006919209,0.02482065,0.017901442,2012,PVH
2013-02-27T00:00:00Z,1413,1882,74626,469,0.006284673,0.025219093,0.01893442,2013,PVH
2014-02-21T00:00:00Z,1290,1890,71724,600,0.008365401,0.026351012,0.017985612,2014,PVH
2015-02-20T00:00:00Z,1187,1751,68141,564,0.008276955,0.025696717,0.017419762,2015,PVH
2016-02-22T00:00:00Z,1134,1470,60068,336,0.005593661,0.024472265,0.018878604,2016,PVH
2017-02-17T00:00:00Z,1113,1439,61360,326,0.005312907,0.02345176,0.018138853,2017,PVH
2018-02-16T00:00:00Z,1067,1422,60534,355,0.005864473,0.023490931,0.017626458,2018,PVH
2019-02-22T00:00:00Z,1074,1446,61840,372,0.006015524,0.023382924,0.0173674,2019,PVH
2013-09-20T00:00:00Z,843,2176,93567,1333,0.014246476,0.023256063,0.009009587,2013,NWSA
2014-08-14T00:00:00Z,826,1891,83936,1065,0.012688239,0.02252907,0.009840831,2014,NWSA
2015-08-13T00:00:00Z,911,1961,84891,1050,0.012368802,0.023100211,0.010731409,2015,NWSA
2016-08-12T00:00:00Z,954,1829,78404,875,0.011160145,0.023327891,0.012167747,2016,NWSA
2017-08-14T00:00:00Z,1039,1904,82216,865,0.010521066,0.023158509,0.012637443,2017,NWSA
2018-08-15T00:00:00Z,1183,2024,89986,841,0.009345898,0.022492388,0.013146489,2018,NWSA
2013-09-20T00:00:00Z,843,2176,93567,1333,0.014246476,0.023256063,0.009009587,2013,NWS
2014-08-14T00:00:00Z,826,1891,83936,1065,0.012688239,0.02252907,0.009840831,2014,NWS
2015-08-13T00:00:00Z,911,1961,84891,1050,0.012368802,0.023100211,0.010731409,2015,NWS
2016-08-12T00:00:00Z,954,1829,78404,875,0.011160145,0.023327891,0.012167747,2016,NWS
2017-08-14T00:00:00Z,1039,1904,82216,865,0.010521066,0.023158509,0.012637443,2017,NWS
2018-08-15T00:00:00Z,1183,2024,89986,841,0.009345898,0.022492388,0.013146489,2018,NWS
2011-02-24T00:00:00Z,975,1499,60944,524,0.008598057,0.024596351,0.015998294,2011,COTY
2012-02-29T00:00:00Z,1335,1851,74575,516,0.006919209,0.02482065,0.017901442,2012,COTY
2013-02-27T00:00:00Z,1413,1882,74626,469,0.006284673,0.025219093,0.01893442,2013,COTY
2014-02-21T00:00:00Z,1290,1890,71724,600,0.008365401,0.026351012,0.017985612,2014,COTY
2015-02-20T00:00:00Z,1187,1751,68141,564,0.008276955,0.025696717,0.017419762,2015,COTY
2016-02-22T00:00:00Z,1134,1470,60068,336,0.005593661,0.024472265,0.018878604,2016,COTY
2017-02-17T00:00:00Z,1113,1439,61360,326,0.005312907,0.02345176,0.018138853,2017,COTY
2018-02-16T00:00:00Z,1067,1422,60534,355,0.005864473,0.023490931,0.017626458,2018,COTY
2019-02-22T00:00:00Z,1074,1446,61840,372,0.006015524,0.023382924,0.0173674,2019,COTY
2011-02-25T00:00:00Z,1480,1580,86923,100,0.001150443,0.018177007,0.017026564,2011,AMGN
2012-02-29T00:00:00Z,1520,1713,90895,193,0.002123329,0.018845921,0.016722592,2012,AMGN
2013-02-27T00:00:00Z,1489,1785,90138,296,0.003283854,0.019802969,0.016519115,2013,AMGN
2014-02-24T00:00:00Z,1129,1372,70822,243,0.003431137,0.019372511,0.015941374,2014,AMGN
2015-02-19T00:00:00Z,1181,1467,72826,286,0.003927169,0.020143905,0.016216736,2015,AMGN
2016-02-16T00:00:00Z,1121,1393,70840,272,0.003839639,0.019664032,0.015824393,2016,AMGN
2017-02-14T00:00:00Z,1174,1398,68906,224,0.003250805,0.020288509,0.017037704,2017,AMGN
2018-02-13T00:00:00Z,1286,1488,74718,202,0.002703498,0.01991488,0.017211381,2018,AMGN
2019-02-13T00:00:00Z,1350,1507,76661,157,0.002047977,0.019657975,0.017609997,2019,AMGN
2014-03-03T00:00:00Z,1252,1630,81213,378,0.004654427,0.020070678,0.015416251,2014,LIN
2011-02-24T00:00:00Z,975,1499,60944,524,0.008598057,0.024596351,0.015998294,2011,SLB
2012-02-29T00:00:00Z,1335,1851,74575,516,0.006919209,0.02482065,0.017901442,2012,SLB
2013-02-27T00:00:00Z,1413,1882,74626,469,0.006284673,0.025219093,0.01893442,2013,SLB
2014-02-21T00:00:00Z,1290,1890,71724,600,0.008365401,0.026351012,0.017985612,2014,SLB
2015-02-20T00:00:00Z,1187,1751,68141,564,0.008276955,0.025696717,0.017419762,2015,SLB
2016-02-22T00:00:00Z,1134,1470,60068,336,0.005593661,0.024472265,0.018878604,2016,SLB
2017-02-17T00:00:00Z,1113,1439,61360,326,0.005312907,0.02345176,0.018138853,2017,SLB
2018-02-16T00:00:00Z,1067,1422,60534,355,0.005864473,0.023490931,0.017626458,2018,SLB
2019-02-22T00:00:00Z,1074,1446,61840,372,0.006015524,0.023382924,0.0173674,2019,SLB
2014-03-06T00:00:00Z,1039,1450,65180,411,0.006305615,0.022246088,0.015940473,2014,TWTR
2015-03-02T00:00:00Z,1034,1335,62092,301,0.004847645,0.021500354,0.016652709,2015,TWTR
2016-02-29T00:00:00Z,970,1338,59849,368,0.006148808,0.022356263,0.016207455,2016,TWTR
2017-02-27T00:00:00Z,1011,1402,61171,391,0.006391918,0.022919357,0.016527439,2017,TWTR
2018-02-23T00:00:00Z,1084,1409,63206,325,0.005141917,0.022292187,0.017150271,2018,TWTR
2019-02-21T00:00:00Z,1109,1474,67518,365,0.005405966,0.021831215,0.01642525,2019,TWTR
2014-03-10T00:00:00Z,736,1475,54421,739,0.013579317,0.027103508,0.013524191,2014,ALLE
2015-02-27T00:00:00Z,766,1375,53303,609,0.011425248,0.025795921,0.014370673,2015,ALLE
2016-02-26T00:00:00Z,733,1318,51104,585,0.011447245,0.025790545,0.0143433,2016,ALLE
2017-02-17T00:00:00Z,756,1329,51609,573,0.011102715,0.025751322,0.014648608,2017,ALLE
2018-02-20T00:00:00Z,699,1342,49911,643,0.012882932,0.02688786,0.014004929,2018,ALLE
2019-02-19T00:00:00Z,696,1425,52211,729,0.013962575,0.027293099,0.013330524,2019,ALLE
2011-02-24T00:00:00Z,975,1499,60944,524,0.008598057,0.024596351,0.015998294,2011,HLT
2012-02-29T00:00:00Z,1335,1851,74575,516,0.006919209,0.02482065,0.017901442,2012,HLT
2013-02-27T00:00:00Z,1413,1882,74626,469,0.006284673,0.025219093,0.01893442,2013,HLT
2014-02-21T00:00:00Z,1290,1890,71724,600,0.008365401,0.026351012,0.017985612,2014,HLT
2015-02-20T00:00:00Z,1187,1751,68141,564,0.008276955,0.025696717,0.017419762,2015,HLT
2016-02-22T00:00:00Z,1134,1470,60068,336,0.005593661,0.024472265,0.018878604,2016,HLT
2017-02-17T00:00:00Z,1113,1439,61360,326,0.005312907,0.02345176,0.018138853,2017,HLT
2018-02-16T00:00:00Z,1067,1422,60534,355,0.005864473,0.023490931,0.017626458,2018,HLT
2019-02-22T00:00:00Z,1074,1446,61840,372,0.006015524,0.023382924,0.0173674,2019,HLT
2010-02-25T00:00:00Z,1011,1196,72717,185,0.002544109,0.016447323,0.013903214,2010,CHV
2011-02-24T00:00:00Z,1107,1287,79871,180,0.002253634,0.016113483,0.013859849,2011,CHV
2012-02-23T00:00:00Z,968,1187,70629,219,0.003100709,0.016806128,0.013705418,2012,CHV
2013-02-22T00:00:00Z,924,1117,66572,193,0.002899117,0.016778826,0.013879709,2013,CHV
2014-02-21T00:00:00Z,950,1047,64482,97,0.001504296,0.016237089,0.014732794,2014,CHV
2015-02-20T00:00:00Z,910,979,61049,69,0.00113024,0.016036299,0.014906059,2015,CHV
2016-02-25T00:00:00Z,948,960,59796,12,0.000200682,0.016054586,0.015853903,2016,CHV
2017-02-23T00:00:00Z,1048,991,61860,-57,-0.000921435,0.016020045,0.016941481,2017,CHV
2018-02-22T00:00:00Z,1061,1025,61089,-36,-0.000589304,0.016778798,0.017368102,2018,CHV
2019-02-22T00:00:00Z,1022,1002,60801,-20,-0.000328942,0.016479992,0.016808934,2019,CHV
2010-02-25T00:00:00Z,1011,1196,72717,185,0.002544109,0.016447323,0.013903214,2010,CVX
2011-02-24T00:00:00Z,1107,1287,79871,180,0.002253634,0.016113483,0.013859849,2011,CVX
2012-02-23T00:00:00Z,968,1187,70629,219,0.003100709,0.016806128,0.013705418,2012,CVX
2013-02-22T00:00:00Z,924,1117,66572,193,0.002899117,0.016778826,0.013879709,2013,CVX
2014-02-21T00:00:00Z,950,1047,64482,97,0.001504296,0.016237089,0.014732794,2014,CVX
2015-02-20T00:00:00Z,910,979,61049,69,0.00113024,0.016036299,0.014906059,2015,CVX
2016-02-25T00:00:00Z,948,960,59796,12,0.000200682,0.016054586,0.015853903,2016,CVX
2017-02-23T00:00:00Z,1048,991,61860,-57,-0.000921435,0.016020045,0.016941481,2017,CVX
2018-02-22T00:00:00Z,1061,1025,61089,-36,-0.000589304,0.016778798,0.017368102,2018,CVX
2019-02-22T00:00:00Z,1022,1002,60801,-20,-0.000328942,0.016479992,0.016808934,2019,CVX
2010-10-27T00:00:00Z,710,1099,47994,389,0.00810518,0.022898696,0.014793516,2010,AAPL
2011-10-26T00:00:00Z,665,969,42966,304,0.007075362,0.022552716,0.015477354,2011,AAPL
2012-10-31T00:00:00Z,656,955,43285,299,0.006907705,0.02206307,0.015155366,2012,AAPL
2013-10-30T00:00:00Z,709,955,44960,246,0.00547153,0.021241103,0.015769573,2013,AAPL
2014-10-27T00:00:00Z,747,1002,47829,255,0.005331493,0.020949633,0.01561814,2014,AAPL
2015-10-28T00:00:00Z,748,982,45878,234,0.005100484,0.021404595,0.016304111,2015,AAPL
2016-10-26T00:00:00Z,737,959,43545,222,0.005098174,0.022023194,0.01692502,2016,AAPL
2017-11-03T00:00:00Z,762,967,44546,205,0.004601984,0.021707897,0.017105913,2017,AAPL
2018-11-05T00:00:00Z,727,911,41917,184,0.004389627,0.021733426,0.017343798,2018,AAPL
2011-02-24T00:00:00Z,975,1499,60944,524,0.008598057,0.024596351,0.015998294,2011,MRKT
2012-02-29T00:00:00Z,1335,1851,74575,516,0.006919209,0.02482065,0.017901442,2012,MRKT
2013-02-27T00:00:00Z,1413,1882,74626,469,0.006284673,0.025219093,0.01893442,2013,MRKT
2014-02-21T00:00:00Z,1290,1890,71724,600,0.008365401,0.026351012,0.017985612,2014,MRKT
2015-02-20T00:00:00Z,1187,1751,68141,564,0.008276955,0.025696717,0.017419762,2015,MRKT
2016-02-22T00:00:00Z,1134,1470,60068,336,0.005593661,0.024472265,0.018878604,2016,MRKT
2017-02-17T00:00:00Z,1113,1439,61360,326,0.005312907,0.02345176,0.018138853,2017,MRKT
2018-02-16T00:00:00Z,1067,1422,60534,355,0.005864473,0.023490931,0.017626458,2018,MRKT
2019-02-22T00:00:00Z,1074,1446,61840,372,0.006015524,0.023382924,0.0173674,2019,MRKT
2017-01-27T00:00:00Z,805,1142,53273,337,0.006325906,0.02143675,0.015110844,2017,INFO
2018-01-23T00:00:00Z,839,1140,53869,301,0.005587629,0.02116245,0.01557482,2018,INFO
2019-01-18T00:00:00Z,865,1253,58114,388,0.006676532,0.02156107,0.014884537,2019,INFO
2015-03-12T00:00:00Z,1420,1257,62589,-163,-0.002604291,0.020083401,0.022687693,2015,ANET
2016-02-25T00:00:00Z,1558,1337,64084,-221,-0.003448599,0.020863242,0.024311841,2016,ANET
2017-02-17T00:00:00Z,1612,1384,67080,-228,-0.003398927,0.020632081,0.024031008,2017,ANET
2018-02-20T00:00:00Z,1810,1520,73439,-290,-0.003948856,0.02069745,0.024646305,2018,ANET
2019-02-15T00:00:00Z,1580,1431,68964,-149,-0.002160548,0.020749956,0.022910504,2019,ANET
2015-02-23T00:00:00Z,2018,2356,104962,338,0.003220213,0.022446219,0.019226006,2015,SYF
2016-02-25T00:00:00Z,1857,1926,88806,69,0.000776975,0.021687724,0.020910749,2016,SYF
2017-02-23T00:00:00Z,1802,1893,85164,91,0.001068527,0.022227702,0.021159175,2017,SYF
2018-02-22T00:00:00Z,1783,1955,85704,172,0.002006907,0.022811071,0.020804163,2018,SYF
2019-02-15T00:00:00Z,1793,1934,82900,141,0.001700844,0.023329312,0.021628468,2019,SYF
2011-02-24T00:00:00Z,975,1499,60944,524,0.008598057,0.024596351,0.015998294,2011,CFG
2012-02-29T00:00:00Z,1335,1851,74575,516,0.006919209,0.02482065,0.017901442,2012,CFG
2013-02-27T00:00:00Z,1413,1882,74626,469,0.006284673,0.025219093,0.01893442,2013,CFG
2014-02-21T00:00:00Z,1290,1890,71724,600,0.008365401,0.026351012,0.017985612,2014,CFG
2015-02-20T00:00:00Z,1187,1751,68141,564,0.008276955,0.025696717,0.017419762,2015,CFG
2016-02-22T00:00:00Z,1134,1470,60068,336,0.005593661,0.024472265,0.018878604,2016,CFG
2017-02-17T00:00:00Z,1113,1439,61360,326,0.005312907,0.02345176,0.018138853,2017,CFG
2018-02-16T00:00:00Z,1067,1422,60534,355,0.005864473,0.023490931,0.017626458,2018,CFG
2019-02-22T00:00:00Z,1074,1446,61840,372,0.006015524,0.023382924,0.0173674,2019,CFG
2014-12-22T00:00:00Z,806,1455,56346,649,0.01151812,0.025822596,0.014304476,2014,KEYS
2015-12-21T00:00:00Z,816,1522,58015,706,0.012169267,0.026234595,0.014065328,2015,KEYS
2016-12-19T00:00:00Z,872,1506,59671,634,0.010624927,0.025238391,0.014613464,2016,KEYS
2017-12-20T00:00:00Z,989,1745,66738,756,0.011327879,0.026147023,0.014819144,2017,KEYS
2018-12-18T00:00:00Z,993,1752,65122,759,0.011655047,0.026903351,0.015248303,2018,KEYS
2011-02-28T00:00:00Z,1219,1571,75835,352,0.004641656,0.020716028,0.016074372,2011,MRO
2012-02-29T00:00:00Z,1024,1329,65563,305,0.004652014,0.020270579,0.015618565,2012,MRO
2013-02-22T00:00:00Z,1050,1333,65588,283,0.004314814,0.02032384,0.016009026,2013,MRO
2014-02-28T00:00:00Z,1107,1454,68395,347,0.00507347,0.021258864,0.016185394,2014,MRO
2015-03-02T00:00:00Z,1191,1228,64304,37,0.000575392,0.01909679,0.018521398,2015,MRO
2016-02-25T00:00:00Z,1212,1268,64337,56,0.000870417,0.019708721,0.018838305,2016,MRO
2017-02-24T00:00:00Z,1179,1240,61040,61,0.000999345,0.020314548,0.019315203,2017,MRO
2018-02-22T00:00:00Z,1135,1239,61309,104,0.001696325,0.020209105,0.01851278,2018,MRO
2019-02-21T00:00:00Z,1125,1251,60798,126,0.002072437,0.020576335,0.018503898,2019,MRO
2010-02-26T00:00:00Z,850,1357,51807,507,0.009786322,0.026193372,0.016407049,2010,VMC
2011-02-28T00:00:00Z,865,1378,51355,513,0.00998929,0.02683283,0.01684354,2011,VMC
2012-02-29T00:00:00Z,910,1520,54781,610,0.011135248,0.027746847,0.016611599,2012,VMC
2013-02-28T00:00:00Z,816,1448,51929,632,0.012170464,0.027884227,0.015713763,2013,VMC
2014-02-26T00:00:00Z,794,1400,51218,606,0.011831778,0.02733414,0.015502362,2014,VMC
2015-02-27T00:00:00Z,846,1343,50298,497,0.009881109,0.026700863,0.016819754,2015,VMC
2016-02-25T00:00:00Z,922,1388,52832,466,0.008820412,0.026271956,0.017451545,2016,VMC
2017-02-24T00:00:00Z,915,1378,53411,463,0.008668626,0.025799929,0.017131303,2017,VMC
2018-02-27T00:00:00Z,974,1456,56709,482,0.008499533,0.025674937,0.017175404,2018,VMC
2019-02-26T00:00:00Z,888,1383,54905,495,0.009015572,0.025188963,0.01617339,2019,VMC
2016-03-03T00:00:00Z,1063,1443,65308,380,0.005818583,0.022095302,0.01627672,2016,KHC
2017-02-23T00:00:00Z,1064,1526,61870,462,0.00746727,0.024664619,0.017197349,2017,KHC
2018-02-16T00:00:00Z,1099,1622,62896,523,0.008315314,0.025788603,0.017473289,2018,KHC
2010-03-29T00:00:00Z,587,843,38562,256,0.00663866,0.021860899,0.01522224,2010,Z
2011-03-28T00:00:00Z,592,838,37898,246,0.006491108,0.022111985,0.015620877,2011,Z
2012-03-26T00:00:00Z,515,868,37913,353,0.00931079,0.022894522,0.013583731,2012,Z
2013-04-01T00:00:00Z,515,920,38948,405,0.01039848,0.023621239,0.013222759,2013,Z
2014-03-31T00:00:00Z,551,932,40707,381,0.00935957,0.022895325,0.013535756,2014,Z
2015-03-30T00:00:00Z,533,921,39351,388,0.009859978,0.023404742,0.013544764,2015,Z
2016-03-24T00:00:00Z,562,997,40458,435,0.010751891,0.024642839,0.013890949,2016,Z
2017-03-23T00:00:00Z,575,1003,41724,428,0.010257885,0.024038922,0.013781037,2017,Z
2018-03-29T00:00:00Z,640,1036,44386,396,0.008921732,0.023340693,0.014418961,2018,Z
2019-04-02T00:00:00Z,607,1007,43756,400,0.009141603,0.023013987,0.013872383,2019,Z
2010-03-29T00:00:00Z,587,843,38562,256,0.00663866,0.021860899,0.01522224,2010,FL
2011-03-28T00:00:00Z,592,838,37898,246,0.006491108,0.022111985,0.015620877,2011,FL
2012-03-26T00:00:00Z,515,868,37913,353,0.00931079,0.022894522,0.013583731,2012,FL
2013-04-01T00:00:00Z,515,920,38948,405,0.01039848,0.023621239,0.013222759,2013,FL
2014-03-31T00:00:00Z,551,932,40707,381,0.00935957,0.022895325,0.013535756,2014,FL
2015-03-30T00:00:00Z,533,921,39351,388,0.009859978,0.023404742,0.013544764,2015,FL
2016-03-24T00:00:00Z,562,997,40458,435,0.010751891,0.024642839,0.013890949,2016,FL
2017-03-23T00:00:00Z,575,1003,41724,428,0.010257885,0.024038922,0.013781037,2017,FL
2018-03-29T00:00:00Z,640,1036,44386,396,0.008921732,0.023340693,0.014418961,2018,FL
2019-04-02T00:00:00Z,607,1007,43756,400,0.009141603,0.023013987,0.013872383,2019,FL
2016-02-11T00:00:00Z,1224,1409,65051,185,0.002843922,0.021659928,0.018816006,2016,PYPL
2017-02-08T00:00:00Z,1357,1478,69123,121,0.001750503,0.021382174,0.019631671,2017,PYPL
2018-02-07T00:00:00Z,1422,1651,76001,229,0.003013118,0.021723398,0.01871028,2018,PYPL
2019-02-07T00:00:00Z,1526,1681,76122,155,0.002036205,0.022082972,0.020046767,2019,PYPL
2010-02-23T00:00:00Z,141,213,12018,72,0.005991013,0.017723415,0.011732401,2010,TXN
2011-02-25T00:00:00Z,138,212,11977,74,0.006178509,0.017700593,0.011522084,2011,TXN
2012-02-24T00:00:00Z,150,228,12074,78,0.006460162,0.018883551,0.012423389,2012,TXN
2013-02-22T00:00:00Z,153,227,12605,74,0.005870686,0.018008727,0.01213804,2013,TXN
2014-02-24T00:00:00Z,170,227,12313,57,0.004629254,0.0184358,0.013806546,2014,TXN
2015-02-24T00:00:00Z,443,877,33936,434,0.012788779,0.025842763,0.013053984,2015,TXN
2016-02-24T00:00:00Z,437,794,32251,357,0.011069424,0.024619392,0.013549967,2016,TXN
2017-02-23T00:00:00Z,442,811,31992,369,0.011534134,0.025350088,0.013815954,2017,TXN
2018-02-22T00:00:00Z,431,782,31728,351,0.011062784,0.024646999,0.013584216,2018,TXN
2019-02-22T00:00:00Z,439,796,31087,357,0.0114839,0.025605559,0.014121659,2019,TXN
2015-12-17T00:00:00Z,1551,2024,84270,473,0.005612911,0.024018037,0.018405126,2015,HPE
2016-12-15T00:00:00Z,1549,2110,89684,561,0.006255296,0.023527051,0.017271754,2016,HPE
2017-12-15T00:00:00Z,1508,1952,86857,444,0.005111851,0.022473721,0.017361871,2017,HPE
2018-12-12T00:00:00Z,1502,1978,84895,476,0.005606926,0.02329937,0.017692444,2018,HPE
2010-03-01T00:00:00Z,1677,2199,106912,522,0.00488252,0.020568318,0.015685798,2010,EIX
2011-02-28T00:00:00Z,1476,1842,93817,366,0.003901212,0.019633968,0.015732756,2011,EIX
2012-02-29T00:00:00Z,1553,1861,93869,308,0.003281168,0.019825501,0.016544333,2012,EIX
2013-02-26T00:00:00Z,1125,1514,73530,389,0.005290358,0.020590235,0.015299878,2013,EIX
2014-02-25T00:00:00Z,1114,1457,73198,343,0.00468592,0.019904915,0.015218995,2014,EIX
2015-02-24T00:00:00Z,1083,1437,69239,354,0.005112725,0.020754199,0.015641474,2015,EIX
2016-02-23T00:00:00Z,1034,1420,68139,386,0.005664891,0.020839754,0.015174863,2016,EIX
2017-02-21T00:00:00Z,1034,1441,66614,407,0.006109827,0.021632089,0.015522263,2017,EIX
2018-02-22T00:00:00Z,1219,1550,72103,331,0.004590655,0.021497025,0.01690637,2018,EIX
2019-02-28T00:00:00Z,1390,1734,78930,344,0.004358292,0.021968833,0.017610541,2019,EIX
2011-02-24T00:00:00Z,550,789,39897,239,0.005990425,0.019775923,0.013785498,2011,UA
2012-02-27T00:00:00Z,604,831,41153,227,0.005516001,0.020192939,0.014676937,2012,UA
2013-02-25T00:00:00Z,617,814,41017,197,0.004802887,0.01984543,0.015042543,2013,UA
2014-02-21T00:00:00Z,663,869,42155,206,0.004886728,0.020614399,0.015727672,2014,UA
2015-02-20T00:00:00Z,674,878,42423,204,0.004808712,0.02069632,0.015887608,2015,UA
2016-02-22T00:00:00Z,702,982,45655,280,0.006132954,0.021509145,0.015376191,2016,UA
2017-02-23T00:00:00Z,728,959,46313,231,0.0049878,0.020706929,0.015719129,2017,UA
2018-02-28T00:00:00Z,862,1129,50516,267,0.005285454,0.022349355,0.017063901,2018,UA
2019-02-25T00:00:00Z,924,1186,53304,262,0.004915203,0.022249737,0.017334534,2019,UA
2017-02-28T00:00:00Z,865,1285,56077,420,0.007489702,0.022914921,0.015425219,2017,FTV
2018-02-28T00:00:00Z,926,1341,58459,415,0.007098992,0.022939154,0.015840161,2018,FTV
2019-02-28T00:00:00Z,1014,1345,64346,331,0.005144065,0.02090262,0.015758555,2019,FTV
2017-07-25T00:00:00Z,699,933,44523,234,0.005255711,0.020955461,0.015699751,2017,LW
2018-07-26T00:00:00Z,706,1018,46147,312,0.006761003,0.022059939,0.015298936,2018,LW
2017-01-13T00:00:00Z,236,259,15895,23,0.001446996,0.016294432,0.014847436,2017,FTI
2018-04-02T00:00:00Z,1036,1679,63362,643,0.010148038,0.026498532,0.016350494,2018,FTI
2019-03-11T00:00:00Z,1176,1875,70951,699,0.00985187,0.026426689,0.016574819,2019,FTI
2011-02-18T00:00:00Z,622,1248,48674,626,0.012861076,0.025639972,0.012778896,2011,HSY
2012-02-17T00:00:00Z,627,1236,49662,609,0.012262897,0.024888245,0.012625347,2012,HSY
2013-02-22T00:00:00Z,673,1258,52006,585,0.011248702,0.024189517,0.012940815,2013,HSY
2014-02-21T00:00:00Z,650,1191,50150,541,0.010787637,0.023748754,0.012961117,2014,HSY
2015-02-20T00:00:00Z,568,1107,44664,539,0.012067885,0.024785062,0.012717177,2015,HSY
2016-02-26T00:00:00Z,689,1242,49720,553,0.011122285,0.024979887,0.013857603,2016,HSY
2017-02-21T00:00:00Z,632,1197,48536,565,0.011640844,0.024662106,0.013021263,2017,HSY
2018-02-27T00:00:00Z,626,1292,50972,666,0.013065997,0.025347249,0.012281252,2018,HSY
2019-02-22T00:00:00Z,603,1321,55320,718,0.012979031,0.023879248,0.010900217,2019,HSY
2012-03-27T00:00:00Z,557,1098,42814,541,0.012636054,0.025645817,0.013009763,2012,KR
2013-04-02T00:00:00Z,574,1114,46022,540,0.011733519,0.024205815,0.012472296,2013,KR
2014-04-01T00:00:00Z,563,1111,47277,548,0.01159126,0.023499799,0.011908539,2014,KR
2015-03-31T00:00:00Z,557,1134,46187,577,0.012492693,0.024552363,0.01205967,2015,KR
2016-03-29T00:00:00Z,588,1179,48898,591,0.012086384,0.024111416,0.012025032,2016,KR
2017-03-28T00:00:00Z,580,1138,45850,558,0.01217012,0.024820065,0.012649945,2017,KR
2018-04-03T00:00:00Z,608,1199,47793,591,0.012365828,0.025087356,0.012721528,2018,KR
2019-04-02T00:00:00Z,593,1159,47367,566,0.011949247,0.024468512,0.012519264,2019,KR
2011-02-24T00:00:00Z,975,1499,60944,524,0.008598057,0.024596351,0.015998294,2011,DWDP
2012-02-29T00:00:00Z,1335,1851,74575,516,0.006919209,0.02482065,0.017901442,2012,DWDP
2013-02-27T00:00:00Z,1413,1882,74626,469,0.006284673,0.025219093,0.01893442,2013,DWDP
2014-02-21T00:00:00Z,1290,1890,71724,600,0.008365401,0.026351012,0.017985612,2014,DWDP
2015-02-20T00:00:00Z,1187,1751,68141,564,0.008276955,0.025696717,0.017419762,2015,DWDP
2016-02-22T00:00:00Z,1134,1470,60068,336,0.005593661,0.024472265,0.018878604,2016,DWDP
2017-02-17T00:00:00Z,1113,1439,61360,326,0.005312907,0.02345176,0.018138853,2017,DWDP
2018-02-16T00:00:00Z,1067,1422,60534,355,0.005864473,0.023490931,0.017626458,2018,DWDP
2019-02-22T00:00:00Z,1074,1446,61840,372,0.006015524,0.023382924,0.0173674,2019,DWDP
2010-02-26T00:00:00Z,365,476,26634,111,0.004167605,0.017871893,0.013704288,2010,CVS
2011-02-18T00:00:00Z,424,513,28566,89,0.003115592,0.017958412,0.01484282,2011,CVS
2012-02-17T00:00:00Z,459,533,29461,74,0.002511795,0.018091714,0.015579919,2012,CVS
2013-02-15T00:00:00Z,465,549,29533,84,0.002844276,0.018589375,0.015745099,2013,CVS
2014-02-11T00:00:00Z,380,443,23814,63,0.002645503,0.018602503,0.015957,2014,CVS
2015-02-10T00:00:00Z,310,441,21249,131,0.006164996,0.020753918,0.014588922,2015,CVS
2016-02-09T00:00:00Z,376,492,24321,116,0.004769541,0.020229431,0.015459891,2016,CVS
2017-02-09T00:00:00Z,422,537,26026,115,0.004418658,0.020633213,0.016214555,2017,CVS
2018-02-14T00:00:00Z,594,718,32497,124,0.003815737,0.022094347,0.01827861,2018,CVS
2019-02-28T00:00:00Z,1158,1393,56228,235,0.004179412,0.024774134,0.020594721,2019,CVS
2009-07-13T00:00:00Z,879,1392,53046,513,0.009670852,0.026241375,0.016570524,2009,GIS
2010-07-09T00:00:00Z,888,1432,52873,544,0.010288805,0.027083767,0.016794962,2010,GIS
2011-07-08T00:00:00Z,818,1338,49451,520,0.01051546,0.027057087,0.016541627,2011,GIS
2012-07-03T00:00:00Z,812,1355,50362,543,0.010781939,0.026905206,0.016123268,2012,GIS
2013-07-03T00:00:00Z,807,1340,51979,533,0.010254141,0.025779642,0.015525501,2013,GIS
2014-07-03T00:00:00Z,755,1259,48337,504,0.010426795,0.0260463,0.015619505,2014,GIS
2015-07-06T00:00:00Z,725,1295,49611,570,0.011489387,0.026103082,0.014613695,2015,GIS
2016-06-30T00:00:00Z,745,1337,50888,592,0.011633391,0.026273385,0.014639994,2016,GIS
2017-06-29T00:00:00Z,788,1457,54573,669,0.012258809,0.026698184,0.014439375,2017,GIS
2018-06-29T00:00:00Z,823,1512,57516,689,0.011979275,0.026288337,0.014309062,2018,GIS
2011-02-23T00:00:00Z,111,191,9969,80,0.008024877,0.019159394,0.011134517,2011,MHP
2012-02-07T00:00:00Z,590,1068,47308,478,0.010103999,0.022575463,0.012471464,2012,MHP
2013-02-28T00:00:00Z,605,1102,49881,497,0.009963714,0.02209258,0.012128867,2013,MHP
2014-02-07T00:00:00Z,577,1077,49542,500,0.010092447,0.02173913,0.011646684,2014,MHP
2015-02-13T00:00:00Z,797,1176,55838,379,0.006787492,0.021060926,0.014273434,2015,MHP
2016-02-12T00:00:00Z,894,1246,58875,352,0.005978769,0.021163482,0.015184713,2016,MHP
2017-02-09T00:00:00Z,879,1399,58589,520,0.008875386,0.023878202,0.015002816,2017,MHP
2018-02-09T00:00:00Z,798,1359,56942,561,0.00985213,0.02386639,0.01401426,2018,MHP
2019-02-13T00:00:00Z,848,1404,60459,556,0.009196315,0.023222349,0.014026034,2019,MHP
2011-02-23T00:00:00Z,111,191,9969,80,0.008024877,0.019159394,0.011134517,2011,MHFI
2012-02-07T00:00:00Z,590,1068,47308,478,0.010103999,0.022575463,0.012471464,2012,MHFI
2013-02-28T00:00:00Z,605,1102,49881,497,0.009963714,0.02209258,0.012128867,2013,MHFI
2014-02-07T00:00:00Z,577,1077,49542,500,0.010092447,0.02173913,0.011646684,2014,MHFI
2015-02-13T00:00:00Z,797,1176,55838,379,0.006787492,0.021060926,0.014273434,2015,MHFI
2016-02-12T00:00:00Z,894,1246,58875,352,0.005978769,0.021163482,0.015184713,2016,MHFI
2017-02-09T00:00:00Z,879,1399,58589,520,0.008875386,0.023878202,0.015002816,2017,MHFI
2018-02-09T00:00:00Z,798,1359,56942,561,0.00985213,0.02386639,0.01401426,2018,MHFI
2019-02-13T00:00:00Z,848,1404,60459,556,0.009196315,0.023222349,0.014026034,2019,MHFI
2011-02-23T00:00:00Z,111,191,9969,80,0.008024877,0.019159394,0.011134517,2011,SPGI
2012-02-07T00:00:00Z,590,1068,47308,478,0.010103999,0.022575463,0.012471464,2012,SPGI
2013-02-28T00:00:00Z,605,1102,49881,497,0.009963714,0.02209258,0.012128867,2013,SPGI
2014-02-07T00:00:00Z,577,1077,49542,500,0.010092447,0.02173913,0.011646684,2014,SPGI
2015-02-13T00:00:00Z,797,1176,55838,379,0.006787492,0.021060926,0.014273434,2015,SPGI
2016-02-12T00:00:00Z,894,1246,58875,352,0.005978769,0.021163482,0.015184713,2016,SPGI
2017-02-09T00:00:00Z,879,1399,58589,520,0.008875386,0.023878202,0.015002816,2017,SPGI
2018-02-09T00:00:00Z,798,1359,56942,561,0.00985213,0.02386639,0.01401426,2018,SPGI
2019-02-13T00:00:00Z,848,1404,60459,556,0.009196315,0.023222349,0.014026034,2019,SPGI
2010-02-24T00:00:00Z,631,1127,44406,496,0.011169662,0.025379453,0.014209791,2010,KMB
2011-02-23T00:00:00Z,626,1055,41303,429,0.010386655,0.025542939,0.015156284,2011,KMB
2012-02-29T00:00:00Z,532,995,36827,463,0.012572297,0.02701822,0.014445923,2012,KMB
2013-02-22T00:00:00Z,507,969,35829,462,0.012894583,0.027045131,0.014150548,2013,KMB
2014-02-14T00:00:00Z,542,952,36006,410,0.011386991,0.026440038,0.015053047,2014,KMB
2015-02-18T00:00:00Z,498,864,34309,366,0.010667755,0.025182897,0.014515142,2015,KMB
2016-02-11T00:00:00Z,502,866,34093,364,0.010676678,0.025401109,0.01472443,2016,KMB
2017-02-08T00:00:00Z,463,758,31089,295,0.009488887,0.024381614,0.014892727,2017,KMB
2018-02-08T00:00:00Z,433,798,31406,365,0.011621983,0.025409157,0.013787174,2018,KMB
2019-02-07T00:00:00Z,456,862,32716,406,0.01240983,0.026347964,0.013938134,2019,KMB
2011-02-24T00:00:00Z,975,1499,60944,524,0.008598057,0.024596351,0.015998294,2011,UTX
2012-02-29T00:00:00Z,1335,1851,74575,516,0.006919209,0.02482065,0.017901442,2012,UTX
2013-02-27T00:00:00Z,1413,1882,74626,469,0.006284673,0.025219093,0.01893442,2013,UTX
2014-02-21T00:00:00Z,1290,1890,71724,600,0.008365401,0.026351012,0.017985612,2014,UTX
2015-02-20T00:00:00Z,1187,1751,68141,564,0.008276955,0.025696717,0.017419762,2015,UTX
2016-02-22T00:00:00Z,1134,1470,60068,336,0.005593661,0.024472265,0.018878604,2016,UTX
2017-02-17T00:00:00Z,1113,1439,61360,326,0.005312907,0.02345176,0.018138853,2017,UTX
2018-02-16T00:00:00Z,1067,1422,60534,355,0.005864473,0.023490931,0.017626458,2018,UTX
2019-02-22T00:00:00Z,1074,1446,61840,372,0.006015524,0.023382924,0.0173674,2019,UTX
2009-08-14T00:00:00Z,88,163,9790,75,0.007660878,0.016649642,0.008988764,2009,PG
2010-08-13T00:00:00Z,110,202,11646,92,0.007899708,0.017345011,0.009445303,2010,PG
2011-08-10T00:00:00Z,116,191,11337,75,0.006615507,0.016847491,0.010231984,2011,PG
2012-08-08T00:00:00Z,530,1194,45119,664,0.014716638,0.026463352,0.011746714,2012,PG
2013-08-08T00:00:00Z,538,1187,45543,649,0.014250269,0.026063281,0.011813012,2013,PG
2014-08-08T00:00:00Z,546,1177,46190,631,0.013660966,0.025481706,0.01182074,2014,PG
2015-08-07T00:00:00Z,581,1160,47355,579,0.012226798,0.024495829,0.012269032,2015,PG
2016-08-09T00:00:00Z,614,1144,46386,530,0.011425861,0.024662614,0.013236752,2016,PG
2017-08-07T00:00:00Z,627,1242,47609,615,0.012917726,0.026087504,0.013169779,2017,PG
2018-08-07T00:00:00Z,637,1250,49475,613,0.012390096,0.025265285,0.012875189,2018,PG
2010-02-25T00:00:00Z,3521,5907,293682,2386,0.008124434,0.020113592,0.011989158,2010,SO
2011-02-25T00:00:00Z,3652,6710,317999,3058,0.009616382,0.021100695,0.011484313,2011,SO
2012-02-24T00:00:00Z,3526,6402,319763,2876,0.008994161,0.020021078,0.011026917,2012,SO
2013-02-28T00:00:00Z,3247,6470,312637,3223,0.01030908,0.020694927,0.010385847,2013,SO
2014-02-27T00:00:00Z,3190,6423,312228,3233,0.010354613,0.020571505,0.010216893,2014,SO
2015-03-02T00:00:00Z,3202,6354,321581,3152,0.009801574,0.01975863,0.009957056,2015,SO
2016-02-26T00:00:00Z,3394,6695,337746,3301,0.009773617,0.019822589,0.010048972,2016,SO
2017-02-22T00:00:00Z,4228,8680,425585,4452,0.010460895,0.020395456,0.009934561,2017,SO
2018-02-21T00:00:00Z,4229,8730,410109,4501,0.010975131,0.021287024,0.010311893,2018,SO
2019-02-20T00:00:00Z,2918,5663,299156,2745,0.009175815,0.018929923,0.009754108,2019,SO
2011-02-24T00:00:00Z,470,854,36251,384,0.010592811,0.023557971,0.01296516,2011,CL
2012-02-23T00:00:00Z,507,877,39635,370,0.009335184,0.022126908,0.012791724,2012,CL
2013-02-21T00:00:00Z,581,1044,44711,463,0.010355394,0.023349959,0.012994565,2013,CL
2014-02-20T00:00:00Z,673,1110,48618,437,0.00898844,0.02283105,0.01384261,2014,CL
2015-02-19T00:00:00Z,680,1133,49436,453,0.009163363,0.022918521,0.013755158,2015,CL
2016-02-18T00:00:00Z,734,1235,52714,501,0.009504117,0.023428311,0.013924195,2016,CL
2017-02-23T00:00:00Z,714,1340,53684,626,0.01166083,0.024960882,0.013300052,2017,CL
2018-02-15T00:00:00Z,713,1336,55336,623,0.011258494,0.024143415,0.012884921,2018,CL
2019-02-21T00:00:00Z,701,1376,53731,675,0.01256258,0.025609053,0.013046472,2019,CL
2010-02-22T00:00:00Z,816,1354,57171,538,0.009410365,0.023683336,0.014272971,2010,FMC
2011-02-22T00:00:00Z,841,1363,57425,522,0.009090118,0.023735307,0.014645189,2011,FMC
2012-02-21T00:00:00Z,792,1299,54210,507,0.009352518,0.023962369,0.014609851,2012,FMC
2013-02-19T00:00:00Z,775,1239,51249,464,0.009053835,0.024176081,0.015122246,2013,FMC
2014-02-18T00:00:00Z,818,1222,51566,404,0.00783462,0.023697785,0.015863166,2014,FMC
2015-02-27T00:00:00Z,923,1280,54365,357,0.006566725,0.02354456,0.016977835,2015,FMC
2016-02-26T00:00:00Z,986,1379,57844,393,0.006794136,0.023839983,0.017045847,2016,FMC
2017-02-28T00:00:00Z,1006,1458,58571,452,0.00771713,0.024892865,0.017175735,2017,FMC
2018-02-28T00:00:00Z,1082,1570,62813,488,0.007769092,0.024994826,0.017225734,2018,FMC
2019-02-28T00:00:00Z,1124,1700,69502,576,0.008287531,0.024459728,0.016172196,2019,FMC
2010-12-17T00:00:00Z,635,877,45548,242,0.005313076,0.019254413,0.013941337,2010,DE
2011-12-19T00:00:00Z,671,938,48439,267,0.005512087,0.019364562,0.013852474,2011,DE
2012-12-17T00:00:00Z,706,905,48433,199,0.004108769,0.018685607,0.014576838,2012,DE
2013-12-16T00:00:00Z,710,889,49008,179,0.003652465,0.018139896,0.014487431,2013,DE
2014-12-19T00:00:00Z,762,932,50168,170,0.003388614,0.018577579,0.015188965,2014,DE
2015-12-18T00:00:00Z,757,947,50182,190,0.003786218,0.018871308,0.01508509,2015,DE
2016-12-19T00:00:00Z,845,1032,52622,187,0.003553647,0.019611569,0.016057923,2016,DE
2017-12-18T00:00:00Z,844,1078,53646,234,0.004361928,0.020094695,0.015732767,2017,DE
2018-12-17T00:00:00Z,837,1122,56413,285,0.005052027,0.019889033,0.014837006,2018,DE
2011-02-18T00:00:00Z,1404,1848,88289,444,0.005028939,0.02093126,0.015902321,2011,BMY
2012-02-17T00:00:00Z,1212,1529,74352,317,0.004263503,0.020564343,0.016300839,2012,BMY
2013-02-15T00:00:00Z,1204,1558,76565,354,0.004623522,0.020348723,0.015725201,2013,BMY
2014-02-14T00:00:00Z,1141,1501,75178,360,0.004788635,0.019965947,0.015177313,2014,BMY
2015-02-13T00:00:00Z,1036,1477,70403,441,0.006263938,0.02097922,0.014715282,2015,BMY
2016-02-12T00:00:00Z,1070,1535,71058,465,0.00654395,0.021602072,0.015058122,2016,BMY
2017-02-21T00:00:00Z,958,1416,64442,458,0.007107166,0.021973247,0.014866081,2017,BMY
2018-02-13T00:00:00Z,988,1460,65007,472,0.007260757,0.02245912,0.015198363,2018,BMY
2019-02-25T00:00:00Z,1062,1546,67738,484,0.007145177,0.022823231,0.015678054,2019,BMY
2007-10-26T00:00:00Z,160,118,9500,-42,-0.004421053,0.012421053,0.016842105,2007,WAG
2008-10-30T00:00:00Z,209,203,12361,-6,-0.000485398,0.01642262,0.016908017,2008,WAG
2009-10-26T00:00:00Z,191,187,12214,-4,-0.000327493,0.0153103,0.015637793,2009,WAG
2010-10-26T00:00:00Z,182,218,12788,36,0.002815139,0.017047232,0.014232093,2010,WAG
2011-10-25T00:00:00Z,220,257,14037,37,0.002635891,0.018308755,0.015672865,2011,WAG
2012-10-19T00:00:00Z,326,371,20301,45,0.00221664,0.018274962,0.016058322,2012,WAG
2013-10-21T00:00:00Z,452,481,24824,29,0.001168224,0.01937641,0.018208186,2013,WAG
2014-10-20T00:00:00Z,928,1280,62407,352,0.005640393,0.02051052,0.014870127,2014,WAG
2015-10-28T00:00:00Z,1101,1677,75154,576,0.007664263,0.022314182,0.014649919,2015,WBA
2016-10-20T00:00:00Z,1036,1494,69810,458,0.006560665,0.021400945,0.014840281,2016,WBA
2017-10-25T00:00:00Z,1011,1465,69572,454,0.006525614,0.021057322,0.014531708,2017,WBA
2018-10-11T00:00:00Z,1064,1474,68830,410,0.005956705,0.021415081,0.015458376,2018,WBA
2011-02-09T00:00:00Z,876,1191,56339,315,0.005591154,0.021139885,0.015548732,2011,BA
2012-02-09T00:00:00Z,852,1193,56535,341,0.006031662,0.021101972,0.01507031,2012,BA
2013-02-11T00:00:00Z,815,1180,54108,365,0.006745768,0.021808235,0.015062468,2013,BA
2014-02-14T00:00:00Z,792,1180,53518,388,0.007249897,0.022048657,0.014798759,2014,BA
2015-02-12T00:00:00Z,806,1179,53766,373,0.00693747,0.021928356,0.014990886,2015,BA
2016-02-10T00:00:00Z,821,1185,53637,364,0.00678636,0.022092958,0.015306598,2016,BA
2017-02-08T00:00:00Z,832,1145,53415,313,0.005859777,0.021435926,0.015576149,2017,BA
2018-02-12T00:00:00Z,759,1117,50760,358,0.007052797,0.022005516,0.014952719,2018,BA
2019-02-08T00:00:00Z,793,1145,56425,352,0.00623837,0.020292424,0.014054054,2019,BA
2011-02-22T00:00:00Z,1443,2015,104559,572,0.005470596,0.019271416,0.013800821,2011,UAL
2012-02-22T00:00:00Z,1240,1768,94528,528,0.005585647,0.018703453,0.013117806,2012,UAL
2013-02-25T00:00:00Z,1270,1589,87558,319,0.003643299,0.01814797,0.014504671,2013,UAL
2014-02-20T00:00:00Z,1083,1278,71643,195,0.002721829,0.017838449,0.01511662,2014,UAL
2015-02-20T00:00:00Z,1062,1199,67175,137,0.002039449,0.017848902,0.015809453,2015,UAL
2016-02-18T00:00:00Z,1021,1158,65820,137,0.002081434,0.017593437,0.015512002,2016,UAL
2017-02-23T00:00:00Z,867,1032,62627,165,0.002634646,0.016478516,0.013843869,2017,UAL
2018-02-22T00:00:00Z,839,1030,64073,191,0.002980975,0.016075414,0.013094439,2018,UAL
2019-02-28T00:00:00Z,828,1095,62699,267,0.004258441,0.017464393,0.013205952,2019,UAL
2011-02-28T00:00:00Z,3593,3639,156335,46,0.00029424,0.023276937,0.022982697,2011,HI
2012-02-27T00:00:00Z,3694,3509,154790,-185,-0.001195168,0.022669423,0.023864591,2012,HI
2013-03-04T00:00:00Z,3671,3433,151501,-238,-0.001570947,0.022659916,0.024230863,2013,HI
2014-02-24T00:00:00Z,3451,3311,143413,-140,-0.000976202,0.023087168,0.024063369,2014,HI
2015-02-23T00:00:00Z,3345,3328,139262,-17,-0.000122072,0.023897402,0.024019474,2015,HI
2016-02-22T00:00:00Z,3261,3195,134870,-66,-0.00048936,0.023689479,0.024178839,2016,HI
2017-02-21T00:00:00Z,2288,1937,85927,-351,-0.004084863,0.022542391,0.026627253,2017,HI
2012-02-27T00:00:00Z,1843,2794,117644,951,0.00808371,0.023749617,0.015665907,2012,LUK
2013-02-25T00:00:00Z,1909,3212,126866,1303,0.010270679,0.025318052,0.015047373,2013,LUK
2014-02-28T00:00:00Z,2099,3328,128529,1229,0.009562044,0.025892989,0.016330945,2014,LUK
2015-02-27T00:00:00Z,2097,3358,130245,1261,0.009681754,0.02578218,0.016100426,2015,LUK
2016-02-19T00:00:00Z,2154,3309,131734,1155,0.008767668,0.0251188,0.016351132,2016,LUK
2017-02-27T00:00:00Z,1602,2182,90639,580,0.006399011,0.024073522,0.017674511,2017,LUK
2018-02-27T00:00:00Z,1602,2250,93589,648,0.006923891,0.024041287,0.017117396,2018,LUK
2011-02-24T00:00:00Z,975,1499,60944,524,0.008598057,0.024596351,0.015998294,2011,JEF
2012-02-29T00:00:00Z,1335,1851,74575,516,0.006919209,0.02482065,0.017901442,2012,JEF
2013-02-27T00:00:00Z,1413,1882,74626,469,0.006284673,0.025219093,0.01893442,2013,JEF
2014-02-21T00:00:00Z,1290,1890,71724,600,0.008365401,0.026351012,0.017985612,2014,JEF
2015-02-20T00:00:00Z,1187,1751,68141,564,0.008276955,0.025696717,0.017419762,2015,JEF
2016-02-22T00:00:00Z,1134,1470,60068,336,0.005593661,0.024472265,0.018878604,2016,JEF
2017-02-17T00:00:00Z,1113,1439,61360,326,0.005312907,0.02345176,0.018138853,2017,JEF
2018-02-16T00:00:00Z,1067,1422,60534,355,0.005864473,0.023490931,0.017626458,2018,JEF
2019-02-22T00:00:00Z,1074,1446,61840,372,0.006015524,0.023382924,0.0173674,2019,JEF
2011-02-18T00:00:00Z,763,1030,46129,267,0.005788116,0.022328687,0.016540571,2011,ABT
2012-02-21T00:00:00Z,814,1098,48798,284,0.005819911,0.022500922,0.016681012,2012,ABT
2013-02-15T00:00:00Z,801,1014,46389,213,0.004591606,0.02185863,0.017267025,2013,ABT
2014-02-21T00:00:00Z,759,976,42289,217,0.005131358,0.023079288,0.01794793,2014,ABT
2015-02-27T00:00:00Z,761,1009,45191,248,0.005487818,0.022327455,0.016839636,2015,ABT
2016-02-19T00:00:00Z,723,1015,46112,292,0.006332408,0.022011624,0.015679216,2016,ABT
2017-02-17T00:00:00Z,775,1007,48317,232,0.004801623,0.020841526,0.016039903,2017,ABT
2018-02-16T00:00:00Z,838,1152,52620,314,0.005967313,0.021892816,0.015925504,2018,ABT
2019-02-22T00:00:00Z,818,1190,52377,372,0.007102354,0.022719896,0.015617542,2019,ABT
2018-03-29T00:00:00Z,1106,1275,68051,169,0.002483432,0.018735948,0.016252516,2018,AMR
2011-02-24T00:00:00Z,975,1499,60944,524,0.008598057,0.024596351,0.015998294,2011,AAL
2012-02-29T00:00:00Z,1335,1851,74575,516,0.006919209,0.02482065,0.017901442,2012,AAL
2013-02-27T00:00:00Z,1413,1882,74626,469,0.006284673,0.025219093,0.01893442,2013,AAL
2014-02-21T00:00:00Z,1290,1890,71724,600,0.008365401,0.026351012,0.017985612,2014,AAL
2015-02-20T00:00:00Z,1187,1751,68141,564,0.008276955,0.025696717,0.017419762,2015,AAL
2016-02-22T00:00:00Z,1134,1470,60068,336,0.005593661,0.024472265,0.018878604,2016,AAL
2017-02-17T00:00:00Z,1113,1439,61360,326,0.005312907,0.02345176,0.018138853,2017,AAL
2018-02-16T00:00:00Z,1067,1422,60534,355,0.005864473,0.023490931,0.017626458,2018,AAL
2019-02-22T00:00:00Z,1074,1446,61840,372,0.006015524,0.023382924,0.0173674,2019,AAL
2011-02-25T00:00:00Z,684,1319,55901,635,0.011359367,0.023595285,0.012235917,2011,LMT
2012-02-23T00:00:00Z,717,1315,58679,598,0.010191039,0.022410062,0.012219022,2012,LMT
2013-02-28T00:00:00Z,768,1427,63062,659,0.010450033,0.022628524,0.012178491,2013,LMT
2014-02-14T00:00:00Z,777,1463,63628,686,0.010781417,0.022993022,0.012211605,2014,LMT
2015-02-09T00:00:00Z,774,1563,64590,789,0.012215513,0.024198792,0.011983279,2015,LMT
2016-02-24T00:00:00Z,870,1731,75177,861,0.011452971,0.023025659,0.011572688,2016,LMT
2017-02-09T00:00:00Z,903,1808,74880,905,0.012086004,0.024145299,0.012059295,2017,LMT
2018-02-06T00:00:00Z,903,1788,75075,885,0.011788212,0.023816184,0.012027972,2018,LMT
2019-02-08T00:00:00Z,929,1871,74389,942,0.012663163,0.025151568,0.012488406,2019,LMT
2007-02-28T00:00:00Z,584,947,44298,363,0.008194501,0.02137794,0.013183439,2007,MWV
2008-02-28T00:00:00Z,529,1019,44958,490,0.010899061,0.022665599,0.011766538,2008,MWV
2009-02-24T00:00:00Z,587,1048,45835,461,0.010057816,0.022864623,0.012806807,2009,MWV
2010-02-23T00:00:00Z,581,1010,43511,429,0.009859576,0.023212521,0.013352945,2010,MWV
2011-02-28T00:00:00Z,618,963,41689,345,0.008275564,0.023099619,0.014824054,2011,MWV
2012-02-27T00:00:00Z,592,972,42056,380,0.009035572,0.023112041,0.014076469,2012,MWV
2013-02-25T00:00:00Z,610,1037,43234,427,0.009876486,0.023985752,0.014109266,2013,MWV
2014-02-24T00:00:00Z,630,1044,42931,414,0.009643381,0.024318092,0.014674711,2014,MWV
2015-02-23T00:00:00Z,614,1102,45534,488,0.010717266,0.024201695,0.013484429,2015,MWV
2018-11-16T00:00:00Z,1205,1962,87346,757,0.008666682,0.022462391,0.013795709,2018,WRK
2010-08-26T00:00:00Z,687,917,49818,230,0.004616805,0.018407001,0.013790196,2010,CAH
2011-08-26T00:00:00Z,579,800,43669,221,0.005060798,0.018319632,0.013258833,2011,CAH
2012-08-22T00:00:00Z,519,806,42521,287,0.006749606,0.01895534,0.012205734,2012,CAH
2013-08-20T00:00:00Z,541,864,44539,323,0.007252071,0.019398729,0.012146658,2013,CAH
2014-08-13T00:00:00Z,539,833,42450,294,0.006925795,0.019623086,0.012697291,2014,CAH
2015-08-13T00:00:00Z,626,917,44643,291,0.006518379,0.020540734,0.014022355,2015,CAH
2016-08-12T00:00:00Z,617,920,43498,303,0.006965838,0.021150398,0.01418456,2016,CAH
2017-08-10T00:00:00Z,663,1038,45046,375,0.008324824,0.023043111,0.014718288,2017,CAH
2018-08-22T00:00:00Z,732,1170,48735,438,0.008987381,0.024007387,0.015020006,2018,CAH
2010-02-05T00:00:00Z,2919,4698,210434,1779,0.008453957,0.02232529,0.013871333,2010,EXC
2011-02-10T00:00:00Z,2747,4521,208005,1774,0.008528641,0.021735054,0.013206413,2011,EXC
2012-02-09T00:00:00Z,2919,4977,224081,2058,0.009184179,0.022210718,0.01302654,2012,EXC
2013-02-22T00:00:00Z,3036,4599,223863,1563,0.006981949,0.020543815,0.013561866,2013,EXC
2014-02-14T00:00:00Z,3077,4755,232586,1678,0.007214536,0.020444051,0.013229515,2014,EXC
2015-02-13T00:00:00Z,3088,4978,243251,1890,0.007769752,0.020464459,0.012694706,2015,EXC
2016-02-10T00:00:00Z,2978,4766,229532,1788,0.007789764,0.020763989,0.012974226,2016,EXC
2017-02-13T00:00:00Z,3519,5635,287440,2116,0.007361536,0.019604091,0.012242555,2017,EXC
2018-02-09T00:00:00Z,3299,5281,267432,1982,0.00741123,0.019747076,0.012335846,2018,EXC
2019-02-08T00:00:00Z,2915,4417,229587,1502,0.006542182,0.019238894,0.012696712,2019,EXC
2011-03-31T00:00:00Z,150,226,13106,76,0.005798871,0.01724401,0.01144514,2011,REI
2012-03-20T00:00:00Z,166,260,14949,94,0.006288046,0.017392468,0.011104422,2012,REI
2013-04-01T00:00:00Z,378,623,32288,245,0.007587958,0.019295094,0.011707136,2013,REI
2014-03-21T00:00:00Z,377,632,34629,255,0.00736377,0.018250599,0.010886829,2014,REI
2015-03-16T00:00:00Z,393,679,36593,286,0.007815702,0.018555461,0.010739759,2015,REI
2016-03-15T00:00:00Z,470,740,37804,270,0.007142101,0.019574648,0.012432547,2016,REI
2017-03-15T00:00:00Z,470,755,38144,285,0.007471686,0.019793414,0.012321728,2017,REI
2018-03-15T00:00:00Z,515,787,38950,272,0.006983312,0.020205392,0.01322208,2018,REI
2019-02-28T00:00:00Z,565,909,43677,344,0.007875999,0.020811869,0.01293587,2019,REI
2011-02-28T00:00:00Z,379,561,22710,182,0.008014091,0.024702774,0.016688683,2011,PFE
2012-02-28T00:00:00Z,522,717,29150,195,0.006689537,0.024596913,0.017907376,2012,PFE
2013-02-28T00:00:00Z,519,660,29464,141,0.004785501,0.022400217,0.017614716,2013,PFE
2014-02-28T00:00:00Z,530,702,30276,172,0.005681068,0.023186683,0.017505615,2014,PFE
2015-02-27T00:00:00Z,486,652,26783,166,0.006197961,0.0243438,0.018145839,2015,PFE
2016-02-29T00:00:00Z,621,778,32569,157,0.004820535,0.023887746,0.019067211,2016,PFE
2017-02-23T00:00:00Z,584,739,31229,155,0.004963335,0.023663902,0.018700567,2017,PFE
2018-02-22T00:00:00Z,616,795,32809,179,0.00545582,0.024231156,0.018775336,2018,PFE
2019-02-28T00:00:00Z,680,877,35960,197,0.005478309,0.024388209,0.0189099,2019,PFE
2009-11-23T00:00:00Z,121,193,10789,72,0.006673464,0.01788859,0.011215127,2009,EMR
2010-11-23T00:00:00Z,118,194,10727,76,0.007084926,0.018085206,0.01100028,2010,EMR
2011-11-22T00:00:00Z,123,210,11020,87,0.007894737,0.019056261,0.011161525,2011,EMR
2012-11-20T00:00:00Z,130,225,11427,95,0.008313643,0.019690207,0.011376564,2012,EMR
2013-11-19T00:00:00Z,125,236,11674,111,0.009508309,0.020215864,0.010707555,2013,EMR
2014-11-19T00:00:00Z,134,223,11159,89,0.007975625,0.01998387,0.012008244,2014,EMR
2015-11-18T00:00:00Z,145,264,11733,119,0.010142334,0.022500639,0.012358306,2015,EMR
2016-11-16T00:00:00Z,483,758,34592,275,0.007949815,0.021912581,0.013962766,2016,EMR
2017-11-20T00:00:00Z,490,777,33808,287,0.008489115,0.022982726,0.014493611,2017,EMR
2018-11-19T00:00:00Z,493,815,34553,322,0.009319017,0.023586953,0.014267936,2018,EMR
2010-03-01T00:00:00Z,59,114,8673,55,0.00634152,0.013144241,0.006802721,2010,JNJ
2011-02-25T00:00:00Z,70,118,8624,48,0.005565863,0.013682746,0.008116883,2011,JNJ
2012-02-23T00:00:00Z,72,114,8581,42,0.004894534,0.013285165,0.00839063,2012,JNJ
2013-02-22T00:00:00Z,64,110,8111,46,0.005671311,0.01356183,0.007890519,2013,JNJ
2014-02-21T00:00:00Z,60,112,8267,52,0.006290069,0.013547841,0.007257772,2014,JNJ
2015-02-24T00:00:00Z,77,110,8741,33,0.003775312,0.012584372,0.008809061,2015,JNJ
2016-02-24T00:00:00Z,771,998,50424,227,0.004501825,0.019792162,0.015290338,2016,JNJ
2017-02-27T00:00:00Z,899,1162,55689,263,0.004722656,0.02086588,0.016143224,2017,JNJ
2018-02-21T00:00:00Z,867,1136,55644,269,0.004834304,0.020415499,0.015581195,2018,JNJ
2019-02-20T00:00:00Z,952,1249,61178,297,0.004854686,0.020415836,0.015561149,2019,JNJ
2011-02-24T00:00:00Z,975,1499,60944,524,0.008598057,0.024596351,0.015998294,2011,GLW
2012-02-29T00:00:00Z,1335,1851,74575,516,0.006919209,0.02482065,0.017901442,2012,GLW
2013-02-27T00:00:00Z,1413,1882,74626,469,0.006284673,0.025219093,0.01893442,2013,GLW
2014-02-21T00:00:00Z,1290,1890,71724,600,0.008365401,0.026351012,0.017985612,2014,GLW
2015-02-20T00:00:00Z,1187,1751,68141,564,0.008276955,0.025696717,0.017419762,2015,GLW
2016-02-22T00:00:00Z,1134,1470,60068,336,0.005593661,0.024472265,0.018878604,2016,GLW
2017-02-17T00:00:00Z,1113,1439,61360,326,0.005312907,0.02345176,0.018138853,2017,GLW
2018-02-16T00:00:00Z,1067,1422,60534,355,0.005864473,0.023490931,0.017626458,2018,GLW
2019-02-22T00:00:00Z,1074,1446,61840,372,0.006015524,0.023382924,0.0173674,2019,GLW
2011-02-17T00:00:00Z,757,1261,57984,504,0.008692053,0.021747379,0.013055326,2011,PPG
2012-02-16T00:00:00Z,844,1278,59631,434,0.007278094,0.021431806,0.014153712,2012,PPG
2013-02-21T00:00:00Z,845,1340,62884,495,0.007871637,0.021309077,0.01343744,2013,PPG
2014-02-20T00:00:00Z,726,1266,57865,540,0.009332066,0.02187851,0.012546444,2014,PPG
2015-02-19T00:00:00Z,690,1265,56980,575,0.01009126,0.022200772,0.012109512,2015,PPG
2016-02-18T00:00:00Z,664,1238,55256,574,0.010388012,0.022404807,0.012016795,2016,PPG
2017-02-16T00:00:00Z,669,1281,55974,612,0.010933648,0.022885625,0.011951978,2017,PPG
2018-02-15T00:00:00Z,591,1242,49927,651,0.013039037,0.024876319,0.011837282,2018,PPG
2019-02-21T00:00:00Z,624,1256,49625,632,0.012735516,0.025309824,0.012574307,2019,PPG
2010-02-26T00:00:00Z,2771,3309,156835,538,0.003430357,0.021098607,0.01766825,2010,PPL
2011-02-28T00:00:00Z,2967,3529,174566,562,0.003219413,0.02021585,0.016996437,2011,PPL
2012-02-28T00:00:00Z,4207,5688,264632,1481,0.005596451,0.021493999,0.015897548,2012,PPL
2013-02-28T00:00:00Z,3923,5263,246401,1340,0.00543829,0.021359491,0.015921202,2013,PPL
2014-02-24T00:00:00Z,2651,3567,177170,916,0.005170176,0.020133205,0.01496303,2014,PPL
2015-02-23T00:00:00Z,2743,3565,176370,822,0.004660657,0.020213188,0.015552532,2015,PPL
2016-02-19T00:00:00Z,1929,2675,132571,746,0.005627173,0.020177867,0.014550694,2016,PPL
2017-02-17T00:00:00Z,1662,2544,127970,882,0.00689224,0.019879659,0.012987419,2017,PPL
2018-02-22T00:00:00Z,1709,2780,135519,1071,0.007902951,0.020513729,0.012610778,2018,PPL
2019-02-14T00:00:00Z,1831,2750,138774,919,0.006622278,0.019816392,0.013194114,2019,PPL
2010-02-16T00:00:00Z,1123,1892,73405,769,0.010476126,0.025774811,0.015298685,2010,MMM
2011-02-16T00:00:00Z,1092,1789,71068,697,0.009807508,0.025173074,0.015365565,2011,MMM
2012-02-16T00:00:00Z,1167,1867,73396,700,0.009537304,0.025437354,0.015900049,2012,MMM
2013-02-14T00:00:00Z,1183,1697,70812,514,0.007258657,0.023964865,0.016706208,2013,MMM
2014-02-13T00:00:00Z,1176,1663,69081,487,0.007049695,0.024073189,0.017023494,2014,MMM
2015-02-12T00:00:00Z,1161,1609,68575,448,0.006532993,0.023463361,0.016930368,2015,MMM
2016-02-11T00:00:00Z,1095,1675,67390,580,0.008606618,0.02485532,0.016248702,2016,MMM
2017-02-09T00:00:00Z,1222,1861,72779,639,0.008780005,0.025570563,0.016790558,2017,MMM
2018-02-08T00:00:00Z,1243,1852,76200,609,0.007992126,0.024304462,0.016312336,2018,MMM
2019-02-07T00:00:00Z,1229,1763,75989,534,0.007027333,0.023200726,0.016173394,2019,MMM
2003-03-21T00:00:00Z,270,295,17431,25,0.001434226,0.016923871,0.015489645,2003,MRK
2004-03-10T00:00:00Z,270,286,17524,16,0.000913034,0.016320475,0.015407441,2004,MRK
2005-03-11T00:00:00Z,351,344,21710,-7,-0.000322432,0.015845233,0.016167665,2005,MRK
2006-03-13T00:00:00Z,535,504,28568,-31,-0.00108513,0.017642117,0.018727247,2006,MRK
2007-02-28T00:00:00Z,1287,1627,80745,340,0.004210787,0.020149854,0.015939067,2007,MRK
2008-02-28T00:00:00Z,1554,1938,97080,384,0.003955501,0.019962917,0.016007417,2008,MRK
2009-02-27T00:00:00Z,1672,2183,104069,511,0.004910204,0.020976468,0.016066264,2009,MRK
2010-03-30T00:00:00Z,1327,1650,77704,323,0.0041568,0.021234428,0.017077628,2010,MRK
2010-02-16T00:00:00Z,1407,2066,87711,659,0.007513311,0.023554628,0.016041318,2010,MOT
2011-02-18T00:00:00Z,1446,1796,81792,350,0.004279147,0.021958138,0.017678991,2011,MOT
2012-02-15T00:00:00Z,1252,1609,71163,357,0.005016652,0.022610064,0.017593412,2012,MOT
2013-02-12T00:00:00Z,1038,1484,65341,446,0.00682573,0.022711621,0.015885891,2013,MOT
2014-02-13T00:00:00Z,1035,1495,65866,460,0.006983876,0.022697598,0.015713722,2014,MOT
2015-02-13T00:00:00Z,1063,1293,61145,230,0.00376155,0.021146455,0.017384905,2015,MOT
2016-02-23T00:00:00Z,1112,1369,63666,257,0.004036691,0.021502843,0.017466151,2016,MOT
2017-02-21T00:00:00Z,1102,1425,65366,323,0.004941407,0.021800324,0.016858917,2017,MOT
2018-02-16T00:00:00Z,1064,1379,63593,315,0.004953375,0.021684777,0.016731401,2018,MOT
2019-02-15T00:00:00Z,1021,1399,65910,378,0.005735093,0.021225914,0.015490821,2019,MOT
2010-02-16T00:00:00Z,1407,2066,87711,659,0.007513311,0.023554628,0.016041318,2010,MSI
2011-02-18T00:00:00Z,1446,1796,81792,350,0.004279147,0.021958138,0.017678991,2011,MSI
2012-02-15T00:00:00Z,1252,1609,71163,357,0.005016652,0.022610064,0.017593412,2012,MSI
2013-02-12T00:00:00Z,1038,1484,65341,446,0.00682573,0.022711621,0.015885891,2013,MSI
2014-02-13T00:00:00Z,1035,1495,65866,460,0.006983876,0.022697598,0.015713722,2014,MSI
2015-02-13T00:00:00Z,1063,1293,61145,230,0.00376155,0.021146455,0.017384905,2015,MSI
2016-02-23T00:00:00Z,1112,1369,63666,257,0.004036691,0.021502843,0.017466151,2016,MSI
2017-02-21T00:00:00Z,1102,1425,65366,323,0.004941407,0.021800324,0.016858917,2017,MSI
2018-02-16T00:00:00Z,1064,1379,63593,315,0.004953375,0.021684777,0.016731401,2018,MSI
2019-02-15T00:00:00Z,1021,1399,65910,378,0.005735093,0.021225914,0.015490821,2019,MSI
2011-02-16T00:00:00Z,2208,3007,160267,799,0.004985431,0.01876244,0.01377701,2011,FE
2012-02-28T00:00:00Z,2730,3380,184478,650,0.003523455,0.018321968,0.014798513,2012,FE
2013-02-25T00:00:00Z,2449,2823,151379,374,0.00247062,0.018648558,0.016177937,2013,FE
2014-02-27T00:00:00Z,2437,2876,151561,439,0.002896524,0.018975858,0.016079334,2014,FE
2015-02-17T00:00:00Z,2264,2693,136988,429,0.003131661,0.019658656,0.016526995,2015,FE
2016-02-16T00:00:00Z,2151,2769,135676,618,0.004554969,0.020408915,0.015853946,2016,FE
2017-02-21T00:00:00Z,2538,3153,149488,615,0.004114043,0.021091994,0.016977951,2017,FE
2018-02-20T00:00:00Z,2490,3110,144144,620,0.004301254,0.021575647,0.017274392,2018,FE
2019-02-19T00:00:00Z,1754,2433,109379,679,0.006207773,0.022243758,0.016035985,2019,FE
2010-03-01T00:00:00Z,1382,1583,78849,201,0.002549176,0.020076348,0.017527172,2010,CMS
2011-02-24T00:00:00Z,1247,1501,77083,254,0.003295149,0.019472517,0.016177367,2011,CMS
2012-02-23T00:00:00Z,1201,1423,74239,222,0.002990342,0.019167823,0.016177481,2012,CMS
2013-02-21T00:00:00Z,1151,1392,71442,241,0.003373366,0.019484337,0.016110971,2013,CMS
2014-02-06T00:00:00Z,1131,1345,69377,214,0.003084596,0.019386828,0.016302233,2014,CMS
2015-02-05T00:00:00Z,1055,1297,66768,242,0.003624491,0.019425473,0.015800983,2015,CMS
2016-02-11T00:00:00Z,1024,1333,66017,309,0.004680613,0.020191769,0.015511156,2016,CMS
2017-02-07T00:00:00Z,1086,1366,68411,280,0.004092909,0.019967549,0.01587464,2017,CMS
2018-02-14T00:00:00Z,1142,1417,72732,275,0.003781004,0.019482484,0.015701479,2018,CMS
2019-02-05T00:00:00Z,1096,1408,72012,312,0.004332611,0.019552297,0.015219686,2019,CMS
2010-02-24T00:00:00Z,583,894,44667,311,0.006962635,0.020014776,0.013052141,2010,CHD
2011-02-24T00:00:00Z,586,891,45582,305,0.006691238,0.01954719,0.012855952,2011,CHD
2012-02-24T00:00:00Z,756,961,52778,205,0.003884194,0.018208344,0.01432415,2012,CHD
2013-02-22T00:00:00Z,827,1105,53194,278,0.005226153,0.02077302,0.015546866,2013,CHD
2014-02-21T00:00:00Z,862,1110,54655,248,0.004537554,0.020309212,0.015771659,2014,CHD
2015-02-20T00:00:00Z,800,1152,53979,352,0.006521054,0.021341633,0.014820578,2015,CHD
2016-02-19T00:00:00Z,865,1149,52824,284,0.005376344,0.021751477,0.016375133,2016,CHD
2017-02-24T00:00:00Z,856,1056,50655,200,0.003948278,0.020846906,0.016898628,2017,CHD
2018-02-23T00:00:00Z,797,977,48043,180,0.003746644,0.020335949,0.016589305,2018,CHD
2019-02-21T00:00:00Z,850,1023,49362,173,0.00350472,0.020724444,0.017219724,2019,CHD
2010-02-26T00:00:00Z,2695,1970,82122,-725,-0.008828329,0.0239887,0.032817028,2010,CINF
2011-02-25T00:00:00Z,2914,2036,86633,-878,-0.010134706,0.023501437,0.033636143,2011,CINF
2012-02-29T00:00:00Z,3178,2113,89845,-1065,-0.011853748,0.023518281,0.03537203,2012,CINF
2013-02-27T00:00:00Z,3093,2163,88974,-930,-0.010452492,0.024310473,0.034762964,2013,CINF
2014-02-27T00:00:00Z,2972,2098,85640,-874,-0.010205511,0.024497898,0.03470341,2014,CINF
2015-02-27T00:00:00Z,2738,2048,85323,-690,-0.008086917,0.024002907,0.032089823,2015,CINF
2016-02-26T00:00:00Z,2744,1929,83329,-815,-0.009780509,0.023149204,0.032929712,2016,CINF
2017-02-24T00:00:00Z,2675,1900,84403,-775,-0.009182138,0.022511048,0.031693186,2017,CINF
2018-02-23T00:00:00Z,2674,1939,84424,-735,-0.008706055,0.022967403,0.031673458,2018,CINF
2019-02-22T00:00:00Z,2740,2013,85785,-727,-0.008474675,0.023465641,0.031940316,2019,CINF
2010-02-26T00:00:00Z,804,1261,64512,457,0.007083953,0.019546751,0.012462798,2010,WEC
2011-02-25T00:00:00Z,807,1148,59300,341,0.005750422,0.019359191,0.013608769,2011,WEC
2012-02-28T00:00:00Z,827,1190,62400,363,0.005817308,0.019070513,0.013253205,2012,WEC
2013-02-27T00:00:00Z,788,1097,59273,309,0.005213166,0.018507584,0.013294417,2013,WEC
2014-02-27T00:00:00Z,728,1094,58127,366,0.006296558,0.018820858,0.0125243,2014,WEC
2015-02-27T00:00:00Z,718,1101,58503,383,0.006546673,0.018819548,0.012272875,2015,WEC
2016-02-26T00:00:00Z,854,1472,72662,618,0.008505133,0.020258182,0.011753048,2016,WEC
2017-02-28T00:00:00Z,830,1562,74496,732,0.009826031,0.020967569,0.011141538,2017,WEC
2018-02-28T00:00:00Z,918,1666,80833,748,0.009253646,0.020610394,0.011356748,2018,WEC
2019-02-26T00:00:00Z,944,1694,84700,750,0.008854782,0.02,0.011145218,2019,WEC
2011-02-28T00:00:00Z,1244,1847,76848,603,0.007846658,0.024034458,0.016187799,2011,AWK
2012-02-28T00:00:00Z,1248,1874,77673,626,0.008059429,0.024126788,0.016067359,2012,AWK
2013-03-01T00:00:00Z,1181,1788,74350,607,0.008164089,0.02404842,0.015884331,2013,AWK
2014-02-27T00:00:00Z,1272,1915,79093,643,0.00812967,0.024212004,0.016082333,2014,AWK
2015-02-25T00:00:00Z,1286,1930,77178,644,0.008344347,0.025007126,0.01666278,2015,AWK
2016-02-25T00:00:00Z,1254,1797,70675,543,0.007683056,0.025426247,0.017743191,2016,AWK
2017-02-21T00:00:00Z,1249,1933,73981,684,0.009245617,0.02612833,0.016882713,2017,AWK
2018-02-20T00:00:00Z,1460,2221,85838,761,0.008865537,0.025874321,0.017008784,2018,AWK
2019-02-19T00:00:00Z,1456,2345,89026,889,0.009985847,0.02634062,0.016354773,2019,AWK
2010-02-25T00:00:00Z,951,1312,62986,361,0.005731432,0.020830026,0.015098593,2010,TXT
2011-03-01T00:00:00Z,882,1127,56066,245,0.00436985,0.020101309,0.015731459,2011,TXT
2012-02-23T00:00:00Z,878,1123,56047,245,0.004371331,0.020036755,0.015665424,2012,TXT
2013-02-15T00:00:00Z,793,1053,51617,260,0.0050371,0.020400256,0.015363156,2013,TXT
2014-02-14T00:00:00Z,759,997,47571,238,0.005003048,0.020958147,0.015955099,2014,TXT
2015-02-25T00:00:00Z,678,929,45239,251,0.00554831,0.020535379,0.014987069,2015,TXT
2016-02-24T00:00:00Z,656,888,42728,232,0.005429695,0.020782625,0.01535293,2016,TXT
2017-02-22T00:00:00Z,653,900,43296,247,0.005704915,0.02078714,0.015082225,2017,TXT
2018-02-15T00:00:00Z,659,886,43796,227,0.005183122,0.020230158,0.015047036,2018,TXT
2019-02-14T00:00:00Z,653,964,46462,311,0.006693642,0.020748138,0.014054496,2019,TXT
2010-07-30T00:00:00Z,388,622,29186,234,0.008017543,0.021311588,0.013294045,2010,CTAS
2011-07-29T00:00:00Z,370,578,30029,208,0.006926638,0.01924806,0.012321423,2011,CTAS
2012-07-30T00:00:00Z,354,627,30384,273,0.008984992,0.020635861,0.011650869,2012,CTAS
2013-07-30T00:00:00Z,372,630,31011,258,0.008319629,0.020315372,0.011995743,2013,CTAS
2014-07-30T00:00:00Z,441,676,34110,235,0.006889475,0.019818235,0.01292876,2014,CTAS
2015-07-30T00:00:00Z,460,702,35869,242,0.006746773,0.019571217,0.012824445,2015,CTAS
2016-07-29T00:00:00Z,460,746,36841,286,0.00776309,0.020249179,0.012486089,2016,CTAS
2017-07-31T00:00:00Z,576,924,43412,348,0.008016217,0.021284437,0.013268221,2017,CTAS
2018-07-27T00:00:00Z,566,912,41373,346,0.008362942,0.022043362,0.01368042,2018,CTAS
2010-02-25T00:00:00Z,1477,1888,95044,411,0.004324313,0.019864484,0.015540171,2010,PEG
2011-02-25T00:00:00Z,1556,1922,99267,366,0.003687026,0.019361923,0.015674897,2011,PEG
2012-02-27T00:00:00Z,1547,2063,100116,516,0.005154021,0.020606097,0.015452076,2012,PEG
2013-02-26T00:00:00Z,1543,2070,96234,527,0.005476235,0.021510069,0.016033834,2013,PEG
2014-02-26T00:00:00Z,1526,1959,91209,433,0.004747339,0.021478144,0.016730805,2014,PEG
2015-02-26T00:00:00Z,1533,2099,95695,566,0.005914625,0.02193427,0.016019646,2015,PEG
2016-02-26T00:00:00Z,1549,2200,99929,651,0.006514625,0.022015631,0.015501006,2016,PEG
2017-02-27T00:00:00Z,1684,2321,104629,637,0.006088178,0.022183142,0.016094964,2017,PEG
2018-02-26T00:00:00Z,1657,2347,105802,690,0.006521616,0.022182946,0.01566133,2018,PEG
2019-02-28T00:00:00Z,1704,2436,105715,732,0.006924278,0.023043088,0.01611881,2019,PEG
2010-02-17T00:00:00Z,813,958,43333,145,0.00334618,0.022107862,0.018761683,2010,HAL
2011-02-17T00:00:00Z,1314,1210,53073,-104,-0.001959565,0.022798787,0.024758352,2011,HAL
2012-02-16T00:00:00Z,1684,1431,61578,-253,-0.00410861,0.023238819,0.027347429,2012,HAL
2013-02-11T00:00:00Z,1588,1314,57701,-274,-0.004748618,0.022772569,0.027521187,2013,HAL
2014-02-07T00:00:00Z,1090,1066,45917,-24,-0.000522682,0.023215802,0.023738485,2014,HAL
2015-02-24T00:00:00Z,1055,1052,48123,-3,-6.23E-05,0.021860649,0.021922989,2015,HAL
2016-02-05T00:00:00Z,971,966,47994,-5,-0.00010418,0.020127516,0.020231696,2016,HAL
2017-02-07T00:00:00Z,883,914,44210,31,0.000701199,0.020674056,0.019972857,2017,HAL
2018-02-09T00:00:00Z,798,836,39556,38,0.000960663,0.021134594,0.020173931,2018,HAL
2019-02-13T00:00:00Z,711,754,37277,43,0.001153526,0.02022695,0.019073423,2019,HAL
2010-02-26T00:00:00Z,1258,1918,94843,660,0.006958869,0.020222895,0.013264026,2010,XEL
2011-02-28T00:00:00Z,1252,1869,93403,617,0.006605784,0.020010064,0.01340428,2011,XEL
2012-02-24T00:00:00Z,1218,1720,90618,502,0.005539738,0.018980776,0.013441038,2012,XEL
2013-02-22T00:00:00Z,1270,1870,95304,600,0.006295643,0.019621422,0.013325779,2013,XEL
2014-02-21T00:00:00Z,1308,1909,97159,601,0.006185737,0.019648206,0.013462469,2014,XEL
2015-02-20T00:00:00Z,1262,1894,95635,632,0.006608459,0.019804465,0.013196006,2015,XEL
2016-02-19T00:00:00Z,1195,1813,91916,618,0.00672353,0.019724531,0.013001001,2016,XEL
2017-02-24T00:00:00Z,1179,1779,90067,600,0.006661707,0.019751962,0.013090255,2017,XEL
2018-02-23T00:00:00Z,1162,1740,89348,578,0.006469087,0.019474415,0.013005327,2018,XEL
2019-02-22T00:00:00Z,870,1307,62879,437,0.006949856,0.020785954,0.013836098,2019,XEL
2011-02-28T00:00:00Z,3053,5090,246442,2037,0.008265637,0.020653947,0.01238831,2011,ETR
2012-02-28T00:00:00Z,3064,5133,252468,2069,0.008195098,0.02033129,0.012136192,2012,ETR
2013-02-27T00:00:00Z,3288,5483,268589,2195,0.008172338,0.02041409,0.012241752,2013,ETR
2014-02-27T00:00:00Z,3238,5349,262025,2111,0.008056483,0.020414083,0.012357599,2014,ETR
2015-02-26T00:00:00Z,3162,5183,264964,2021,0.007627451,0.019561148,0.011933697,2015,ETR
2016-02-26T00:00:00Z,3156,5302,262713,2146,0.00816861,0.020181719,0.012013109,2016,ETR
2017-02-24T00:00:00Z,3169,5670,261982,2501,0.009546457,0.021642708,0.012096251,2017,ETR
2018-02-26T00:00:00Z,3136,5572,258189,2436,0.009434949,0.02158109,0.012146141,2018,ETR
2019-02-26T00:00:00Z,3118,5417,255146,2299,0.009010527,0.021230981,0.012220454,2019,ETR
2011-02-24T00:00:00Z,975,1499,60944,524,0.008598057,0.024596351,0.015998294,2011,WR
2012-02-29T00:00:00Z,1335,1851,74575,516,0.006919209,0.02482065,0.017901442,2012,WR
2013-02-27T00:00:00Z,1413,1882,74626,469,0.006284673,0.025219093,0.01893442,2013,WR
2014-02-21T00:00:00Z,1290,1890,71724,600,0.008365401,0.026351012,0.017985612,2014,WR
2015-02-20T00:00:00Z,1187,1751,68141,564,0.008276955,0.025696717,0.017419762,2015,WR
2016-02-22T00:00:00Z,1134,1470,60068,336,0.005593661,0.024472265,0.018878604,2016,WR
2017-02-17T00:00:00Z,1113,1439,61360,326,0.005312907,0.02345176,0.018138853,2017,WR
2018-02-16T00:00:00Z,1067,1422,60534,355,0.005864473,0.023490931,0.017626458,2018,WR
2019-02-22T00:00:00Z,1074,1446,61840,372,0.006015524,0.023382924,0.0173674,2019,WR
2019-02-22T00:00:00Z,938,1641,74748,703,0.009404934,0.021953765,0.012548831,2019,EVRG
2010-02-26T00:00:00Z,475,633,40953,158,0.003858081,0.015456743,0.011598662,2010,AEP
2011-02-25T00:00:00Z,492,685,43126,193,0.004475259,0.01588369,0.011408431,2011,AEP
2012-02-28T00:00:00Z,513,595,38353,82,0.002138034,0.01551378,0.013375746,2012,AEP
2013-02-26T00:00:00Z,510,630,39508,120,0.00303736,0.015946137,0.012908778,2013,AEP
2014-02-25T00:00:00Z,537,697,42096,160,0.003800836,0.016557393,0.012756556,2014,AEP
2015-02-20T00:00:00Z,483,619,37954,136,0.003583285,0.016309216,0.012725931,2015,AEP
2016-02-24T00:00:00Z,473,659,37672,186,0.004937354,0.017493098,0.012555744,2016,AEP
2017-02-28T00:00:00Z,488,678,38637,190,0.004917566,0.017547946,0.01263038,2017,AEP
2018-02-23T00:00:00Z,515,656,40741,141,0.003460887,0.016101716,0.012640829,2018,AEP
2019-02-21T00:00:00Z,480,653,39448,173,0.00438552,0.016553437,0.012167917,2019,AEP
2010-02-26T00:00:00Z,1085,1726,77162,641,0.008307198,0.022368523,0.014061326,2010,FPL
2011-02-28T00:00:00Z,1228,1844,82445,616,0.007471648,0.022366426,0.014894778,2011,FPL
2012-02-28T00:00:00Z,1334,1847,83924,513,0.006112673,0.022008007,0.015895334,2012,FPL
2013-02-28T00:00:00Z,1373,1911,85997,538,0.006256032,0.022221705,0.015965673,2013,FPL
2014-02-24T00:00:00Z,1371,1987,88931,616,0.006926718,0.022343165,0.015416446,2014,FPL
2015-02-20T00:00:00Z,1343,1946,88080,603,0.006846049,0.022093551,0.015247502,2015,FPL
2016-02-22T00:00:00Z,1392,1896,88778,504,0.005677082,0.021356642,0.01567956,2016,FPL
2017-02-23T00:00:00Z,1229,1787,80587,558,0.006924194,0.022174792,0.015250599,2017,FPL
2018-02-16T00:00:00Z,1209,1734,77537,525,0.006770961,0.022363517,0.015592556,2018,FPL
2019-02-15T00:00:00Z,1211,1773,79449,562,0.00707372,0.022316203,0.015242483,2019,FPL
2010-02-26T00:00:00Z,1085,1726,77162,641,0.008307198,0.022368523,0.014061326,2010,NEE
2011-02-28T00:00:00Z,1228,1844,82445,616,0.007471648,0.022366426,0.014894778,2011,NEE
2012-02-28T00:00:00Z,1334,1847,83924,513,0.006112673,0.022008007,0.015895334,2012,NEE
2013-02-28T00:00:00Z,1373,1911,85997,538,0.006256032,0.022221705,0.015965673,2013,NEE
2014-02-24T00:00:00Z,1371,1987,88931,616,0.006926718,0.022343165,0.015416446,2014,NEE
2015-02-20T00:00:00Z,1343,1946,88080,603,0.006846049,0.022093551,0.015247502,2015,NEE
2016-02-22T00:00:00Z,1392,1896,88778,504,0.005677082,0.021356642,0.01567956,2016,NEE
2017-02-23T00:00:00Z,1229,1787,80587,558,0.006924194,0.022174792,0.015250599,2017,NEE
2018-02-16T00:00:00Z,1209,1734,77537,525,0.006770961,0.022363517,0.015592556,2018,NEE
2019-02-15T00:00:00Z,1211,1773,79449,562,0.00707372,0.022316203,0.015242483,2019,NEE
2012-02-16T00:00:00Z,1509,2269,96581,760,0.007869043,0.023493234,0.015624191,2012,AA
2013-02-15T00:00:00Z,1542,2229,100310,687,0.006848769,0.022221115,0.015372346,2013,AA
2014-02-13T00:00:00Z,1653,2284,103164,631,0.006116475,0.022139506,0.016023031,2014,AA
2015-02-19T00:00:00Z,1601,2182,104813,581,0.005543206,0.020818028,0.015274823,2015,AA
2016-02-19T00:00:00Z,1599,2262,111049,663,0.005970337,0.020369386,0.014399049,2016,AA
2017-02-28T00:00:00Z,1254,1799,77125,545,0.007066451,0.02332577,0.016259319,2017,AA
2018-02-26T00:00:00Z,1268,1926,77400,658,0.008501292,0.024883721,0.016382429,2018,AA
2019-02-21T00:00:00Z,1248,1836,75550,588,0.007782925,0.024301787,0.016518862,2019,AA
2011-02-24T00:00:00Z,975,1499,60944,524,0.008598057,0.024596351,0.015998294,2011,ARNC
2012-02-29T00:00:00Z,1335,1851,74575,516,0.006919209,0.02482065,0.017901442,2012,ARNC
2013-02-27T00:00:00Z,1413,1882,74626,469,0.006284673,0.025219093,0.01893442,2013,ARNC
2014-02-21T00:00:00Z,1290,1890,71724,600,0.008365401,0.026351012,0.017985612,2014,ARNC
2015-02-20T00:00:00Z,1187,1751,68141,564,0.008276955,0.025696717,0.017419762,2015,ARNC
2016-02-22T00:00:00Z,1134,1470,60068,336,0.005593661,0.024472265,0.018878604,2016,ARNC
2017-02-17T00:00:00Z,1113,1439,61360,326,0.005312907,0.02345176,0.018138853,2017,ARNC
2018-02-16T00:00:00Z,1067,1422,60534,355,0.005864473,0.023490931,0.017626458,2018,ARNC
2019-02-22T00:00:00Z,1074,1446,61840,372,0.006015524,0.023382924,0.0173674,2019,ARNC
2010-02-26T00:00:00Z,1745,2513,132942,768,0.005776955,0.01890298,0.013126025,2010,AEE
2011-02-24T00:00:00Z,1756,2347,126948,591,0.004655449,0.018487885,0.013832435,2011,AEE
2012-02-28T00:00:00Z,1760,2311,126086,551,0.004370033,0.01832876,0.013958727,2012,AEE
2013-03-01T00:00:00Z,1706,2434,125740,728,0.005789725,0.019357404,0.013567679,2013,AEE
2014-03-03T00:00:00Z,1622,2224,108291,602,0.005559095,0.020537256,0.014978161,2014,AEE
2015-03-02T00:00:00Z,1495,2024,100981,529,0.005238609,0.020043374,0.014804765,2015,AEE
2016-02-26T00:00:00Z,1409,1989,97076,580,0.0059747,0.020489101,0.014514401,2016,AEE
2017-02-28T00:00:00Z,1214,1875,93998,661,0.007032065,0.019947233,0.012915168,2017,AEE
2018-02-28T00:00:00Z,1284,1864,97519,580,0.005947559,0.019114224,0.013166665,2018,AEE
2019-02-26T00:00:00Z,1295,1907,98508,612,0.006212693,0.019358834,0.01314614,2019,AEE
2010-02-23T00:00:00Z,678,949,51603,271,0.005251633,0.018390404,0.013138771,2010,CMCSA
2011-02-25T00:00:00Z,875,1117,62965,242,0.003843405,0.017740014,0.013896609,2011,CMCSA
2012-02-23T00:00:00Z,898,1275,70731,377,0.005330053,0.018026042,0.012695989,2012,CMCSA
2013-02-21T00:00:00Z,832,1168,67485,336,0.004978884,0.01730755,0.012328666,2013,CMCSA
2014-02-12T00:00:00Z,990,1564,85479,574,0.0067151,0.018296892,0.011581792,2014,CMCSA
2015-02-27T00:00:00Z,931,1547,84305,616,0.007306803,0.018350039,0.011043236,2015,CMCSA
2016-02-05T00:00:00Z,891,1527,82688,636,0.007691563,0.018467009,0.010775445,2016,CMCSA
2017-02-03T00:00:00Z,866,1446,79576,580,0.00728863,0.018171308,0.010882678,2017,CMCSA
2018-01-31T00:00:00Z,869,1528,78707,659,0.008372826,0.019413775,0.011040949,2018,CMCSA
2019-01-31T00:00:00Z,944,1604,85456,660,0.007723273,0.018769893,0.01104662,2019,CMCSA
2011-02-24T00:00:00Z,975,1499,60944,524,0.008598057,0.024596351,0.015998294,2011,CMA
2012-02-29T00:00:00Z,1335,1851,74575,516,0.006919209,0.02482065,0.017901442,2012,CMA
2013-02-27T00:00:00Z,1413,1882,74626,469,0.006284673,0.025219093,0.01893442,2013,CMA
2014-02-21T00:00:00Z,1290,1890,71724,600,0.008365401,0.026351012,0.017985612,2014,CMA
2015-02-20T00:00:00Z,1187,1751,68141,564,0.008276955,0.025696717,0.017419762,2015,CMA
2016-02-22T00:00:00Z,1134,1470,60068,336,0.005593661,0.024472265,0.018878604,2016,CMA
2017-02-17T00:00:00Z,1113,1439,61360,326,0.005312907,0.02345176,0.018138853,2017,CMA
2018-02-16T00:00:00Z,1067,1422,60534,355,0.005864473,0.023490931,0.017626458,2018,CMA
2019-02-22T00:00:00Z,1074,1446,61840,372,0.006015524,0.023382924,0.0173674,2019,CMA
2011-02-22T00:00:00Z,1229,1447,72478,218,0.003007809,0.019964679,0.01695687,2011,OKE
2012-02-21T00:00:00Z,1455,1529,79151,74,0.000934922,0.019317507,0.018382585,2012,OKE
2013-02-26T00:00:00Z,1547,1628,83968,81,0.000964653,0.019388338,0.018423685,2013,OKE
2014-02-25T00:00:00Z,1571,1728,91177,157,0.001721925,0.018952148,0.017230223,2014,OKE
2015-02-25T00:00:00Z,1618,1524,88045,-94,-0.001067636,0.01730933,0.018376966,2015,OKE
2016-02-23T00:00:00Z,1634,1560,90394,-74,-0.000818638,0.017257783,0.018076421,2016,OKE
2017-02-28T00:00:00Z,1460,1455,81154,-5,-6.16E-05,0.017928876,0.017990487,2017,OKE
2018-02-27T00:00:00Z,1288,1364,76199,76,0.000997388,0.017900497,0.016903109,2018,OKE
2019-02-26T00:00:00Z,1205,1267,71619,62,0.000865692,0.017690836,0.016825144,2019,OKE
2009-09-30T00:00:00Z,507,972,41443,465,0.01122023,0.023453901,0.01223367,2009,CPB
2010-09-29T00:00:00Z,518,984,40091,466,0.011623556,0.024544162,0.012920606,2010,CPB
2011-09-28T00:00:00Z,527,1041,40899,514,0.012567544,0.025452945,0.012885401,2011,CPB
2012-09-27T00:00:00Z,511,995,38893,484,0.012444399,0.02558301,0.013138611,2012,CPB
2013-09-26T00:00:00Z,641,1049,43301,408,0.009422415,0.024225768,0.014803353,2013,CPB
2014-09-24T00:00:00Z,690,1065,44264,375,0.008471896,0.024060184,0.015588288,2014,CPB
2015-09-29T00:00:00Z,708,1200,46006,492,0.010694257,0.026083554,0.015389297,2015,CPB
2016-09-22T00:00:00Z,747,1283,43834,536,0.012227951,0.029269517,0.017041566,2016,CPB
2017-09-27T00:00:00Z,724,1371,44788,647,0.014445834,0.030610878,0.016165044,2017,CPB
2018-09-27T00:00:00Z,754,1460,50823,706,0.013891348,0.028727151,0.014835803,2018,CPB
2014-02-18T00:00:00Z,1588,1658,87222,70,0.00080255,0.019008966,0.018206416,2014,F
2015-02-13T00:00:00Z,1442,1428,76037,-14,-0.000184121,0.018780331,0.018964452,2015,F
2016-02-11T00:00:00Z,1342,1391,71847,49,0.000682005,0.019360586,0.018678581,2016,F
2017-02-09T00:00:00Z,1269,1370,67768,101,0.001490379,0.020216031,0.018725652,2017,F
2018-02-08T00:00:00Z,1284,1378,68281,94,0.001376664,0.02018131,0.018804646,2018,F
2019-02-21T00:00:00Z,1322,1361,67794,39,0.000575272,0.020075523,0.019500251,2019,F
2011-02-11T00:00:00Z,600,1052,43852,452,0.010307398,0.023989784,0.013682386,2011,DOV
2012-02-10T00:00:00Z,585,1115,43950,530,0.012059158,0.025369738,0.01331058,2012,DOV
2013-02-15T00:00:00Z,656,1203,47671,547,0.011474481,0.025235468,0.013760987,2013,DOV
2014-02-14T00:00:00Z,713,1369,52025,656,0.012609322,0.026314272,0.01370495,2014,DOV
2015-02-13T00:00:00Z,727,1327,50704,600,0.011833386,0.026171505,0.014338119,2015,DOV
2016-02-12T00:00:00Z,810,1380,51234,570,0.011125425,0.026935238,0.015809814,2016,DOV
2017-02-10T00:00:00Z,819,1367,51978,548,0.010542922,0.026299588,0.015756666,2017,DOV
2018-02-09T00:00:00Z,745,1462,53453,717,0.013413653,0.027351131,0.013937478,2018,DOV
2019-02-15T00:00:00Z,712,1542,58806,830,0.014114206,0.026221814,0.012107608,2019,DOV
2011-02-24T00:00:00Z,975,1499,60944,524,0.008598057,0.024596351,0.015998294,2011,DAL
2012-02-29T00:00:00Z,1335,1851,74575,516,0.006919209,0.02482065,0.017901442,2012,DAL
2013-02-27T00:00:00Z,1413,1882,74626,469,0.006284673,0.025219093,0.01893442,2013,DAL
2014-02-21T00:00:00Z,1290,1890,71724,600,0.008365401,0.026351012,0.017985612,2014,DAL
2015-02-20T00:00:00Z,1187,1751,68141,564,0.008276955,0.025696717,0.017419762,2015,DAL
2016-02-22T00:00:00Z,1134,1470,60068,336,0.005593661,0.024472265,0.018878604,2016,DAL
2017-02-17T00:00:00Z,1113,1439,61360,326,0.005312907,0.02345176,0.018138853,2017,DAL
2018-02-16T00:00:00Z,1067,1422,60534,355,0.005864473,0.023490931,0.017626458,2018,DAL
2019-02-22T00:00:00Z,1074,1446,61840,372,0.006015524,0.023382924,0.0173674,2019,DAL
2011-02-11T00:00:00Z,1280,1775,79333,495,0.006239522,0.022374044,0.016134522,2011,CE
2012-02-10T00:00:00Z,1206,1677,73354,471,0.006420918,0.022861739,0.016440821,2012,CE
2013-02-08T00:00:00Z,1244,1656,71648,412,0.005750335,0.023112997,0.017362662,2013,CE
2014-02-07T00:00:00Z,1291,1768,75779,477,0.00629462,0.023331002,0.017036382,2014,CE
2015-02-06T00:00:00Z,1106,1527,66818,421,0.006300697,0.022853123,0.016552426,2015,CE
2016-02-05T00:00:00Z,1119,1504,66383,385,0.005799678,0.022656403,0.016856725,2016,CE
2017-02-10T00:00:00Z,1107,1497,65689,390,0.005937067,0.022789204,0.016852137,2017,CE
2018-02-09T00:00:00Z,1110,1465,67172,355,0.00528494,0.021809683,0.016524742,2018,CE
2019-02-07T00:00:00Z,1088,1469,65848,381,0.005786053,0.022308954,0.016522901,2019,CE
2004-03-15T00:00:00Z,775,934,53687,159,0.002961611,0.017397135,0.014435524,2004,MEE
2005-03-16T00:00:00Z,827,1013,56523,186,0.003290696,0.017921908,0.014631212,2005,MEE
2006-03-16T00:00:00Z,854,1112,60313,258,0.004277685,0.018437153,0.014159468,2006,MEE
2007-03-01T00:00:00Z,879,1050,56767,171,0.003012313,0.018496662,0.015484348,2007,MEE
2008-02-29T00:00:00Z,980,1134,59008,154,0.002609816,0.019217733,0.016607918,2008,MEE
2009-03-02T00:00:00Z,1121,1290,68182,169,0.00247866,0.01891995,0.016441289,2009,MEE
2010-03-01T00:00:00Z,1108,1255,65299,147,0.002251183,0.019219284,0.016968101,2010,MEE
2011-03-01T00:00:00Z,1465,1751,83992,286,0.003405086,0.020847224,0.017442137,2011,MEE
2011-02-24T00:00:00Z,975,1499,60944,524,0.008598057,0.024596351,0.015998294,2011,SNS
2012-02-29T00:00:00Z,1335,1851,74575,516,0.006919209,0.02482065,0.017901442,2012,SNS
2013-02-27T00:00:00Z,1413,1882,74626,469,0.006284673,0.025219093,0.01893442,2013,SNS
2014-02-21T00:00:00Z,1290,1890,71724,600,0.008365401,0.026351012,0.017985612,2014,SNS
2015-02-20T00:00:00Z,1187,1751,68141,564,0.008276955,0.025696717,0.017419762,2015,SNS
2016-02-22T00:00:00Z,1134,1470,60068,336,0.005593661,0.024472265,0.018878604,2016,SNS
2017-02-17T00:00:00Z,1113,1439,61360,326,0.005312907,0.02345176,0.018138853,2017,SNS
2018-02-16T00:00:00Z,1067,1422,60534,355,0.005864473,0.023490931,0.017626458,2018,SNS
2019-02-22T00:00:00Z,1074,1446,61840,372,0.006015524,0.023382924,0.0173674,2019,SNS
2011-02-24T00:00:00Z,975,1499,60944,524,0.008598057,0.024596351,0.015998294,2011,BH
2012-02-29T00:00:00Z,1335,1851,74575,516,0.006919209,0.02482065,0.017901442,2012,BH
2013-02-27T00:00:00Z,1413,1882,74626,469,0.006284673,0.025219093,0.01893442,2013,BH
2014-02-21T00:00:00Z,1290,1890,71724,600,0.008365401,0.026351012,0.017985612,2014,BH
2015-02-20T00:00:00Z,1187,1751,68141,564,0.008276955,0.025696717,0.017419762,2015,BH
2016-02-22T00:00:00Z,1134,1470,60068,336,0.005593661,0.024472265,0.018878604,2016,BH
2017-02-17T00:00:00Z,1113,1439,61360,326,0.005312907,0.02345176,0.018138853,2017,BH
2018-02-16T00:00:00Z,1067,1422,60534,355,0.005864473,0.023490931,0.017626458,2018,BH
2019-02-22T00:00:00Z,1074,1446,61840,372,0.006015524,0.023382924,0.0173674,2019,BH
2010-02-24T00:00:00Z,2620,2020,106092,-600,-0.005655469,0.019040078,0.024695547,2010,LTR
2011-02-23T00:00:00Z,2093,1908,93297,-185,-0.001982915,0.020450818,0.022433733,2011,LTR
2012-02-22T00:00:00Z,1984,1807,91023,-177,-0.001944563,0.019852125,0.021796689,2012,LTR
2013-02-22T00:00:00Z,1903,1745,88618,-158,-0.001782933,0.019691259,0.021474193,2013,LTR
2014-02-24T00:00:00Z,1975,1886,92233,-89,-0.000964947,0.020448213,0.02141316,2014,LTR
2015-02-24T00:00:00Z,2069,1815,87228,-254,-0.002911909,0.020807539,0.023719448,2015,LTR
2016-02-19T00:00:00Z,2113,1827,87596,-286,-0.003264989,0.020857117,0.024122106,2016,LTR
2017-02-16T00:00:00Z,2168,1747,86112,-421,-0.004888982,0.020287533,0.025176514,2017,LTR
2018-02-15T00:00:00Z,2091,1740,85423,-351,-0.004108964,0.020369221,0.024478185,2018,LTR
2019-02-13T00:00:00Z,2181,1792,86296,-389,-0.004507741,0.020765737,0.025273477,2019,LTR
2010-02-24T00:00:00Z,2620,2020,106092,-600,-0.005655469,0.019040078,0.024695547,2010,L
2011-02-23T00:00:00Z,2093,1908,93297,-185,-0.001982915,0.020450818,0.022433733,2011,L
2012-02-22T00:00:00Z,1984,1807,91023,-177,-0.001944563,0.019852125,0.021796689,2012,L
2013-02-22T00:00:00Z,1903,1745,88618,-158,-0.001782933,0.019691259,0.021474193,2013,L
2014-02-24T00:00:00Z,1975,1886,92233,-89,-0.000964947,0.020448213,0.02141316,2014,L
2015-02-24T00:00:00Z,2069,1815,87228,-254,-0.002911909,0.020807539,0.023719448,2015,L
2016-02-19T00:00:00Z,2113,1827,87596,-286,-0.003264989,0.020857117,0.024122106,2016,L
2017-02-16T00:00:00Z,2168,1747,86112,-421,-0.004888982,0.020287533,0.025176514,2017,L
2018-02-15T00:00:00Z,2091,1740,85423,-351,-0.004108964,0.020369221,0.024478185,2018,L
2019-02-13T00:00:00Z,2181,1792,86296,-389,-0.004507741,0.020765737,0.025273477,2019,L
2010-02-26T00:00:00Z,660,1084,44243,424,0.009583437,0.024501051,0.014917614,2010,K
2011-02-25T00:00:00Z,664,1082,44286,418,0.009438649,0.0244321,0.014993452,2011,K
2012-02-29T00:00:00Z,674,1054,43857,380,0.008664523,0.024032652,0.015368128,2012,K
2013-02-26T00:00:00Z,748,1121,47749,373,0.007811682,0.023476931,0.01566525,2013,K
2014-02-24T00:00:00Z,756,1255,51607,499,0.009669231,0.024318406,0.014649175,2014,K
2015-02-25T00:00:00Z,817,1296,54486,479,0.008791249,0.023785927,0.014994678,2015,K
2016-02-24T00:00:00Z,899,1491,60008,592,0.009865351,0.024846687,0.014981336,2016,K
2017-02-21T00:00:00Z,1022,1724,67738,702,0.010363459,0.025451002,0.015087543,2017,K
2018-02-20T00:00:00Z,1073,1879,73125,806,0.011022222,0.025695726,0.014673504,2018,K
2019-02-25T00:00:00Z,1055,1788,69378,733,0.010565309,0.025771859,0.01520655,2019,K
2011-11-23T00:00:00Z,1559,1816,85944,257,0.002990319,0.021130038,0.018139719,2011,VAR
2012-11-21T00:00:00Z,1575,1815,87831,240,0.00273252,0.020664686,0.017932165,2012,VAR
2013-11-26T00:00:00Z,1653,1896,86516,243,0.002808729,0.021915021,0.019106292,2013,VAR
2014-11-25T00:00:00Z,1594,1974,84368,380,0.004504077,0.023397497,0.018893419,2014,VAR
2015-11-25T00:00:00Z,1664,2034,86333,370,0.004285731,0.023559937,0.019274206,2015,VAR
2016-11-23T00:00:00Z,1703,2094,90127,391,0.004338323,0.023233881,0.018895558,2016,VAR
2017-11-27T00:00:00Z,1607,1946,81686,339,0.004150038,0.023822932,0.019672894,2017,VAR
2018-11-26T00:00:00Z,1577,2009,85021,432,0.005081098,0.023629456,0.018548359,2018,VAR
2010-12-15T00:00:00Z,1379,1862,77029,483,0.006270366,0.024172714,0.017902348,2010,HWP
2011-12-14T00:00:00Z,1395,1839,77735,444,0.005711713,0.023657297,0.017945584,2011,HWP
2012-12-27T00:00:00Z,1591,2056,84961,465,0.005473099,0.024199339,0.018726239,2012,HWP
2013-12-30T00:00:00Z,1688,2001,83002,313,0.003770993,0.024107853,0.020336859,2013,HWP
2014-12-18T00:00:00Z,1700,2043,83868,343,0.00408976,0.024359708,0.020269948,2014,HWP
2015-12-16T00:00:00Z,1667,2120,88443,453,0.005121943,0.023970241,0.018848298,2015,HWP
2016-12-15T00:00:00Z,1437,1786,71245,349,0.004898589,0.025068426,0.020169836,2016,HWP
2017-12-14T00:00:00Z,1303,1660,66689,357,0.005353207,0.024891661,0.019538455,2017,HWP
2018-12-13T00:00:00Z,1245,1682,67226,437,0.006500461,0.025020082,0.01851962,2018,HWP
2010-12-15T00:00:00Z,1379,1862,77029,483,0.006270366,0.024172714,0.017902348,2010,HPQ
2011-12-14T00:00:00Z,1395,1839,77735,444,0.005711713,0.023657297,0.017945584,2011,HPQ
2012-12-27T00:00:00Z,1591,2056,84961,465,0.005473099,0.024199339,0.018726239,2012,HPQ
2013-12-30T00:00:00Z,1688,2001,83002,313,0.003770993,0.024107853,0.020336859,2013,HPQ
2014-12-18T00:00:00Z,1700,2043,83868,343,0.00408976,0.024359708,0.020269948,2014,HPQ
2015-12-16T00:00:00Z,1667,2120,88443,453,0.005121943,0.023970241,0.018848298,2015,HPQ
2016-12-15T00:00:00Z,1437,1786,71245,349,0.004898589,0.025068426,0.020169836,2016,HPQ
2017-12-14T00:00:00Z,1303,1660,66689,357,0.005353207,0.024891661,0.019538455,2017,HPQ
2018-12-13T00:00:00Z,1245,1682,67226,437,0.006500461,0.025020082,0.01851962,2018,HPQ
2010-02-23T00:00:00Z,806,1255,54185,449,0.008286426,0.023161392,0.014874965,2010,BAX
2011-02-23T00:00:00Z,838,1195,53183,357,0.006712671,0.022469586,0.015756915,2011,BAX
2012-02-23T00:00:00Z,795,1223,53204,428,0.008044508,0.022986993,0.014942486,2012,BAX
2013-02-21T00:00:00Z,849,1248,56016,399,0.007122965,0.022279349,0.015156384,2013,BAX
2014-02-21T00:00:00Z,858,1275,56456,417,0.007386283,0.022583959,0.015197676,2014,BAX
2015-02-26T00:00:00Z,893,1289,55766,396,0.007101101,0.023114442,0.016013341,2015,BAX
2016-02-26T00:00:00Z,894,1296,55199,402,0.007282741,0.023478686,0.016195946,2016,BAX
2017-02-23T00:00:00Z,914,1313,53767,399,0.007420909,0.024420183,0.016999275,2017,BAX
2018-02-23T00:00:00Z,1001,1380,58235,379,0.006508114,0.023697089,0.017188976,2018,BAX
2019-02-21T00:00:00Z,996,1411,60571,415,0.006851464,0.023294976,0.016443513,2019,BAX
2012-02-28T00:00:00Z,2064,3878,171202,1814,0.010595671,0.022651605,0.012055934,2012,DUK
2013-03-01T00:00:00Z,2511,6140,196859,3629,0.018434514,0.031189836,0.012755322,2013,DUK
2014-02-28T00:00:00Z,1818,3613,140812,1795,0.012747493,0.025658325,0.012910831,2014,DUK
2015-03-02T00:00:00Z,2019,3652,145590,1633,0.01121643,0.02508414,0.013867711,2015,DUK
2016-02-25T00:00:00Z,1986,3614,146897,1628,0.011082595,0.024602272,0.013519677,2016,DUK
2017-02-24T00:00:00Z,1973,3679,149044,1706,0.011446284,0.024683986,0.013237702,2017,DUK
2018-02-21T00:00:00Z,2037,3741,160545,1704,0.010613847,0.023301878,0.012688031,2018,DUK
2019-02-28T00:00:00Z,2042,3538,154720,1496,0.00966908,0.022867115,0.013198035,2019,DUK
2011-02-23T00:00:00Z,252,469,21504,217,0.010091146,0.021809896,0.01171875,2011,XRX
2012-02-23T00:00:00Z,218,470,20441,252,0.012328164,0.022993004,0.01066484,2012,XRX
2013-02-21T00:00:00Z,236,514,21588,278,0.012877525,0.023809524,0.010931999,2013,XRX
2014-02-21T00:00:00Z,1025,1787,70422,762,0.010820482,0.025375593,0.014555111,2014,XRX
2015-02-24T00:00:00Z,1159,1808,74171,649,0.008750051,0.024376104,0.015626053,2015,XRX
2016-02-19T00:00:00Z,1187,1861,75537,674,0.00892278,0.024636933,0.015714153,2016,XRX
2017-02-27T00:00:00Z,1159,1682,69063,523,0.007572796,0.024354575,0.016781779,2017,XRX
2018-02-23T00:00:00Z,1300,1928,80337,628,0.007817071,0.023998905,0.016181834,2018,XRX
2019-02-25T00:00:00Z,1220,1993,80544,773,0.009597239,0.024744239,0.015147,2019,XRX
2010-02-19T00:00:00Z,1031,2138,77209,1107,0.014337707,0.027691072,0.013353366,2010,PNW
2011-02-18T00:00:00Z,1022,2167,79534,1145,0.014396359,0.027246209,0.01284985,2011,PNW
2012-02-24T00:00:00Z,1018,2128,78360,1110,0.014165391,0.027156713,0.012991322,2012,PNW
2013-02-22T00:00:00Z,1080,2292,81431,1212,0.014883767,0.028146529,0.013262762,2013,PNW
2014-02-21T00:00:00Z,1075,2280,82610,1205,0.014586612,0.027599564,0.013012952,2014,PNW
2015-02-20T00:00:00Z,1028,2219,82542,1191,0.014429018,0.026883284,0.012454266,2015,PNW
2016-02-19T00:00:00Z,1010,2201,82927,1191,0.014362029,0.026541416,0.012179387,2016,PNW
2017-02-24T00:00:00Z,1062,2316,88411,1254,0.014183755,0.026195835,0.01201208,2017,PNW
2018-02-23T00:00:00Z,1185,2484,92723,1299,0.014009469,0.02678947,0.012780001,2018,PNW
2019-02-22T00:00:00Z,1186,2519,99772,1333,0.013360462,0.025247564,0.011887103,2019,PNW
2011-02-24T00:00:00Z,975,1499,60944,524,0.008598057,0.024596351,0.015998294,2011,APD
2012-02-29T00:00:00Z,1335,1851,74575,516,0.006919209,0.02482065,0.017901442,2012,APD
2013-02-27T00:00:00Z,1413,1882,74626,469,0.006284673,0.025219093,0.01893442,2013,APD
2014-02-21T00:00:00Z,1290,1890,71724,600,0.008365401,0.026351012,0.017985612,2014,APD
2015-02-20T00:00:00Z,1187,1751,68141,564,0.008276955,0.025696717,0.017419762,2015,APD
2016-02-22T00:00:00Z,1134,1470,60068,336,0.005593661,0.024472265,0.018878604,2016,APD
2017-02-17T00:00:00Z,1113,1439,61360,326,0.005312907,0.02345176,0.018138853,2017,APD
2018-02-16T00:00:00Z,1067,1422,60534,355,0.005864473,0.023490931,0.017626458,2018,APD
2019-02-22T00:00:00Z,1074,1446,61840,372,0.006015524,0.023382924,0.0173674,2019,APD
2014-02-24T00:00:00Z,974,1308,73211,334,0.004562156,0.017866168,0.013304012,2014,VNO
2015-02-17T00:00:00Z,949,1252,72198,303,0.004196792,0.017341201,0.013144408,2015,VNO
2016-02-16T00:00:00Z,907,1230,68043,323,0.004746998,0.018076804,0.013329806,2016,VNO
2017-02-13T00:00:00Z,995,1542,77947,547,0.007017589,0.019782673,0.012765084,2017,VNO
2018-02-12T00:00:00Z,974,1444,76620,470,0.006134169,0.018846254,0.012712086,2018,VNO
2019-02-11T00:00:00Z,958,1425,75476,467,0.006187397,0.018880174,0.012692777,2019,VNO
2011-02-25T00:00:00Z,793,968,52244,175,0.003349667,0.018528443,0.015178777,2011,AHC
2012-02-27T00:00:00Z,906,1083,56367,177,0.003140135,0.01921337,0.016073234,2012,AHC
2013-02-28T00:00:00Z,862,1096,57003,234,0.004105047,0.019227058,0.015122011,2013,AHC
2014-02-28T00:00:00Z,924,1102,59229,178,0.003005285,0.018605751,0.015600466,2014,AHC
2015-02-27T00:00:00Z,974,1030,57190,56,0.000979192,0.018010142,0.017030949,2015,AHC
2016-02-26T00:00:00Z,1101,1089,58060,-12,-0.000206683,0.018756459,0.018963142,2016,AHC
2017-02-23T00:00:00Z,1140,1095,57374,-45,-0.000784327,0.0190853,0.019869627,2017,AHC
2018-02-21T00:00:00Z,1173,1082,58431,-91,-0.001557392,0.018517568,0.02007496,2018,AHC
2019-02-21T00:00:00Z,1138,1110,57582,-28,-0.000486263,0.019276857,0.01976312,2019,AHC
2011-02-25T00:00:00Z,793,968,52244,175,0.003349667,0.018528443,0.015178777,2011,HES
2012-02-27T00:00:00Z,906,1083,56367,177,0.003140135,0.01921337,0.016073234,2012,HES
2013-02-28T00:00:00Z,862,1096,57003,234,0.004105047,0.019227058,0.015122011,2013,HES
2014-02-28T00:00:00Z,924,1102,59229,178,0.003005285,0.018605751,0.015600466,2014,HES
2015-02-27T00:00:00Z,974,1030,57190,56,0.000979192,0.018010142,0.017030949,2015,HES
2016-02-26T00:00:00Z,1101,1089,58060,-12,-0.000206683,0.018756459,0.018963142,2016,HES
2017-02-23T00:00:00Z,1140,1095,57374,-45,-0.000784327,0.0190853,0.019869627,2017,HES
2018-02-21T00:00:00Z,1173,1082,58431,-91,-0.001557392,0.018517568,0.02007496,2018,HES
2019-02-21T00:00:00Z,1138,1110,57582,-28,-0.000486263,0.019276857,0.01976312,2019,HES
2010-02-19T00:00:00Z,791,998,46936,207,0.004410261,0.021262996,0.016852736,2010,ALK
2011-02-23T00:00:00Z,711,908,44932,197,0.004384403,0.020208315,0.015823912,2011,ALK
2012-02-21T00:00:00Z,619,798,37498,179,0.004773588,0.021281135,0.016507547,2012,ALK
2013-02-14T00:00:00Z,572,829,37780,257,0.006802541,0.021942827,0.015140286,2013,ALK
2014-02-13T00:00:00Z,581,878,39485,297,0.007521844,0.022236292,0.014714449,2014,ALK
2015-02-11T00:00:00Z,597,903,39346,306,0.007777157,0.022950236,0.01517308,2015,ALK
2016-02-11T00:00:00Z,579,930,40095,351,0.008754209,0.023194912,0.014440703,2016,ALK
2017-02-28T00:00:00Z,717,1136,47740,419,0.008776707,0.023795559,0.015018852,2017,ALK
2018-02-15T00:00:00Z,667,1141,48109,474,0.009852626,0.023716976,0.01386435,2018,ALK
2019-02-15T00:00:00Z,695,1066,47334,371,0.007837918,0.02252081,0.014682892,2019,ALK
2010-03-31T00:00:00Z,902,1281,64944,379,0.005835797,0.019724686,0.013888889,2010,DG
2011-03-22T00:00:00Z,857,1199,57529,342,0.005944828,0.020841662,0.014896835,2011,DG
2012-03-22T00:00:00Z,845,1202,57701,357,0.006187068,0.020831528,0.01464446,2012,DG
2013-03-25T00:00:00Z,799,1157,55226,358,0.006482454,0.020950277,0.014467823,2013,DG
2014-03-20T00:00:00Z,786,1069,48731,283,0.005807392,0.021936755,0.016129363,2014,DG
2015-03-20T00:00:00Z,859,1125,50818,266,0.005234366,0.022137825,0.016903459,2015,DG
2016-03-22T00:00:00Z,696,1038,44294,342,0.007721136,0.023434325,0.015713189,2016,DG
2017-03-24T00:00:00Z,644,1032,43681,388,0.008882581,0.023625833,0.014743252,2017,DG
2018-03-23T00:00:00Z,668,1093,46266,425,0.009186011,0.02362426,0.014438248,2018,DG
2019-03-22T00:00:00Z,639,1047,43359,408,0.009409811,0.024147236,0.014737425,2019,DG
2011-02-23T00:00:00Z,565,876,39342,311,0.007905038,0.02226628,0.014361242,2011,OMC
2012-02-17T00:00:00Z,519,876,38017,357,0.009390536,0.023042323,0.013651787,2012,OMC
2013-02-19T00:00:00Z,512,922,39320,410,0.010427263,0.023448627,0.013021363,2013,OMC
2014-02-12T00:00:00Z,551,950,40981,399,0.009736219,0.023181474,0.013445255,2014,OMC
2015-02-10T00:00:00Z,532,826,37385,294,0.007864117,0.022094423,0.014230306,2015,OMC
2016-02-09T00:00:00Z,519,797,36032,278,0.007715364,0.022119227,0.014403863,2016,OMC
2017-02-09T00:00:00Z,515,775,35103,260,0.007406774,0.022077885,0.014671111,2017,OMC
2018-02-15T00:00:00Z,530,804,37042,274,0.007397009,0.021705092,0.014308083,2018,OMC
2019-02-12T00:00:00Z,523,895,40175,372,0.00925949,0.022277536,0.013018046,2019,OMC
2012-02-22T00:00:00Z,869,1656,63878,787,0.012320361,0.025924418,0.013604058,2012,FLS
2013-02-21T00:00:00Z,788,1489,59646,701,0.011752674,0.024963954,0.01321128,2013,FLS
2014-02-18T00:00:00Z,826,1479,59035,653,0.011061235,0.025052935,0.0139917,2014,FLS
2015-02-17T00:00:00Z,868,1487,60065,619,0.010305502,0.024756514,0.014451011,2015,FLS
2016-02-18T00:00:00Z,927,1528,61887,601,0.009711248,0.024690161,0.014978913,2016,FLS
2017-02-16T00:00:00Z,929,1541,63201,612,0.009683391,0.024382526,0.014699135,2017,FLS
2018-02-28T00:00:00Z,883,1466,59952,583,0.009724446,0.024452896,0.014728449,2018,FLS
2019-02-20T00:00:00Z,913,1598,63495,685,0.010788251,0.025167336,0.014379085,2019,FLS
2010-11-24T00:00:00Z,220,201,15555,-19,-0.001221472,0.01292189,0.014143362,2010,HP
2011-11-23T00:00:00Z,252,209,16006,-43,-0.002686493,0.013057603,0.015744096,2011,HP
2012-11-21T00:00:00Z,275,237,17585,-38,-0.002160933,0.013477396,0.015638328,2012,HP
2013-11-27T00:00:00Z,710,804,41705,94,0.002253926,0.019278264,0.017024338,2013,HP
2014-11-26T00:00:00Z,742,800,42856,58,0.001353369,0.018667164,0.017313795,2014,HP
2015-11-25T00:00:00Z,881,893,48710,12,0.000246356,0.018332991,0.018086635,2015,HP
2016-11-23T00:00:00Z,1034,954,51373,-80,-0.001557238,0.018570066,0.020127304,2016,HP
2017-11-22T00:00:00Z,1056,971,49809,-85,-0.001706519,0.019494469,0.021200988,2017,HP
2018-11-16T00:00:00Z,1250,1421,58563,171,0.002919932,0.024264467,0.021344535,2018,HP
2010-02-26T00:00:00Z,1266,1291,67514,25,0.000370294,0.01912196,0.018751666,2010,HOC
2011-02-25T00:00:00Z,1292,1265,67315,-27,-0.000401099,0.018792245,0.019193345,2011,HOC
2012-02-29T00:00:00Z,1208,1236,65798,28,0.000425545,0.018784765,0.018359221,2012,HOC
2013-02-28T00:00:00Z,1032,1039,57720,7,0.000121275,0.018000693,0.017879418,2013,HOC
2014-02-26T00:00:00Z,1064,1068,57133,4,7.00E-05,0.018693225,0.018623213,2014,HOC
2015-02-25T00:00:00Z,1065,1051,55688,-14,-0.000251401,0.018873007,0.019124407,2015,HOC
2016-02-24T00:00:00Z,1109,1025,55651,-84,-0.001509407,0.018418357,0.019927764,2016,HOC
2017-02-22T00:00:00Z,1228,1143,57490,-85,-0.001478518,0.019881719,0.021360237,2017,HOC
2018-02-21T00:00:00Z,1173,1167,58986,-6,-0.000101719,0.019784356,0.019886075,2018,HOC
2019-02-20T00:00:00Z,1151,1147,59105,-4,-6.77E-05,0.019406142,0.019473818,2019,HOC
2010-02-26T00:00:00Z,1266,1291,67514,25,0.000370294,0.01912196,0.018751666,2010,HFC
2011-02-25T00:00:00Z,1292,1265,67315,-27,-0.000401099,0.018792245,0.019193345,2011,HFC
2012-02-29T00:00:00Z,1208,1236,65798,28,0.000425545,0.018784765,0.018359221,2012,HFC
2013-02-28T00:00:00Z,1032,1039,57720,7,0.000121275,0.018000693,0.017879418,2013,HFC
2014-02-26T00:00:00Z,1064,1068,57133,4,7.00E-05,0.018693225,0.018623213,2014,HFC
2015-02-25T00:00:00Z,1065,1051,55688,-14,-0.000251401,0.018873007,0.019124407,2015,HFC
2016-02-24T00:00:00Z,1109,1025,55651,-84,-0.001509407,0.018418357,0.019927764,2016,HFC
2017-02-22T00:00:00Z,1228,1143,57490,-85,-0.001478518,0.019881719,0.021360237,2017,HFC
2018-02-21T00:00:00Z,1173,1167,58986,-6,-0.000101719,0.019784356,0.019886075,2018,HFC
2019-02-20T00:00:00Z,1151,1147,59105,-4,-6.77E-05,0.019406142,0.019473818,2019,HFC
2011-02-24T00:00:00Z,975,1499,60944,524,0.008598057,0.024596351,0.015998294,2011,HRL
2012-02-29T00:00:00Z,1335,1851,74575,516,0.006919209,0.02482065,0.017901442,2012,HRL
2013-02-27T00:00:00Z,1413,1882,74626,469,0.006284673,0.025219093,0.01893442,2013,HRL
2014-02-21T00:00:00Z,1290,1890,71724,600,0.008365401,0.026351012,0.017985612,2014,HRL
2015-02-20T00:00:00Z,1187,1751,68141,564,0.008276955,0.025696717,0.017419762,2015,HRL
2016-02-22T00:00:00Z,1134,1470,60068,336,0.005593661,0.024472265,0.018878604,2016,HRL
2017-02-17T00:00:00Z,1113,1439,61360,326,0.005312907,0.02345176,0.018138853,2017,HRL
2018-02-16T00:00:00Z,1067,1422,60534,355,0.005864473,0.023490931,0.017626458,2018,HRL
2019-02-22T00:00:00Z,1074,1446,61840,372,0.006015524,0.023382924,0.0173674,2019,HRL
2009-11-16T00:00:00Z,949,1183,62494,234,0.003744359,0.018929817,0.015185458,2009,ATO
2010-11-12T00:00:00Z,980,1314,65153,334,0.005126395,0.020167912,0.015041518,2010,ATO
2011-11-22T00:00:00Z,1050,1289,66389,239,0.003599994,0.019415867,0.015815873,2011,ATO
2012-11-13T00:00:00Z,981,1180,61244,199,0.003249298,0.019267194,0.016017896,2012,ATO
2013-11-13T00:00:00Z,849,1078,54621,229,0.004192527,0.019735999,0.015543472,2013,ATO
2014-11-06T00:00:00Z,860,1112,53942,252,0.004671684,0.020614734,0.01594305,2014,ATO
2015-11-06T00:00:00Z,792,1048,49942,256,0.005125946,0.020984342,0.015858396,2015,ATO
2016-11-14T00:00:00Z,798,1064,50118,266,0.005307474,0.021229897,0.015922423,2016,ATO
2017-11-13T00:00:00Z,750,987,46852,237,0.005058482,0.021066337,0.016007855,2017,ATO
2018-11-13T00:00:00Z,738,1083,49598,345,0.006955926,0.021835558,0.014879632,2018,ATO
2011-02-24T00:00:00Z,975,1499,60944,524,0.008598057,0.024596351,0.015998294,2011,MAS
2012-02-29T00:00:00Z,1335,1851,74575,516,0.006919209,0.02482065,0.017901442,2012,MAS
2013-02-27T00:00:00Z,1413,1882,74626,469,0.006284673,0.025219093,0.01893442,2013,MAS
2014-02-21T00:00:00Z,1290,1890,71724,600,0.008365401,0.026351012,0.017985612,2014,MAS
2015-02-20T00:00:00Z,1187,1751,68141,564,0.008276955,0.025696717,0.017419762,2015,MAS
2016-02-22T00:00:00Z,1134,1470,60068,336,0.005593661,0.024472265,0.018878604,2016,MAS
2017-02-17T00:00:00Z,1113,1439,61360,326,0.005312907,0.02345176,0.018138853,2017,MAS
2018-02-16T00:00:00Z,1067,1422,60534,355,0.005864473,0.023490931,0.017626458,2018,MAS
2019-02-22T00:00:00Z,1074,1446,61840,372,0.006015524,0.023382924,0.0173674,2019,MAS
2004-03-30T00:00:00Z,653,921,51473,268,0.005206613,0.017892876,0.012686263,2004,MXM
2005-03-16T00:00:00Z,796,1084,58840,288,0.00489463,0.018422842,0.013528212,2005,MXM
2006-03-15T00:00:00Z,991,1288,67365,297,0.004408818,0.019119721,0.014710903,2006,MXM
2007-04-02T00:00:00Z,934,1293,65331,359,0.005495094,0.019791523,0.014296429,2007,MXM
2008-04-29T00:00:00Z,669,906,44793,237,0.005291005,0.020226375,0.014935369,2008,MXM
2009-03-31T00:00:00Z,644,898,42510,254,0.005975065,0.021124441,0.015149377,2009,MXM
2011-02-28T00:00:00Z,1922,2351,111039,429,0.003863507,0.021172741,0.017309234,2011,FITB
2012-02-29T00:00:00Z,2095,2466,115919,371,0.003200511,0.021273475,0.018072965,2012,FITB
2013-02-22T00:00:00Z,2267,2522,121558,255,0.002097764,0.020747298,0.018649534,2013,FITB
2014-02-24T00:00:00Z,2269,2559,125339,290,0.002313725,0.02041663,0.018102905,2014,FITB
2015-02-25T00:00:00Z,2303,2606,124942,303,0.002425125,0.020857678,0.018432553,2015,FITB
2016-02-25T00:00:00Z,2307,2630,129528,323,0.002493669,0.02030449,0.017810821,2016,FITB
2017-02-24T00:00:00Z,2509,2774,134822,265,0.001965555,0.020575277,0.018609722,2017,FITB
2018-02-28T00:00:00Z,2408,2677,128802,269,0.002088477,0.020783839,0.018695362,2018,FITB
2019-03-01T00:00:00Z,2678,2963,140215,285,0.002032593,0.021131833,0.01909924,2019,FITB
2010-02-25T00:00:00Z,274,187,13136,-87,-0.006623021,0.014235688,0.020858709,2010,NUE
2011-02-28T00:00:00Z,233,173,11838,-60,-0.005068424,0.014613955,0.019682379,2011,NUE
2012-02-28T00:00:00Z,279,221,13281,-58,-0.004367141,0.016640313,0.021007454,2012,NUE
2013-02-28T00:00:00Z,296,241,14283,-55,-0.003850732,0.016873206,0.020723938,2013,NUE
2014-02-28T00:00:00Z,309,263,14941,-46,-0.003078777,0.01760257,0.020681347,2014,NUE
2015-02-27T00:00:00Z,305,260,15173,-45,-0.002965795,0.017135702,0.020101496,2015,NUE
2016-02-26T00:00:00Z,307,258,15773,-49,-0.003106575,0.016357066,0.01946364,2016,NUE
2017-02-28T00:00:00Z,291,255,14876,-36,-0.002420005,0.017141705,0.01956171,2017,NUE
2018-02-28T00:00:00Z,295,252,14562,-43,-0.002952891,0.017305315,0.020258206,2018,NUE
2019-02-28T00:00:00Z,288,248,14490,-40,-0.002760524,0.017115252,0.019875776,2019,NUE
2012-02-24T00:00:00Z,2581,2685,120841,104,0.000860635,0.02221928,0.021358645,2012,RGBK
2013-02-21T00:00:00Z,2462,2599,117770,137,0.001163284,0.022068438,0.020905154,2013,RGBK
2014-02-21T00:00:00Z,2372,2506,110209,134,0.001215872,0.022738615,0.021522743,2014,RGBK
2015-02-17T00:00:00Z,2342,2436,109987,94,0.000854646,0.022148072,0.021293426,2015,RGBK
2016-02-16T00:00:00Z,2211,2513,110385,302,0.002735879,0.022765774,0.020029895,2016,RGBK
2017-02-24T00:00:00Z,2263,2470,110058,207,0.001880826,0.022442712,0.020561886,2017,RGBK
2018-02-26T00:00:00Z,2136,2421,104249,285,0.002733839,0.023223244,0.020489405,2018,RGBK
2019-02-22T00:00:00Z,2250,2466,104794,216,0.002061187,0.023531882,0.021470695,2019,RGBK
2012-02-24T00:00:00Z,2581,2685,120841,104,0.000860635,0.02221928,0.021358645,2012,RF
2013-02-21T00:00:00Z,2462,2599,117770,137,0.001163284,0.022068438,0.020905154,2013,RF
2014-02-21T00:00:00Z,2372,2506,110209,134,0.001215872,0.022738615,0.021522743,2014,RF
2015-02-17T00:00:00Z,2342,2436,109987,94,0.000854646,0.022148072,0.021293426,2015,RF
2016-02-16T00:00:00Z,2211,2513,110385,302,0.002735879,0.022765774,0.020029895,2016,RF
2017-02-24T00:00:00Z,2263,2470,110058,207,0.001880826,0.022442712,0.020561886,2017,RF
2018-02-26T00:00:00Z,2136,2421,104249,285,0.002733839,0.023223244,0.020489405,2018,RF
2019-02-22T00:00:00Z,2250,2466,104794,216,0.002061187,0.023531882,0.021470695,2019,RF
2005-10-14T00:00:00Z,456,788,37556,332,0.008840132,0.020982,0.012141868,2005,PLL
2006-10-13T00:00:00Z,489,906,42162,417,0.009890423,0.021488544,0.011598122,2006,PLL
2008-03-28T00:00:00Z,822,1472,74519,650,0.008722608,0.019753351,0.011030744,2008,PLL
2008-09-29T00:00:00Z,608,938,46746,330,0.007059428,0.020065888,0.01300646,2008,PLL
2009-09-29T00:00:00Z,688,1023,48402,335,0.006921202,0.02113549,0.014214289,2009,PLL
2010-09-28T00:00:00Z,822,1291,52790,469,0.008884258,0.024455389,0.015571131,2010,PLL
2011-09-29T00:00:00Z,785,1156,51507,371,0.007202904,0.022443551,0.015240647,2011,PLL
2012-10-01T00:00:00Z,729,1090,49463,361,0.007298385,0.022036674,0.014738289,2012,PLL
2013-09-10T00:00:00Z,717,1059,43418,342,0.007876917,0.024390806,0.016513888,2013,PLL
2014-09-08T00:00:00Z,721,1072,44443,351,0.007897757,0.024120784,0.016223027,2014,PLL
2010-02-19T00:00:00Z,1279,1972,97374,693,0.00711689,0.020251813,0.013134923,2010,MTB
2011-02-22T00:00:00Z,1392,2025,99455,633,0.006364688,0.020360967,0.01399628,2011,MTB
2012-02-23T00:00:00Z,1522,2262,103234,740,0.007168181,0.021911386,0.014743205,2012,MTB
2013-02-25T00:00:00Z,1628,2267,104044,639,0.006141632,0.021788859,0.015647226,2013,MTB
2014-02-21T00:00:00Z,1636,2210,102296,574,0.005611168,0.021603973,0.015992805,2014,MTB
2015-02-20T00:00:00Z,1602,2033,97763,431,0.004408621,0.020795188,0.016386568,2015,MTB
2016-02-19T00:00:00Z,1675,2171,102059,496,0.004859934,0.021272009,0.016412075,2016,MTB
2017-02-22T00:00:00Z,1676,2168,100085,492,0.004915822,0.021661588,0.016745766,2017,MTB
2018-02-22T00:00:00Z,1575,2041,95658,466,0.004871521,0.021336428,0.016464906,2018,MTB
2019-02-20T00:00:00Z,1637,2097,96860,460,0.004749122,0.021649804,0.016900681,2019,MTB
2011-02-25T00:00:00Z,464,594,30155,130,0.00431106,0.019698226,0.015387166,2011,ROL
2012-02-28T00:00:00Z,445,572,29928,127,0.004243518,0.019112537,0.014869019,2012,ROL
2013-02-27T00:00:00Z,472,560,29909,88,0.002942258,0.018723461,0.015781203,2013,ROL
2014-02-26T00:00:00Z,470,578,30332,108,0.003560596,0.019055783,0.015495187,2014,ROL
2015-02-25T00:00:00Z,482,555,29478,73,0.002476423,0.0188276,0.016351177,2015,ROL
2016-02-24T00:00:00Z,465,584,32359,119,0.003677493,0.018047529,0.014370036,2016,ROL
2017-02-24T00:00:00Z,501,605,32863,104,0.003164653,0.018409762,0.015245108,2017,ROL
2018-02-26T00:00:00Z,493,618,31961,125,0.003911017,0.019336066,0.015425049,2018,ROL
2019-03-01T00:00:00Z,493,625,32278,132,0.004089473,0.019363034,0.015273561,2019,ROL
2010-02-24T00:00:00Z,237,179,14030,-58,-0.004133999,0.012758375,0.016892373,2010,SHW
2011-02-23T00:00:00Z,251,191,15109,-60,-0.003971143,0.012641472,0.016612615,2011,SHW
2012-02-23T00:00:00Z,247,202,15406,-45,-0.00292094,0.013111775,0.016032715,2012,SHW
2013-02-28T00:00:00Z,282,239,16897,-43,-0.00254483,0.014144523,0.016689353,2013,SHW
2014-02-27T00:00:00Z,297,246,17647,-51,-0.00289001,0.013940046,0.016830056,2014,SHW
2015-02-25T00:00:00Z,267,226,15972,-41,-0.002566992,0.014149762,0.016716754,2015,SHW
2016-02-24T00:00:00Z,279,234,16100,-45,-0.002795031,0.014534161,0.017329193,2016,SHW
2017-02-22T00:00:00Z,312,260,17996,-52,-0.002889531,0.014447655,0.017337186,2017,SHW
2018-02-23T00:00:00Z,321,261,17641,-60,-0.003401168,0.01479508,0.018196247,2018,SHW
2019-02-22T00:00:00Z,315,264,17798,-51,-0.002865491,0.014833127,0.017698618,2019,SHW
2009-11-24T00:00:00Z,821,1405,59379,584,0.009835127,0.023661564,0.013826437,2009,BEN
2010-11-16T00:00:00Z,832,1472,59569,640,0.010743843,0.02471084,0.013966996,2010,BEN
2011-11-15T00:00:00Z,888,1536,61265,648,0.010577002,0.025071411,0.01449441,2011,BEN
2012-11-15T00:00:00Z,915,1537,61841,622,0.010058052,0.024854061,0.014796009,2012,BEN
2013-11-12T00:00:00Z,915,1472,61247,557,0.009094323,0.02403383,0.014939507,2013,BEN
2014-11-12T00:00:00Z,839,1388,56772,549,0.00967026,0.024448672,0.014778412,2014,BEN
2015-11-12T00:00:00Z,796,1338,55050,542,0.009845595,0.024305177,0.014459582,2015,BEN
2016-11-14T00:00:00Z,825,1303,55473,478,0.008616805,0.023488905,0.0148721,2016,BEN
2017-11-13T00:00:00Z,806,1317,53291,511,0.009588861,0.024713366,0.015124505,2017,BEN
2018-11-09T00:00:00Z,815,1279,52420,464,0.008851583,0.024399084,0.015547501,2018,BEN
2010-02-05T00:00:00Z,972,1098,55442,126,0.002272645,0.01980448,0.017531835,2010,AJG
2011-02-07T00:00:00Z,944,1208,55973,264,0.00471656,0.021581834,0.016865274,2011,AJG
2012-02-14T00:00:00Z,975,1200,57301,225,0.003926633,0.020942043,0.01701541,2012,AJG
2013-02-08T00:00:00Z,1006,1283,59544,277,0.004652022,0.021547091,0.016895069,2013,AJG
2014-02-07T00:00:00Z,1071,1290,60857,219,0.0035986,0.021197233,0.017598633,2014,AJG
2015-02-13T00:00:00Z,1264,1428,69065,164,0.002374575,0.020676175,0.0183016,2015,AJG
2016-02-10T00:00:00Z,1271,1455,68730,184,0.002677142,0.021169795,0.018492652,2016,AJG
2017-02-13T00:00:00Z,1288,1499,70613,211,0.002988118,0.021228386,0.018240267,2017,AJG
2018-02-12T00:00:00Z,1385,1644,74980,259,0.003454254,0.021925847,0.018471592,2018,AJG
2019-02-08T00:00:00Z,1426,1792,77804,366,0.004704128,0.023032235,0.018328107,2019,AJG
2004-03-30T00:00:00Z,653,921,51473,268,0.005206613,0.017892876,0.012686263,2004,WMB
2005-03-16T00:00:00Z,796,1084,58840,288,0.00489463,0.018422842,0.013528212,2005,WMB
2006-03-15T00:00:00Z,991,1288,67365,297,0.004408818,0.019119721,0.014710903,2006,WMB
2007-04-02T00:00:00Z,934,1293,65331,359,0.005495094,0.019791523,0.014296429,2007,WMB
2008-04-29T00:00:00Z,669,906,44793,237,0.005291005,0.020226375,0.014935369,2008,WMB
2009-03-31T00:00:00Z,644,898,42510,254,0.005975065,0.021124441,0.015149377,2009,WMB
2010-02-26T00:00:00Z,160,242,13859,82,0.005916733,0.017461577,0.011544845,2010,WFC
2011-02-25T00:00:00Z,182,327,15635,145,0.009274065,0.020914615,0.01164055,2011,WFC
2012-02-28T00:00:00Z,189,322,15594,133,0.008528921,0.020648968,0.012120046,2012,WFC
2013-02-27T00:00:00Z,194,249,13966,55,0.003938135,0.017829013,0.013890878,2013,WFC
2014-02-26T00:00:00Z,160,284,13872,124,0.00893887,0.020472895,0.011534025,2014,WFC
2015-02-25T00:00:00Z,138,266,13296,128,0.009626955,0.020006017,0.010379061,2015,WFC
2016-02-24T00:00:00Z,130,272,13525,142,0.010499076,0.020110906,0.00961183,2016,WFC
2017-03-01T00:00:00Z,116,241,12443,125,0.010045809,0.01936832,0.009322511,2017,WFC
2018-03-01T00:00:00Z,116,259,12748,143,0.011217446,0.020316912,0.009099467,2018,WFC
2019-02-27T00:00:00Z,116,209,11245,93,0.008270342,0.018586038,0.010315696,2019,WFC
2012-02-29T00:00:00Z,1203,1202,75315,-1,-1.33E-05,0.015959636,0.015972914,2012,APA
2013-03-01T00:00:00Z,1220,1226,80512,6,7.45E-05,0.015227544,0.015153021,2013,APA
2014-02-28T00:00:00Z,657,661,46097,4,8.68E-05,0.014339328,0.014252554,2014,APA
2015-02-27T00:00:00Z,697,665,46307,-32,-0.00069104,0.01436068,0.01505172,2015,APA
2016-02-26T00:00:00Z,419,297,28735,-122,-0.004245693,0.010335827,0.014581521,2016,APA
2017-02-24T00:00:00Z,1227,1141,66304,-86,-0.001297056,0.017208615,0.018505671,2017,APA
2018-02-23T00:00:00Z,1086,1064,61538,-22,-0.000357503,0.01729013,0.017647632,2018,APA
2019-03-01T00:00:00Z,1113,1093,64256,-20,-0.000311255,0.017010085,0.01732134,2019,APA
2010-11-24T00:00:00Z,691,841,38988,150,0.003847338,0.02157074,0.017723402,2010,BDX
2011-11-23T00:00:00Z,723,906,41226,183,0.004438946,0.021976423,0.017537476,2011,BDX
2012-11-21T00:00:00Z,780,977,43998,197,0.004477476,0.022205555,0.017728079,2012,BDX
2013-11-27T00:00:00Z,769,979,45338,210,0.004631876,0.021593365,0.016961489,2013,BDX
2014-11-26T00:00:00Z,784,1024,46892,240,0.005118144,0.021837414,0.01671927,2014,BDX
2015-11-25T00:00:00Z,755,1020,48084,265,0.005511189,0.021212877,0.015701689,2015,BDX
2016-11-23T00:00:00Z,691,956,45226,265,0.005859461,0.021138283,0.015278822,2016,BDX
2017-11-22T00:00:00Z,732,969,48242,237,0.004912732,0.020086232,0.0151735,2017,BDX
2018-11-21T00:00:00Z,773,1022,51342,249,0.004849831,0.01990573,0.0150559,2018,BDX
2011-02-25T00:00:00Z,856,1341,61574,485,0.007876701,0.021778673,0.013901972,2011,WY
2012-02-22T00:00:00Z,854,1262,59093,408,0.006904371,0.021356167,0.014451796,2012,WY
2013-02-19T00:00:00Z,746,1230,55724,484,0.008685665,0.022073074,0.013387409,2013,WY
2014-02-18T00:00:00Z,752,1241,56322,489,0.00868222,0.022034019,0.013351799,2014,WY
2015-02-13T00:00:00Z,771,1186,53489,415,0.007758605,0.022172783,0.014414179,2015,WY
2016-02-17T00:00:00Z,851,1261,58148,410,0.007050973,0.021686043,0.014635069,2016,WY
2017-02-24T00:00:00Z,882,1462,67148,580,0.008637636,0.0217728,0.013135164,2017,WY
2018-02-16T00:00:00Z,833,1420,64293,587,0.009130076,0.022086386,0.012956309,2018,WY
2019-02-15T00:00:00Z,807,1274,59054,467,0.007908016,0.021573475,0.013665459,2019,WY
2009-05-29T00:00:00Z,839,1317,56053,478,0.008527643,0.02349562,0.014967977,2009,CSC
2010-05-21T00:00:00Z,663,1294,51857,631,0.012168078,0.024953237,0.012785159,2010,CSC
2011-06-15T00:00:00Z,902,1342,58230,440,0.007556242,0.02304654,0.015490297,2011,CSC
2012-05-29T00:00:00Z,1069,1543,71637,474,0.006616692,0.021539149,0.014922456,2012,CSC
2013-05-15T00:00:00Z,1105,1635,79019,530,0.006707248,0.020691226,0.013983979,2013,CSC
2014-05-22T00:00:00Z,1255,1918,87751,663,0.007555469,0.021857301,0.014301831,2014,CSC
2015-06-08T00:00:00Z,1118,1804,73085,686,0.009386331,0.024683588,0.015297257,2015,CSC
2016-06-15T00:00:00Z,1210,1689,75498,479,0.006344539,0.022371454,0.016026915,2016,CSC
2017-05-26T00:00:00Z,1191,1540,65592,349,0.005320771,0.023478473,0.018157702,2017,CSC
2018-05-29T00:00:00Z,1224,1596,72675,372,0.005118679,0.021960784,0.016842105,2018,DXC
2010-02-25T00:00:00Z,496,976,39179,480,0.012251461,0.024911305,0.012659843,2010,IFF
2011-02-24T00:00:00Z,531,999,39770,468,0.011767664,0.025119437,0.013351773,2011,IFF
2012-02-28T00:00:00Z,593,1293,46254,700,0.015133826,0.027954339,0.012820513,2012,IFF
2013-02-26T00:00:00Z,569,1305,47299,736,0.015560583,0.027590435,0.012029853,2013,IFF
2014-02-25T00:00:00Z,637,1401,50757,764,0.015052111,0.027602104,0.012549993,2014,IFF
2015-03-02T00:00:00Z,641,1339,49155,698,0.01419998,0.027240362,0.013040382,2015,IFF
2016-03-01T00:00:00Z,743,1439,52529,696,0.013249824,0.027394392,0.014144568,2016,IFF
2017-02-28T00:00:00Z,823,1575,57154,752,0.013157434,0.027557126,0.014399692,2017,IFF
2018-02-27T00:00:00Z,865,1699,62860,834,0.013267579,0.027028317,0.013760738,2018,IFF
2019-02-26T00:00:00Z,997,1755,73921,758,0.01025419,0.023741562,0.013487372,2019,IFF
2010-03-30T00:00:00Z,673,872,41488,199,0.004796568,0.021018126,0.016221558,2010,TJX
2011-03-30T00:00:00Z,660,897,41375,237,0.005728097,0.021679758,0.015951662,2011,TJX
2012-03-27T00:00:00Z,639,893,41648,254,0.006098732,0.021441606,0.015342874,2012,TJX
2013-04-02T00:00:00Z,587,898,40227,311,0.007731126,0.022323315,0.014592189,2013,TJX
2014-04-01T00:00:00Z,621,923,41352,302,0.007303153,0.022320565,0.015017411,2014,TJX
2015-03-31T00:00:00Z,640,925,41440,285,0.006877413,0.022321429,0.015444015,2015,TJX
2016-03-29T00:00:00Z,634,994,42475,360,0.008475574,0.023402001,0.014926427,2016,TJX
2017-03-28T00:00:00Z,650,1039,43576,389,0.008926932,0.0238434,0.014916468,2017,TJX
2018-04-04T00:00:00Z,691,1109,45987,418,0.009089525,0.024115511,0.015025986,2018,TJX
2019-04-03T00:00:00Z,624,1032,42148,408,0.009680175,0.024485148,0.014804973,2019,TJX
2010-02-26T00:00:00Z,931,1407,60809,476,0.007827789,0.023138022,0.015310234,2010,CUM
2011-02-24T00:00:00Z,953,1512,63495,559,0.008803843,0.023812899,0.015009056,2011,CUM
2012-02-21T00:00:00Z,971,1635,65108,664,0.01019844,0.025112121,0.014913682,2012,CUM
2013-02-20T00:00:00Z,995,1526,65158,531,0.008149421,0.023419994,0.015270573,2013,CUM
2014-02-18T00:00:00Z,947,1363,63695,416,0.006531125,0.021398854,0.014867729,2014,CUM
2015-02-17T00:00:00Z,842,1181,56538,339,0.005995967,0.020888606,0.014892639,2015,CUM
2016-02-12T00:00:00Z,882,1235,58484,353,0.006035839,0.021116887,0.015081048,2016,CUM
2017-02-13T00:00:00Z,908,1234,58789,326,0.005545255,0.020990321,0.015445066,2017,CUM
2018-02-14T00:00:00Z,897,1232,62513,335,0.005358885,0.019707901,0.014349015,2018,CUM
2019-02-11T00:00:00Z,925,1249,65031,324,0.004982239,0.019206225,0.014223985,2019,CUM
2010-02-26T00:00:00Z,931,1407,60809,476,0.007827789,0.023138022,0.015310234,2010,CMI
2011-02-24T00:00:00Z,953,1512,63495,559,0.008803843,0.023812899,0.015009056,2011,CMI
2012-02-21T00:00:00Z,971,1635,65108,664,0.01019844,0.025112121,0.014913682,2012,CMI
2013-02-20T00:00:00Z,995,1526,65158,531,0.008149421,0.023419994,0.015270573,2013,CMI
2014-02-18T00:00:00Z,947,1363,63695,416,0.006531125,0.021398854,0.014867729,2014,CMI
2015-02-17T00:00:00Z,842,1181,56538,339,0.005995967,0.020888606,0.014892639,2015,CMI
2016-02-12T00:00:00Z,882,1235,58484,353,0.006035839,0.021116887,0.015081048,2016,CMI
2017-02-13T00:00:00Z,908,1234,58789,326,0.005545255,0.020990321,0.015445066,2017,CMI
2018-02-14T00:00:00Z,897,1232,62513,335,0.005358885,0.019707901,0.014349015,2018,CMI
2019-02-11T00:00:00Z,925,1249,65031,324,0.004982239,0.019206225,0.014223985,2019,CMI
2009-08-27T00:00:00Z,206,173,12195,-33,-0.002706027,0.014186142,0.016892169,2009,PH
2010-08-26T00:00:00Z,225,202,13520,-23,-0.001701183,0.014940828,0.016642012,2010,PH
2011-08-26T00:00:00Z,210,202,13601,-8,-0.000588192,0.014851849,0.015440041,2011,PH
2012-08-24T00:00:00Z,203,183,12576,-20,-0.001590331,0.014551527,0.016141858,2012,PH
2013-08-29T00:00:00Z,200,202,13005,2,0.000153787,0.015532488,0.0153787,2013,PH
2014-08-22T00:00:00Z,195,196,12090,1,8.27E-05,0.016211745,0.016129032,2014,PH
2015-08-26T00:00:00Z,195,215,12821,20,0.001559941,0.016769363,0.015209422,2015,PH
2016-08-26T00:00:00Z,480,909,34177,429,0.012552301,0.026596834,0.014044533,2016,PH
2017-08-25T00:00:00Z,507,920,35447,413,0.011651198,0.025954242,0.014303044,2017,PH
2018-08-24T00:00:00Z,505,934,35954,429,0.011931913,0.025977638,0.014045725,2018,PH
2001-03-28T00:00:00Z,216,164,13581,-52,-0.003828879,0.012075694,0.015904573,2001,AIH
2003-03-20T00:00:00Z,287,277,16513,-10,-0.000605583,0.016774662,0.017380246,2003,AIH
2004-02-17T00:00:00Z,200,185,12194,-15,-0.001230113,0.015171396,0.016401509,2004,AIH
2005-03-07T00:00:00Z,163,202,12248,39,0.003184193,0.016492489,0.013308295,2005,AIH
2006-03-10T00:00:00Z,246,326,17634,80,0.00453669,0.018487014,0.013950323,2006,AIH
2007-03-14T00:00:00Z,237,353,18881,116,0.006143742,0.018696044,0.012552301,2007,AIH
2010-03-01T00:00:00Z,1068,1658,72981,590,0.008084296,0.022718242,0.014633946,2010,PKI
2011-03-01T00:00:00Z,991,1574,69365,583,0.008404815,0.022691559,0.014286744,2011,PKI
2012-02-28T00:00:00Z,964,1605,73113,641,0.008767251,0.02195232,0.01318507,2012,PKI
2013-02-26T00:00:00Z,954,1578,74249,624,0.008404154,0.021252811,0.012848658,2013,PKI
2014-02-25T00:00:00Z,979,1553,73378,574,0.007822508,0.021164382,0.013341874,2014,PKI
2015-02-24T00:00:00Z,964,1526,69957,562,0.008033506,0.0218134,0.013779893,2015,PKI
2016-03-01T00:00:00Z,982,1501,69725,519,0.007443528,0.021527429,0.014083901,2016,PKI
2017-02-28T00:00:00Z,1081,1665,74850,584,0.007802271,0.022244489,0.014442218,2017,PKI
2018-02-27T00:00:00Z,1090,1642,74810,552,0.007378693,0.021948937,0.014570245,2018,PKI
2019-02-26T00:00:00Z,1102,1721,78746,619,0.007860717,0.021855078,0.013994362,2019,PKI
2007-11-29T00:00:00Z,685,999,45094,314,0.006963232,0.022153723,0.015190491,2007,JCI
2008-11-25T00:00:00Z,696,1028,46042,332,0.007210808,0.02232744,0.015116633,2008,JCI
2009-11-25T00:00:00Z,854,1240,53288,386,0.007243657,0.023269779,0.016026122,2009,JCI
2010-11-23T00:00:00Z,897,1376,58054,479,0.008250939,0.02370207,0.015451132,2010,JCI
2011-11-22T00:00:00Z,869,1341,58360,472,0.008087731,0.022978067,0.014890336,2011,JCI
2012-11-19T00:00:00Z,855,1267,56367,412,0.007309241,0.022477691,0.01516845,2012,JCI
2013-11-21T00:00:00Z,872,1395,59002,523,0.008864106,0.023643266,0.01477916,2013,JCI
2014-11-19T00:00:00Z,979,1404,61336,425,0.006929047,0.022890309,0.015961263,2014,JCI
2015-11-18T00:00:00Z,1014,1449,61872,435,0.007030644,0.023419317,0.016388673,2015,JCI
2016-11-23T00:00:00Z,1160,1622,67598,462,0.006834522,0.023994793,0.017160271,2016,JCI
2009-06-26T00:00:00Z,206,237,14850,31,0.002087542,0.015959596,0.013872054,2009,SJM
2010-06-24T00:00:00Z,247,247,16085,0,0,0.015355922,0.015355922,2010,SJM
2011-06-28T00:00:00Z,255,273,15947,18,0.001128739,0.017119207,0.015990468,2011,SJM
2012-06-25T00:00:00Z,274,276,16013,2,0.000124899,0.017235996,0.017111097,2012,SJM
2013-06-21T00:00:00Z,273,264,14717,-9,-0.000611538,0.017938439,0.018549976,2013,SJM
2014-06-23T00:00:00Z,77,55,5557,-22,-0.003958971,0.009897427,0.013856397,2014,SJM
2015-06-25T00:00:00Z,88,63,6512,-25,-0.003839066,0.009674447,0.013513514,2015,SJM
2016-06-21T00:00:00Z,278,263,13908,-15,-0.001078516,0.01890998,0.019988496,2016,SJM
2017-06-19T00:00:00Z,286,266,13798,-20,-0.001449485,0.019278156,0.020727642,2017,SJM
2018-06-18T00:00:00Z,337,309,15120,-28,-0.001851852,0.020436508,0.02228836,2018,SJM
2010-02-26T00:00:00Z,353,450,24480,97,0.003962418,0.018382353,0.014419935,2010,JBHT
2011-02-25T00:00:00Z,338,429,23048,91,0.003948282,0.018613329,0.014665047,2011,JBHT
2012-02-24T00:00:00Z,330,448,23377,118,0.005047696,0.019164136,0.014116439,2012,JBHT
2013-02-22T00:00:00Z,304,392,22290,88,0.003947959,0.017586362,0.013638403,2013,JBHT
2014-02-21T00:00:00Z,313,377,22054,64,0.002901968,0.017094405,0.014192437,2014,JBHT
2015-02-24T00:00:00Z,338,381,22836,43,0.001882992,0.016684183,0.014801191,2015,JBHT
2016-02-23T00:00:00Z,356,406,23500,50,0.00212766,0.017276596,0.015148936,2016,JBHT
2017-02-23T00:00:00Z,365,425,23424,60,0.002561475,0.018143784,0.015582309,2017,JBHT
2018-02-23T00:00:00Z,372,447,24067,75,0.0031163,0.01857315,0.01545685,2018,JBHT
2019-02-22T00:00:00Z,192,236,13168,44,0.003341434,0.017922236,0.014580802,2019,JBHT
2004-03-30T00:00:00Z,653,921,51473,268,0.005206613,0.017892876,0.012686263,2004,HBAN
2005-03-16T00:00:00Z,796,1084,58840,288,0.00489463,0.018422842,0.013528212,2005,HBAN
2006-03-15T00:00:00Z,991,1288,67365,297,0.004408818,0.019119721,0.014710903,2006,HBAN
2007-04-02T00:00:00Z,934,1293,65331,359,0.005495094,0.019791523,0.014296429,2007,HBAN
2008-04-29T00:00:00Z,669,906,44793,237,0.005291005,0.020226375,0.014935369,2008,HBAN
2009-03-31T00:00:00Z,644,898,42510,254,0.005975065,0.021124441,0.015149377,2009,HBAN
2010-02-22T00:00:00Z,934,1513,58483,579,0.009900313,0.025870766,0.015970453,2010,SWK
2011-02-18T00:00:00Z,1133,1826,74944,693,0.009246904,0.024364859,0.015117955,2011,SWK
2012-02-23T00:00:00Z,1066,1568,70143,502,0.007156808,0.022354333,0.015197525,2012,SWK
2013-02-20T00:00:00Z,1045,1491,68601,446,0.006501363,0.021734377,0.015233014,2013,SWK
2014-02-21T00:00:00Z,1056,1555,68541,499,0.007280314,0.022687151,0.015406837,2014,SWK
2015-02-19T00:00:00Z,1096,1603,68480,507,0.007403621,0.023408294,0.016004673,2015,SWK
2016-02-19T00:00:00Z,1064,1618,65180,554,0.00849954,0.024823566,0.016324026,2016,SWK
2017-02-15T00:00:00Z,1032,1610,64705,578,0.008932849,0.024882157,0.015949308,2017,SWK
2018-02-27T00:00:00Z,1046,1697,69699,651,0.009340163,0.024347552,0.015007389,2018,SWK
2019-02-26T00:00:00Z,1046,1684,70498,638,0.009049902,0.023887202,0.0148373,2019,SWK
2010-02-26T00:00:00Z,489,920,40466,431,0.010650917,0.022735136,0.012084219,2010,MCD
2011-02-25T00:00:00Z,397,778,36066,381,0.010563966,0.021571563,0.011007597,2011,MCD
2012-02-24T00:00:00Z,425,790,35786,365,0.010199519,0.022075672,0.011876153,2012,MCD
2013-02-25T00:00:00Z,435,823,34673,388,0.011190263,0.023736048,0.012545785,2013,MCD
2014-02-24T00:00:00Z,432,720,32561,288,0.008844937,0.022112343,0.013267406,2014,MCD
2015-02-24T00:00:00Z,541,817,35703,276,0.007730443,0.022883231,0.015152788,2015,MCD
2016-02-25T00:00:00Z,562,889,37499,327,0.008720233,0.023707299,0.014987066,2016,MCD
2017-03-01T00:00:00Z,519,907,37181,388,0.010435437,0.02439418,0.013958742,2017,MCD
2018-02-23T00:00:00Z,513,913,38992,400,0.010258515,0.023415059,0.013156545,2018,MCD
2019-02-22T00:00:00Z,506,894,38783,388,0.010004383,0.023051337,0.013046954,2019,MCD
2010-03-03T00:00:00Z,803,1297,53834,494,0.009176357,0.024092581,0.014916224,2010,VFC
2011-03-02T00:00:00Z,756,1244,52311,488,0.009328822,0.023780849,0.014452027,2011,VFC
2012-02-29T00:00:00Z,756,1202,51263,446,0.008700232,0.023447711,0.014747479,2012,VFC
2013-02-27T00:00:00Z,727,1197,50102,470,0.009380863,0.023891262,0.014510399,2013,VFC
2014-02-26T00:00:00Z,732,1161,49342,429,0.008694419,0.02352965,0.014835232,2014,VFC
2015-03-03T00:00:00Z,751,1217,50571,466,0.009214767,0.024065176,0.014850408,2015,VFC
2016-03-02T00:00:00Z,814,1273,54085,459,0.008486641,0.023537025,0.015050384,2016,VFC
2017-03-01T00:00:00Z,877,1378,55370,501,0.009048221,0.024887123,0.015838902,2017,VFC
2018-02-28T00:00:00Z,903,1316,57128,413,0.00722938,0.023035989,0.01580661,2018,VFC
2019-05-24T00:00:00Z,1059,1588,75516,529,0.007005138,0.021028656,0.014023518,2019,VFC
2010-02-26T00:00:00Z,1622,3078,137116,1456,0.010618746,0.022448146,0.0118294,2010,NU
2011-02-25T00:00:00Z,1512,2990,135675,1478,0.01089368,0.022037958,0.011144279,2011,NU
2012-02-24T00:00:00Z,1529,3124,141771,1595,0.011250538,0.022035536,0.010784998,2012,NU
2013-02-28T00:00:00Z,1452,2911,138345,1459,0.010546099,0.021041599,0.0104955,2013,NU
2014-02-25T00:00:00Z,1307,2662,127978,1355,0.010587757,0.02080045,0.010212693,2014,NU
2015-02-25T00:00:00Z,1370,2631,123130,1261,0.010241208,0.02136766,0.011126452,2015,NU
2016-02-26T00:00:00Z,1334,2554,120638,1220,0.0101129,0.021170775,0.011057876,2016,NU
2017-02-23T00:00:00Z,1290,2404,114245,1114,0.009750974,0.021042496,0.011291523,2017,NU
2018-02-26T00:00:00Z,1265,2249,112642,984,0.00873564,0.01996591,0.011230269,2018,NU
2019-02-26T00:00:00Z,1291,2386,117328,1095,0.009332811,0.020336152,0.011003341,2019,NU
2010-02-26T00:00:00Z,1622,3078,137116,1456,0.010618746,0.022448146,0.0118294,2010,ES
2011-02-25T00:00:00Z,1512,2990,135675,1478,0.01089368,0.022037958,0.011144279,2011,ES
2012-02-24T00:00:00Z,1529,3124,141771,1595,0.011250538,0.022035536,0.010784998,2012,ES
2013-02-28T00:00:00Z,1452,2911,138345,1459,0.010546099,0.021041599,0.0104955,2013,ES
2014-02-25T00:00:00Z,1307,2662,127978,1355,0.010587757,0.02080045,0.010212693,2014,ES
2015-02-25T00:00:00Z,1370,2631,123130,1261,0.010241208,0.02136766,0.011126452,2015,ES
2016-02-26T00:00:00Z,1334,2554,120638,1220,0.0101129,0.021170775,0.011057876,2016,ES
2017-02-23T00:00:00Z,1290,2404,114245,1114,0.009750974,0.021042496,0.011291523,2017,ES
2018-02-26T00:00:00Z,1265,2249,112642,984,0.00873564,0.01996591,0.011230269,2018,ES
2019-02-26T00:00:00Z,1291,2386,117328,1095,0.009332811,0.020336152,0.011003341,2019,ES
2010-02-25T00:00:00Z,812,1265,53760,453,0.008426339,0.023530506,0.015104167,2010,TFX
2011-02-25T00:00:00Z,1063,1374,58965,311,0.005274315,0.023301959,0.018027644,2011,TFX
2012-02-24T00:00:00Z,1002,1274,55963,272,0.004860354,0.022765041,0.017904687,2012,TFX
2013-02-22T00:00:00Z,1176,1442,63928,266,0.004160931,0.022556626,0.018395695,2013,TFX
2014-02-24T00:00:00Z,1289,1530,65489,241,0.003680007,0.023362702,0.019682695,2014,TFX
2015-02-20T00:00:00Z,1201,1548,64992,347,0.005339119,0.023818316,0.018479197,2015,TFX
2016-02-25T00:00:00Z,1134,1560,64856,426,0.006568398,0.024053287,0.01748489,2016,TFX
2017-02-23T00:00:00Z,1185,1671,68300,486,0.007115666,0.024465593,0.017349927,2017,TFX
2018-02-22T00:00:00Z,1142,1773,70658,631,0.008930341,0.0250927,0.01616236,2018,TFX
2019-02-21T00:00:00Z,1121,1677,66374,556,0.008376774,0.025265917,0.016889143,2019,TFX
2010-03-01T00:00:00Z,265,247,14826,-18,-0.001214083,0.016659922,0.017874005,2010,AVY
2011-02-28T00:00:00Z,260,259,14941,-1,-6.69E-05,0.01733485,0.01740178,2011,AVY
2012-02-27T00:00:00Z,281,269,14549,-12,-0.000824799,0.018489243,0.019314042,2012,AVY
2013-02-27T00:00:00Z,296,293,14972,-3,-0.000200374,0.019569864,0.019770238,2013,AVY
2014-02-26T00:00:00Z,277,269,14268,-8,-0.000560695,0.018853378,0.019414073,2014,AVY
2015-02-25T00:00:00Z,380,301,15800,-79,-0.005,0.019050633,0.024050633,2015,AVY
2016-02-24T00:00:00Z,400,319,15800,-81,-0.005126582,0.020189873,0.025316456,2016,AVY
2017-02-23T00:00:00Z,422,336,16751,-86,-0.005134022,0.020058504,0.025192526,2017,AVY
2018-02-21T00:00:00Z,411,327,17249,-84,-0.004869848,0.018957621,0.023827468,2018,AVY
2019-02-27T00:00:00Z,422,361,17502,-61,-0.003485316,0.020626214,0.02411153,2019,AVY
2009-08-28T00:00:00Z,464,840,41898,376,0.008974175,0.02004869,0.011074514,2009,ADP
2010-08-25T00:00:00Z,440,774,39649,334,0.00842392,0.019521299,0.01109738,2010,ADP
2011-08-24T00:00:00Z,508,860,42091,352,0.008362833,0.020431921,0.012069088,2011,ADP
2012-08-20T00:00:00Z,473,872,40368,399,0.009884067,0.021601268,0.011717202,2012,ADP
2013-08-19T00:00:00Z,473,970,40642,497,0.012228729,0.023866936,0.011638207,2013,ADP
2014-08-08T00:00:00Z,513,1009,42659,496,0.011627089,0.023652688,0.012025598,2014,ADP
2015-08-07T00:00:00Z,618,966,41301,348,0.008425946,0.023389264,0.014963318,2015,ADP
2016-08-05T00:00:00Z,638,1035,44259,397,0.008969927,0.023385074,0.014415147,2016,ADP
2017-08-04T00:00:00Z,630,1107,45224,477,0.010547497,0.024478153,0.013930656,2017,ADP
2018-08-03T00:00:00Z,683,1155,46910,472,0.010061821,0.024621616,0.014559795,2018,ADP
2009-11-17T00:00:00Z,1527,2130,85626,603,0.007042254,0.024875622,0.017833368,2009,TYC
2010-11-12T00:00:00Z,1340,1837,79066,497,0.006285888,0.023233754,0.016947866,2010,TYC
2011-11-16T00:00:00Z,1274,1831,81013,557,0.00687544,0.022601311,0.015725871,2011,TYC
2012-11-16T00:00:00Z,1411,1618,78791,207,0.002627204,0.02053534,0.017908137,2012,TYC
2013-11-14T00:00:00Z,1408,1626,77696,218,0.002805807,0.020927718,0.018121911,2013,TYC
2014-11-14T00:00:00Z,1394,1587,78484,193,0.0024591,0.020220682,0.017761582,2014,TYC
2015-11-13T00:00:00Z,1372,1708,75939,336,0.004424604,0.022491737,0.018067133,2015,TYC
2016-11-23T00:00:00Z,1408,1916,85539,508,0.005938812,0.02239914,0.016460328,2016,TYC
2017-11-21T00:00:00Z,1440,1872,84118,432,0.005135643,0.022254452,0.017118809,2017,TYC
2018-11-20T00:00:00Z,1246,1831,78552,585,0.007447296,0.0233094,0.015862104,2018,TYC
2010-02-26T00:00:00Z,1240,1520,57044,280,0.004908492,0.026646098,0.021737606,2010,MMC
2011-02-28T00:00:00Z,1148,1485,57563,337,0.005854455,0.025797822,0.019943366,2011,MMC
2012-02-28T00:00:00Z,1048,1416,55001,368,0.006690787,0.025744986,0.019054199,2012,MMC
2013-02-27T00:00:00Z,1014,1386,54762,372,0.006793032,0.025309521,0.01851649,2013,MMC
2014-02-27T00:00:00Z,1023,1389,54764,366,0.006683223,0.025363377,0.018680155,2014,MMC
2015-02-26T00:00:00Z,1004,1356,53586,352,0.00656888,0.025305117,0.018736237,2015,MMC
2016-02-24T00:00:00Z,1055,1484,56735,429,0.00756147,0.026156693,0.018595223,2016,MMC
2017-02-24T00:00:00Z,1080,1605,59142,525,0.00887694,0.027138074,0.018261134,2017,MMC
2018-02-22T00:00:00Z,1109,1688,62131,579,0.009319019,0.027168402,0.017849383,2018,MMC
2019-02-21T00:00:00Z,1242,1826,69256,584,0.008432482,0.026365947,0.017933464,2019,MMC
2014-11-25T00:00:00Z,603,960,38466,357,0.009280923,0.024957105,0.015676182,2014,AHAA
2015-11-24T00:00:00Z,616,970,38589,354,0.009173599,0.025136697,0.015963098,2015,AHAA
2016-11-22T00:00:00Z,566,882,36266,316,0.008713395,0.0243203,0.015606905,2016,AHAA
2017-11-13T00:00:00Z,575,908,36436,333,0.009139313,0.024920408,0.015781096,2017,AHAA
2018-11-15T00:00:00Z,603,956,37816,353,0.009334673,0.025280305,0.015945631,2018,AHAA
2014-11-25T00:00:00Z,603,960,38466,357,0.009280923,0.024957105,0.015676182,2014,SWKS
2015-11-24T00:00:00Z,616,970,38589,354,0.009173599,0.025136697,0.015963098,2015,SWKS
2016-11-22T00:00:00Z,566,882,36266,316,0.008713395,0.0243203,0.015606905,2016,SWKS
2017-11-13T00:00:00Z,575,908,36436,333,0.009139313,0.024920408,0.015781096,2017,SWKS
2018-11-15T00:00:00Z,603,956,37816,353,0.009334673,0.025280305,0.015945631,2018,SWKS
2012-02-28T00:00:00Z,715,1406,52107,691,0.013261174,0.026982939,0.013721765,2012,ITG
2013-03-06T00:00:00Z,724,1302,48365,578,0.011950791,0.026920294,0.014969503,2013,ITG
2014-03-17T00:00:00Z,709,1269,48400,560,0.011570248,0.026219008,0.01464876,2014,ITG
2015-03-13T00:00:00Z,685,1131,46129,446,0.009668538,0.024518199,0.014849661,2015,ITG
2016-02-29T00:00:00Z,712,1155,49630,443,0.008926053,0.023272214,0.014346162,2016,ITG
2017-03-01T00:00:00Z,829,1320,53422,491,0.00919097,0.024708921,0.015517951,2017,ITG
2018-03-01T00:00:00Z,876,1377,56975,501,0.00879333,0.024168495,0.015375165,2018,ITG
2019-03-14T00:00:00Z,906,1427,59449,521,0.008763814,0.024003768,0.015239954,2019,ITG
2010-02-26T00:00:00Z,346,823,30678,477,0.015548602,0.026827042,0.011278441,2010,GPC
2011-02-25T00:00:00Z,334,803,30351,469,0.015452539,0.026457118,0.01100458,2011,GPC
2012-02-27T00:00:00Z,421,798,30841,377,0.012223988,0.025874647,0.01365066,2012,GPC
2013-02-26T00:00:00Z,335,811,30735,476,0.01548723,0.026386855,0.010899626,2013,GPC
2014-02-27T00:00:00Z,469,847,33784,378,0.011188728,0.02507104,0.013882311,2014,GPC
2015-02-26T00:00:00Z,364,856,33484,492,0.014693585,0.025564449,0.010870864,2015,GPC
2016-02-26T00:00:00Z,375,855,33267,480,0.014428713,0.025701145,0.011272432,2016,GPC
2017-02-27T00:00:00Z,382,828,33081,446,0.013482059,0.025029473,0.011547414,2017,GPC
2018-02-27T00:00:00Z,458,973,39177,515,0.013145468,0.024836001,0.011690533,2018,GPC
2019-02-25T00:00:00Z,532,976,39956,444,0.011112223,0.02442687,0.013314646,2019,GPC
2010-03-01T00:00:00Z,1438,1751,81468,313,0.003841999,0.021493102,0.017651102,2010,HST
2011-02-24T00:00:00Z,1577,2016,92667,439,0.004737393,0.021755317,0.017017924,2011,HST
2012-02-22T00:00:00Z,1606,1918,93145,312,0.003349616,0.020591551,0.017241935,2012,HST
2013-02-25T00:00:00Z,1559,1973,94281,414,0.004391129,0.020926804,0.016535675,2013,HST
2014-02-26T00:00:00Z,1485,2037,94508,552,0.005840775,0.021553731,0.015712956,2014,HST
2015-02-25T00:00:00Z,1377,1840,88307,463,0.005243072,0.0208364,0.015593328,2015,HST
2016-02-22T00:00:00Z,1345,1856,88379,511,0.005781917,0.021000464,0.015218547,2016,HST
2017-02-24T00:00:00Z,1312,1820,86058,508,0.005902996,0.021148528,0.015245532,2017,HST
2018-02-27T00:00:00Z,1234,1630,77712,396,0.005095738,0.020974882,0.015879144,2018,HST
2019-02-26T00:00:00Z,1141,1545,74402,404,0.005429962,0.020765571,0.015335609,2019,HST
2009-08-07T00:00:00Z,1222,1502,67933,280,0.004121708,0.02211002,0.017988312,2009,KLAC
2010-08-06T00:00:00Z,1099,1595,64027,496,0.007746732,0.024911366,0.017164634,2010,KLAC
2011-08-05T00:00:00Z,1077,1373,56149,296,0.005271688,0.024452795,0.019181107,2011,KLAC
2012-08-06T00:00:00Z,1066,1300,54662,234,0.004280853,0.023782518,0.019501665,2012,KLAC
2013-08-08T00:00:00Z,1117,1323,55410,206,0.00371774,0.023876557,0.020158816,2013,KLAC
2014-08-08T00:00:00Z,1093,1301,55104,208,0.003774681,0.023609901,0.019835221,2014,KLAC
2015-08-07T00:00:00Z,1325,1591,66336,266,0.004009889,0.02398396,0.019974071,2015,KLAC
2016-08-05T00:00:00Z,1334,1644,68890,310,0.004499927,0.023864131,0.019364204,2016,KLAC
2017-08-04T00:00:00Z,1261,1577,65220,316,0.00484514,0.024179699,0.01933456,2017,KLAC
2018-08-06T00:00:00Z,1279,1531,66329,252,0.003799243,0.02308191,0.019282667,2018,KLAC
2010-03-26T00:00:00Z,886,1207,51051,321,0.00628783,0.023643024,0.017355194,2010,LB
2011-03-18T00:00:00Z,830,1140,49368,310,0.006279371,0.023091881,0.01681251,2011,LB
2012-03-23T00:00:00Z,781,1231,50324,450,0.008942055,0.02446149,0.015519434,2012,LB
2013-03-22T00:00:00Z,795,1262,52603,467,0.008877821,0.023991027,0.015113206,2013,LB
2014-03-21T00:00:00Z,696,1165,49772,469,0.009422969,0.023406735,0.013983766,2014,LB
2015-03-20T00:00:00Z,684,1102,48087,418,0.008692578,0.022916797,0.014224219,2015,LB
2016-03-18T00:00:00Z,679,1142,48285,463,0.009588899,0.023651237,0.014062338,2016,LB
2017-03-17T00:00:00Z,711,1129,47909,418,0.008724874,0.02356551,0.014840635,2017,LB
2018-03-23T00:00:00Z,742,1165,50128,423,0.008438398,0.023240504,0.014802107,2018,LB
2019-03-22T00:00:00Z,759,1164,51052,405,0.007933088,0.022800282,0.014867194,2019,LB
2010-02-24T00:00:00Z,4064,4103,186567,39,0.00020904,0.021992099,0.021783059,2010,JPM
2011-02-28T00:00:00Z,4251,4362,206264,111,0.000538145,0.021147655,0.02060951,2011,JPM
2012-02-29T00:00:00Z,4110,3825,190914,-285,-0.001492819,0.020035199,0.021528018,2012,JPM
2013-02-28T00:00:00Z,4656,3969,202076,-687,-0.003399711,0.019641125,0.023040836,2013,JPM
2014-02-20T00:00:00Z,4271,3972,196189,-299,-0.001524041,0.020245783,0.021769824,2014,JPM
2015-02-24T00:00:00Z,4043,3707,181037,-336,-0.001855974,0.020476477,0.022332451,2015,JPM
2016-02-23T00:00:00Z,3884,3682,175689,-202,-0.001149759,0.020957487,0.022107246,2016,JPM
2017-02-28T00:00:00Z,3835,3577,171921,-258,-0.001500689,0.020806068,0.022306757,2017,JPM
2018-02-27T00:00:00Z,4028,3531,171485,-497,-0.002898213,0.020590722,0.023488935,2018,JPM
2019-02-26T00:00:00Z,4174,3610,186846,-564,-0.003018529,0.019320724,0.022339253,2019,JPM
2008-10-24T00:00:00Z,588,959,53041,371,0.006994589,0.018080353,0.011085764,2008,FOH
2009-10-23T00:00:00Z,458,744,41536,286,0.006885593,0.017912173,0.011026579,2009,FOH
2010-10-25T00:00:00Z,399,525,30063,126,0.004191198,0.017463327,0.013272129,2010,FOH
2011-10-28T00:00:00Z,393,537,29926,144,0.004811869,0.017944263,0.013132393,2011,FOH
2012-10-26T00:00:00Z,391,515,30288,124,0.004094031,0.017003434,0.012909403,2012,FOH
2013-10-25T00:00:00Z,415,541,33210,126,0.003794038,0.016290274,0.012496236,2013,FOH
2009-08-27T00:00:00Z,792,1311,51061,519,0.010164313,0.025675173,0.01551086,2009,LRCX
2010-08-23T00:00:00Z,798,1273,47670,475,0.009964338,0.026704426,0.016740088,2010,LRCX
2011-08-19T00:00:00Z,804,1200,48799,396,0.00811492,0.024590668,0.016475747,2011,LRCX
2012-08-22T00:00:00Z,803,1338,54690,535,0.00978241,0.024465167,0.014682757,2012,LRCX
2013-08-27T00:00:00Z,846,1249,53351,403,0.007553748,0.023410995,0.015857247,2013,LRCX
2014-08-26T00:00:00Z,849,1195,51207,346,0.006756889,0.023336653,0.016579764,2014,LRCX
2015-08-13T00:00:00Z,190,213,11748,23,0.00195778,0.018130746,0.016172966,2015,LRCX
2016-08-17T00:00:00Z,919,1349,56019,430,0.007675967,0.024081115,0.016405148,2016,LRCX
2017-08-15T00:00:00Z,905,1261,52934,356,0.006725356,0.023822118,0.017096762,2017,LRCX
2018-08-14T00:00:00Z,932,1320,56216,388,0.00690195,0.02348086,0.01657891,2018,LRCX
2004-03-30T00:00:00Z,653,921,51473,268,0.005206613,0.017892876,0.012686263,2004,MCO
2005-03-16T00:00:00Z,796,1084,58840,288,0.00489463,0.018422842,0.013528212,2005,MCO
2006-03-15T00:00:00Z,991,1288,67365,297,0.004408818,0.019119721,0.014710903,2006,MCO
2007-04-02T00:00:00Z,934,1293,65331,359,0.005495094,0.019791523,0.014296429,2007,MCO
2008-04-29T00:00:00Z,669,906,44793,237,0.005291005,0.020226375,0.014935369,2008,MCO
2009-03-31T00:00:00Z,644,898,42510,254,0.005975065,0.021124441,0.015149377,2009,MCO
2012-02-24T00:00:00Z,1122,1873,73857,751,0.010168298,0.025359817,0.015191519,2012,HUM
2013-02-22T00:00:00Z,1074,1865,74081,791,0.010677502,0.025175146,0.014497644,2013,HUM
2014-02-19T00:00:00Z,1133,1935,76835,802,0.010437951,0.025183835,0.014745884,2014,HUM
2015-02-18T00:00:00Z,1126,1850,72678,724,0.009961749,0.025454746,0.015492997,2015,HUM
2016-02-18T00:00:00Z,1357,2123,81776,766,0.009367051,0.025961162,0.016594111,2016,HUM
2017-02-17T00:00:00Z,1441,2177,82467,736,0.008924782,0.026398438,0.017473656,2017,HUM
2018-02-16T00:00:00Z,1292,2055,81319,763,0.009382801,0.025270847,0.015888046,2018,HUM
2019-02-21T00:00:00Z,1130,1800,72647,670,0.00922268,0.024777348,0.015554668,2019,HUM
2010-02-05T00:00:00Z,968,1124,48559,156,0.003212587,0.023147099,0.019934513,2010,UNP
2011-02-04T00:00:00Z,978,1110,48342,132,0.002730545,0.0229614,0.020230855,2011,UNP
2012-02-03T00:00:00Z,981,1099,48669,118,0.002424541,0.022581109,0.020156568,2012,UNP
2013-02-08T00:00:00Z,955,1105,47565,150,0.003153579,0.023231368,0.020077788,2013,UNP
2014-02-07T00:00:00Z,1017,1112,48409,95,0.001962445,0.022970935,0.02100849,2014,UNP
2015-02-06T00:00:00Z,1000,1080,48135,80,0.001661992,0.022436896,0.020774904,2015,UNP
2016-02-05T00:00:00Z,1010,1093,48931,83,0.001696266,0.022337577,0.020641311,2016,UNP
2017-02-03T00:00:00Z,892,1009,45321,117,0.002581585,0.02226341,0.019681825,2017,UNP
2018-02-09T00:00:00Z,834,1044,45976,210,0.0045676,0.0227075,0.018139899,2018,UNP
2019-02-08T00:00:00Z,840,1027,46493,187,0.004022111,0.022089347,0.018067236,2019,UNP
2011-02-25T00:00:00Z,3152,3811,151064,659,0.004362389,0.025227718,0.020865329,2011,LNC
2012-02-23T00:00:00Z,2641,3146,124015,505,0.004072088,0.025367899,0.021295811,2012,LNC
2013-03-01T00:00:00Z,2570,3180,121646,610,0.00501455,0.026141427,0.021126876,2013,LNC
2014-02-25T00:00:00Z,2526,3137,119472,611,0.005114169,0.026257198,0.021143029,2014,LNC
2015-02-26T00:00:00Z,2505,3085,117520,580,0.00493533,0.026250851,0.021315521,2015,LNC
2016-02-25T00:00:00Z,2493,2993,115160,500,0.004341785,0.025989927,0.021648142,2016,LNC
2017-02-23T00:00:00Z,2535,3040,118449,505,0.004263438,0.025665054,0.021401616,2017,LNC
2018-02-22T00:00:00Z,2525,3044,116006,519,0.004473907,0.026240022,0.021766116,2018,LNC
2019-02-20T00:00:00Z,2565,3159,118772,594,0.005001179,0.026597178,0.021595999,2019,LNC
2011-03-11T00:00:00Z,581,700,34427,119,0.003456589,0.020332878,0.016876289,2011,TGT
2012-03-15T00:00:00Z,567,689,33732,122,0.003616744,0.020425709,0.016808965,2012,TGT
2013-03-20T00:00:00Z,552,731,34357,179,0.005210001,0.021276596,0.016066595,2013,TGT
2014-03-14T00:00:00Z,639,729,33886,90,0.002655964,0.021513309,0.018857345,2014,TGT
2015-03-13T00:00:00Z,667,787,34599,120,0.003468308,0.022746322,0.019278014,2015,TGT
2016-03-11T00:00:00Z,546,745,33788,199,0.005889665,0.022049248,0.016159583,2016,TGT
2017-03-08T00:00:00Z,523,661,30103,138,0.004584261,0.021957944,0.017373684,2017,TGT
2018-03-14T00:00:00Z,491,672,30838,181,0.005869382,0.021791296,0.015921915,2018,TGT
2019-03-13T00:00:00Z,447,606,28844,159,0.005512412,0.021009569,0.015497157,2019,TGT
2009-06-29T00:00:00Z,1151,999,54981,-152,-0.002764591,0.018169913,0.020934505,2009,HRB
2010-06-29T00:00:00Z,1102,979,52085,-123,-0.002361524,0.018796199,0.021157723,2010,HRB
2011-06-23T00:00:00Z,1105,1031,55186,-74,-0.00134092,0.018682274,0.020023194,2011,HRB
2012-06-26T00:00:00Z,1220,1099,56933,-121,-0.002125305,0.019303392,0.021428697,2012,HRB
2013-06-26T00:00:00Z,1294,1189,60216,-105,-0.001743723,0.019745583,0.021489305,2013,HRB
2014-06-19T00:00:00Z,1173,1047,54766,-126,-0.002300698,0.019117701,0.021418398,2014,HRB
2015-06-17T00:00:00Z,1181,1078,55690,-103,-0.001849524,0.019357156,0.02120668,2015,HRB
2016-06-17T00:00:00Z,1055,911,48246,-144,-0.002984703,0.018882394,0.021867098,2016,HRB
2017-06-16T00:00:00Z,968,863,44053,-105,-0.002383493,0.019590039,0.021973532,2017,HRB
2018-06-15T00:00:00Z,967,889,45619,-78,-0.001709814,0.019487494,0.021197308,2018,HRB
2011-02-28T00:00:00Z,526,452,30199,-74,-0.002450412,0.014967383,0.017417795,2011,BK
2012-02-28T00:00:00Z,725,601,35117,-124,-0.003531053,0.017114218,0.020645272,2012,BK
2013-02-28T00:00:00Z,137,156,13969,19,0.001360155,0.011167585,0.009807431,2013,BK
2014-02-28T00:00:00Z,128,153,13042,25,0.001916884,0.01173133,0.009814446,2014,BK
2015-02-27T00:00:00Z,111,110,11864,-1,-8.43E-05,0.009271746,0.009356035,2015,BK
2016-02-26T00:00:00Z,142,117,11856,-25,-0.002108637,0.009868421,0.011977058,2016,BK
2017-02-28T00:00:00Z,138,114,11355,-24,-0.002113606,0.01003963,0.012153236,2017,BK
2018-02-28T00:00:00Z,119,115,11458,-4,-0.000349101,0.010036656,0.010385757,2018,BK
2019-02-27T00:00:00Z,121,114,11027,-7,-0.000634805,0.010338261,0.010973066,2019,BK
2011-12-09T00:00:00Z,718,1060,44736,342,0.00764485,0.023694564,0.016049714,2011,LEE
2012-12-14T00:00:00Z,648,923,39374,275,0.006984304,0.023441865,0.016457561,2012,LEE
2013-12-13T00:00:00Z,648,876,38246,228,0.005961408,0.022904356,0.016942948,2013,LEE
2014-12-12T00:00:00Z,667,943,41686,276,0.006620928,0.022621504,0.016000576,2014,LEE
2015-12-11T00:00:00Z,612,870,38829,258,0.006644518,0.022405934,0.015761415,2015,LEE
2016-12-09T00:00:00Z,520,839,36961,319,0.008630719,0.022699602,0.014068883,2016,LEE
2017-12-08T00:00:00Z,531,857,37152,326,0.008774763,0.023067399,0.014292636,2017,LEE
2018-12-14T00:00:00Z,509,828,35019,319,0.009109341,0.023644307,0.014534967,2018,LEE
2010-02-22T00:00:00Z,993,1177,53760,184,0.003422619,0.021893601,0.018470982,2010,LLY
2011-02-22T00:00:00Z,984,1212,53088,228,0.004294756,0.022830018,0.018535262,2011,LLY
2012-02-24T00:00:00Z,874,1134,49447,260,0.005258155,0.022933646,0.017675491,2012,LLY
2013-02-21T00:00:00Z,823,1093,47009,270,0.005743581,0.023250867,0.017507286,2013,LLY
2014-02-19T00:00:00Z,923,1112,47574,189,0.003972758,0.023374112,0.019401354,2014,LLY
2015-02-19T00:00:00Z,961,1169,51737,208,0.004020334,0.022595048,0.018574714,2015,LLY
2016-02-19T00:00:00Z,984,1242,55142,258,0.004678829,0.022523666,0.017844837,2016,LLY
2017-02-21T00:00:00Z,1011,1272,54873,261,0.004756438,0.023180799,0.018424362,2017,LLY
2018-02-20T00:00:00Z,1069,1352,57545,283,0.00491789,0.023494656,0.018576766,2018,LLY
2019-02-19T00:00:00Z,1093,1395,57593,302,0.005243693,0.024221694,0.018978001,2019,LLY
2010-04-28T00:00:00Z,550,719,37701,169,0.00448264,0.019071112,0.014588472,2010,PIR
2011-04-25T00:00:00Z,484,661,34641,177,0.005109552,0.019081435,0.013971883,2011,PIR
2012-04-25T00:00:00Z,469,698,33828,229,0.00676954,0.020633794,0.013864254,2012,PIR
2013-04-30T00:00:00Z,463,718,33980,255,0.007504414,0.021130077,0.013625662,2013,PIR
2014-04-29T00:00:00Z,483,744,37131,261,0.007029167,0.020037166,0.013007999,2014,PIR
2015-04-28T00:00:00Z,512,789,38083,277,0.007273587,0.020717906,0.013444319,2015,PIR
2016-04-26T00:00:00Z,524,827,39019,303,0.007765448,0.021194803,0.013429355,2016,PIR
2017-04-25T00:00:00Z,574,917,41126,343,0.008340223,0.02229733,0.013957107,2017,PIR
2018-05-02T00:00:00Z,178,361,16906,183,0.010824559,0.021353366,0.010528806,2018,PIR
2019-04-29T00:00:00Z,221,309,15822,88,0.005561876,0.019529769,0.013967893,2019,PIR
2010-08-31T00:00:00Z,757,1142,55548,385,0.006930943,0.020558796,0.013627853,2010,SYY
2011-08-30T00:00:00Z,793,1222,57826,429,0.007418808,0.021132363,0.013713554,2011,SYY
2012-08-28T00:00:00Z,818,1244,56751,426,0.007506476,0.021920319,0.014413843,2012,SYY
2013-08-27T00:00:00Z,882,1362,59847,480,0.008020452,0.022758033,0.014737581,2013,SYY
2014-08-26T00:00:00Z,952,1453,64955,501,0.007713032,0.022369333,0.014656301,2014,SYY
2015-08-25T00:00:00Z,804,1273,57143,469,0.008207479,0.022277444,0.014069965,2015,SYY
2016-08-30T00:00:00Z,867,1438,61949,571,0.009217259,0.023212643,0.013995383,2016,SYY
2017-08-30T00:00:00Z,918,1492,63613,574,0.009023313,0.023454325,0.014431013,2017,SYY
2018-08-27T00:00:00Z,963,1489,63987,526,0.00822042,0.023270352,0.015049932,2018,SYY
2013-01-25T00:00:00Z,432,712,30900,280,0.009061489,0.023042071,0.013980583,2013,MKC
2014-01-29T00:00:00Z,528,768,33504,240,0.007163324,0.022922636,0.015759312,2014,MKC
2015-01-29T00:00:00Z,568,853,35111,285,0.008117114,0.024294381,0.016177266,2015,MKC
2016-01-28T00:00:00Z,604,952,40922,348,0.008503983,0.02326377,0.014759787,2016,MKC
2017-01-25T00:00:00Z,582,996,43490,414,0.00951943,0.022901817,0.013382387,2017,MKC
2018-01-25T00:00:00Z,683,1242,53810,559,0.010388404,0.023081212,0.012692808,2018,MKC
2019-01-25T00:00:00Z,662,1211,51150,549,0.010733138,0.023675464,0.012942326,2019,MKC
2010-02-19T00:00:00Z,508,579,28566,71,0.002485472,0.020268851,0.017783379,2010,RHI
2011-02-17T00:00:00Z,434,515,26105,81,0.003102854,0.019728021,0.016625168,2011,RHI
2012-02-17T00:00:00Z,437,558,26694,121,0.004532854,0.020903574,0.01637072,2012,RHI
2013-02-15T00:00:00Z,363,457,24972,94,0.003764216,0.018300497,0.014536281,2013,RHI
2014-02-14T00:00:00Z,375,475,25656,100,0.003897724,0.018514188,0.014616464,2014,RHI
2015-02-13T00:00:00Z,456,519,26675,63,0.002361762,0.01945642,0.017094658,2015,RHI
2016-02-17T00:00:00Z,478,578,28280,100,0.003536068,0.020438472,0.016902405,2016,RHI
2017-02-13T00:00:00Z,474,610,28718,136,0.004735706,0.021241033,0.016505328,2017,RHI
2018-02-20T00:00:00Z,463,593,29427,130,0.004417712,0.020151561,0.01573385,2018,RHI
2019-02-15T00:00:00Z,476,533,28043,57,0.002032593,0.019006526,0.016973933,2019,RHI
2011-02-23T00:00:00Z,785,1377,57018,592,0.010382686,0.024150268,0.013767582,2011,EFX
2012-02-23T00:00:00Z,742,1374,56011,632,0.011283498,0.024530896,0.013247398,2012,EFX
2013-02-22T00:00:00Z,728,1362,56579,634,0.011205571,0.024072536,0.012866965,2013,EFX
2014-02-28T00:00:00Z,801,1425,59624,624,0.010465584,0.023899772,0.013434188,2014,EFX
2015-02-25T00:00:00Z,782,1436,58609,654,0.011158696,0.024501356,0.013342661,2015,EFX
2016-02-24T00:00:00Z,818,1426,58091,608,0.010466337,0.024547692,0.014081355,2016,EFX
2017-02-22T00:00:00Z,837,1450,59033,613,0.010384022,0.024562533,0.01417851,2017,EFX
2018-03-01T00:00:00Z,1072,1799,71123,727,0.010221729,0.025294209,0.01507248,2018,EFX
2019-02-21T00:00:00Z,1187,1894,73672,707,0.00959659,0.025708546,0.016111956,2019,EFX
2010-02-25T00:00:00Z,453,687,30785,234,0.007601104,0.022316063,0.014714959,2010,GWW
2011-02-28T00:00:00Z,444,629,30096,185,0.006146996,0.020899787,0.014752791,2011,GWW
2012-02-28T00:00:00Z,406,649,29258,243,0.008305421,0.022181967,0.013876547,2012,GWW
2013-02-28T00:00:00Z,404,663,29643,259,0.008737307,0.022366157,0.01362885,2013,GWW
2014-02-27T00:00:00Z,404,688,30752,284,0.009235172,0.022372529,0.013137357,2014,GWW
2015-02-27T00:00:00Z,420,682,31062,262,0.008434743,0.021956088,0.013521344,2015,GWW
2016-02-29T00:00:00Z,474,744,33784,270,0.007991949,0.022022259,0.01403031,2016,GWW
2017-02-28T00:00:00Z,498,784,35665,286,0.008019066,0.021982336,0.013963269,2017,GWW
2018-02-26T00:00:00Z,438,794,35278,356,0.010091275,0.022506945,0.01241567,2018,GWW
2019-02-28T00:00:00Z,458,707,32280,249,0.007713755,0.021902107,0.014188352,2019,GWW
2010-02-24T00:00:00Z,632,1134,58024,502,0.008651592,0.019543637,0.010892045,2010,HAS
2011-02-23T00:00:00Z,581,1096,55414,515,0.00929368,0.019778395,0.010484715,2011,HAS
2012-02-22T00:00:00Z,623,1149,55756,526,0.009433962,0.020607648,0.011173685,2012,HAS
2013-02-27T00:00:00Z,657,1247,57709,590,0.010223709,0.021608415,0.011384706,2013,HAS
2014-02-26T00:00:00Z,737,1420,62404,683,0.010944811,0.022754952,0.01181014,2014,HAS
2015-02-26T00:00:00Z,748,1494,64866,746,0.011500632,0.023032097,0.011531465,2015,HAS
2016-02-24T00:00:00Z,767,1438,60315,671,0.011124927,0.023841499,0.012716571,2016,HAS
2017-02-22T00:00:00Z,757,1523,61984,766,0.012358028,0.024570857,0.012212829,2017,HAS
2018-02-26T00:00:00Z,806,1526,62601,720,0.011501414,0.024376607,0.012875194,2018,HAS
2019-02-26T00:00:00Z,864,1670,66746,806,0.01207563,0.025020226,0.012944596,2019,HAS
2010-02-26T00:00:00Z,650,1479,59498,829,0.013933241,0.024857978,0.010924737,2010,IPG
2011-02-25T00:00:00Z,573,1436,53075,863,0.016260009,0.027056053,0.010796043,2011,IPG
2012-02-24T00:00:00Z,532,1350,50545,818,0.016183599,0.026708873,0.010525275,2012,IPG
2013-02-22T00:00:00Z,548,1343,51474,795,0.015444691,0.026090842,0.010646151,2013,IPG
2014-02-24T00:00:00Z,555,1354,50459,799,0.015834638,0.026833667,0.010999029,2014,IPG
2015-02-23T00:00:00Z,564,1385,50302,821,0.016321419,0.027533696,0.011212278,2015,IPG
2016-02-22T00:00:00Z,601,1385,50543,784,0.015511545,0.02740241,0.011890865,2016,IPG
2017-02-21T00:00:00Z,547,1281,48281,734,0.015202668,0.026532176,0.011329509,2017,IPG
2018-02-26T00:00:00Z,577,1317,50684,740,0.014600268,0.025984532,0.011384263,2018,IPG
2019-02-25T00:00:00Z,598,1364,55105,766,0.013900735,0.024752745,0.01085201,2019,IPG
2009-10-28T00:00:00Z,966,873,50904,-93,-0.001826968,0.017149929,0.018976898,2009,MU
2010-10-26T00:00:00Z,1049,980,52019,-69,-0.001326438,0.01883927,0.020165709,2010,MU
2011-10-25T00:00:00Z,1028,904,50272,-124,-0.002466582,0.017982177,0.020448759,2011,MU
2012-10-29T00:00:00Z,1173,997,56362,-176,-0.003122671,0.017689223,0.020811895,2012,MU
2013-10-28T00:00:00Z,1255,1261,68862,6,8.71E-05,0.018311986,0.018224856,2013,MU
2014-10-27T00:00:00Z,1081,1125,62252,44,0.000706805,0.018071709,0.017364904,2014,MU
2015-10-27T00:00:00Z,893,1008,55286,115,0.002080093,0.018232464,0.016152371,2015,MU
2016-10-28T00:00:00Z,944,1003,57245,59,0.001030658,0.017521181,0.016490523,2016,MU
2017-10-26T00:00:00Z,935,991,53041,56,0.001055787,0.01868366,0.017627873,2017,MU
2018-10-15T00:00:00Z,965,1047,51741,82,0.001584817,0.020235403,0.018650587,2018,MU
2010-02-19T00:00:00Z,861,1119,53324,258,0.004838347,0.020984922,0.016146576,2010,PHM
2011-02-10T00:00:00Z,933,1199,55855,266,0.004762331,0.021466297,0.016703966,2011,PHM
2012-02-09T00:00:00Z,872,1027,50215,155,0.003086727,0.020452056,0.017365329,2012,PHM
2013-02-06T00:00:00Z,817,971,45566,154,0.003379713,0.021309748,0.017930036,2013,PHM
2014-02-05T00:00:00Z,772,937,44872,165,0.003677126,0.020881619,0.017204493,2014,PHM
2015-02-04T00:00:00Z,658,856,42884,198,0.004617107,0.019960825,0.015343718,2015,PHM
2016-02-08T00:00:00Z,647,817,41891,170,0.004058151,0.019502996,0.015444845,2016,PHM
2017-02-01T00:00:00Z,624,796,42645,172,0.004033298,0.018665729,0.014632431,2017,PHM
2018-02-07T00:00:00Z,669,859,44646,190,0.0042557,0.019240245,0.014984545,2018,PHM
2019-01-31T00:00:00Z,660,855,45751,195,0.004262202,0.018688116,0.014425914,2019,PHM
2010-03-30T00:00:00Z,215,282,16890,67,0.003966844,0.01669627,0.012729426,2010,WMT
2011-03-30T00:00:00Z,214,281,17174,67,0.003901246,0.016361942,0.012460696,2011,WMT
2012-03-27T00:00:00Z,231,303,17760,72,0.004054054,0.017060811,0.013006757,2012,WMT
2013-03-26T00:00:00Z,286,324,19030,38,0.001996847,0.017025749,0.015028902,2013,WMT
2014-03-21T00:00:00Z,302,370,20402,68,0.003333007,0.018135477,0.01480247,2014,WMT
2015-04-01T00:00:00Z,319,402,22016,83,0.003769985,0.018259448,0.014489462,2015,WMT
2016-03-30T00:00:00Z,355,417,23214,62,0.002670802,0.017963298,0.015292496,2016,WMT
2017-03-31T00:00:00Z,362,435,23577,73,0.003096238,0.018450185,0.015353947,2017,WMT
2018-03-30T00:00:00Z,806,1114,54454,308,0.00565615,0.020457634,0.014801484,2018,WMT
2019-03-28T00:00:00Z,835,1083,53435,248,0.004641153,0.020267615,0.015626462,2019,WMT
2004-03-30T00:00:00Z,653,921,51473,268,0.005206613,0.017892876,0.012686263,2004,CAG
2005-03-16T00:00:00Z,796,1084,58840,288,0.00489463,0.018422842,0.013528212,2005,CAG
2006-03-15T00:00:00Z,991,1288,67365,297,0.004408818,0.019119721,0.014710903,2006,CAG
2007-04-02T00:00:00Z,934,1293,65331,359,0.005495094,0.019791523,0.014296429,2007,CAG
2008-04-29T00:00:00Z,669,906,44793,237,0.005291005,0.020226375,0.014935369,2008,CAG
2009-03-31T00:00:00Z,644,898,42510,254,0.005975065,0.021124441,0.015149377,2009,CAG
2010-02-26T00:00:00Z,485,770,32027,285,0.008898742,0.024042214,0.015143473,2010,ITW
2011-02-28T00:00:00Z,470,832,32328,362,0.011197723,0.025736204,0.014538481,2011,ITW
2012-02-17T00:00:00Z,446,825,33511,379,0.011309719,0.024618782,0.013309063,2012,ITW
2013-02-19T00:00:00Z,474,843,37235,369,0.009910031,0.022639989,0.012729958,2013,ITW
2014-02-14T00:00:00Z,481,818,38243,337,0.00881207,0.021389535,0.012577465,2014,ITW
2015-02-13T00:00:00Z,492,853,37911,361,0.009522302,0.022500066,0.012977764,2015,ITW
2016-02-12T00:00:00Z,525,966,35981,441,0.012256469,0.026847503,0.014591034,2016,ITW
2017-02-10T00:00:00Z,517,1049,36771,532,0.014467923,0.028527916,0.014059993,2017,ITW
2018-02-15T00:00:00Z,478,1097,37540,619,0.016489078,0.029222163,0.012733085,2018,ITW
2019-02-15T00:00:00Z,471,1096,38434,625,0.016261643,0.028516418,0.012254774,2019,ITW
2009-07-27T00:00:00Z,802,1145,49474,343,0.006932934,0.023143469,0.016210535,2009,NKE
2010-07-20T00:00:00Z,831,1174,50912,343,0.006737115,0.023059397,0.016322282,2010,NKE
2011-07-22T00:00:00Z,850,1097,49117,247,0.005028809,0.022334426,0.017305617,2011,NKE
2012-07-24T00:00:00Z,933,1138,52895,205,0.003875603,0.021514321,0.017638718,2012,NKE
2013-07-23T00:00:00Z,999,1128,53493,129,0.00241153,0.021086871,0.018675341,2013,NKE
2014-07-25T00:00:00Z,1000,1168,56080,168,0.00299572,0.020827389,0.017831669,2014,NKE
2015-07-23T00:00:00Z,1049,1222,57597,173,0.003003629,0.021216383,0.018212754,2015,NKE
2016-07-21T00:00:00Z,1053,1213,57157,160,0.002799307,0.021222247,0.01842294,2016,NKE
2017-07-20T00:00:00Z,1057,1161,56052,104,0.00185542,0.020712909,0.018857489,2017,NKE
2018-07-25T00:00:00Z,1010,1130,54600,120,0.002197802,0.020695971,0.018498168,2018,NKE
2010-03-22T00:00:00Z,508,753,36825,245,0.006653089,0.020448065,0.013794976,2010,JWN
2011-03-18T00:00:00Z,463,674,35854,211,0.005884978,0.01879846,0.012913482,2011,JWN
2012-03-16T00:00:00Z,500,843,40172,343,0.008538285,0.020984766,0.01244648,2012,JWN
2013-03-18T00:00:00Z,409,695,35401,286,0.008078868,0.019632214,0.011553346,2013,JWN
2014-03-17T00:00:00Z,427,695,36119,268,0.007419917,0.01924195,0.011822033,2014,JWN
2015-03-16T00:00:00Z,446,728,38685,282,0.007289647,0.018818664,0.011529016,2015,JWN
2016-03-14T00:00:00Z,392,735,36974,343,0.009276789,0.019878834,0.010602045,2016,JWN
2017-03-20T00:00:00Z,413,795,36810,382,0.010377615,0.021597392,0.011219777,2017,JWN
2018-03-19T00:00:00Z,416,828,39249,412,0.010497083,0.021096079,0.010598996,2018,JWN
2019-03-18T00:00:00Z,437,819,37546,382,0.010174186,0.021813242,0.011639056,2019,JWN
2010-02-26T00:00:00Z,1332,1630,71307,298,0.004179113,0.022858906,0.018679793,2010,AFL
2011-02-25T00:00:00Z,1394,1693,73496,299,0.004068249,0.023035267,0.018967019,2011,AFL
2012-02-27T00:00:00Z,1556,1837,81430,281,0.003450817,0.022559253,0.019108437,2012,AFL
2013-02-27T00:00:00Z,1584,1941,85308,357,0.004184836,0.022752849,0.018568012,2013,AFL
2014-02-27T00:00:00Z,1643,2049,88526,406,0.004586223,0.023145742,0.018559519,2014,AFL
2015-02-26T00:00:00Z,1664,2126,89537,462,0.005159878,0.023744374,0.018584496,2015,AFL
2016-02-25T00:00:00Z,1834,2256,93953,422,0.004491608,0.024012006,0.019520398,2016,AFL
2017-02-24T00:00:00Z,1767,2282,91154,515,0.005649779,0.025034557,0.019384777,2017,AFL
2018-02-23T00:00:00Z,1874,2392,98237,518,0.005272962,0.024349278,0.019076315,2018,AFL
2019-02-25T00:00:00Z,1965,2590,107558,625,0.005810818,0.024080031,0.018269213,2019,AFL
2004-03-30T00:00:00Z,653,921,51473,268,0.005206613,0.017892876,0.012686263,2004,AIF
2005-03-16T00:00:00Z,796,1084,58840,288,0.00489463,0.018422842,0.013528212,2005,AIF
2006-03-15T00:00:00Z,991,1288,67365,297,0.004408818,0.019119721,0.014710903,2006,AIF
2007-04-02T00:00:00Z,934,1293,65331,359,0.005495094,0.019791523,0.014296429,2007,AIF
2008-04-29T00:00:00Z,669,906,44793,237,0.005291005,0.020226375,0.014935369,2008,AIF
2009-03-31T00:00:00Z,644,898,42510,254,0.005975065,0.021124441,0.015149377,2009,AIF
2010-02-26T00:00:00Z,518,613,24376,95,0.003897276,0.025147686,0.02125041,2010,NTRS
2011-02-25T00:00:00Z,579,619,25287,40,0.00158184,0.024478981,0.022897141,2011,NTRS
2012-02-24T00:00:00Z,598,650,27887,52,0.001864668,0.023308352,0.021443683,2012,NTRS
2013-02-26T00:00:00Z,626,631,28431,5,0.000175864,0.022194084,0.02201822,2013,NTRS
2014-02-26T00:00:00Z,383,329,13500,-54,-0.004,0.02437037,0.02837037,2014,NTRS
2015-02-26T00:00:00Z,2325,2838,97983,513,0.005235602,0.028964208,0.023728606,2015,NTRS
2016-02-29T00:00:00Z,2332,2635,95207,303,0.003182539,0.027676536,0.024493997,2016,NTRS
2017-02-28T00:00:00Z,2360,2681,98218,321,0.00326824,0.027296422,0.024028182,2017,NTRS
2018-02-27T00:00:00Z,2246,2697,98685,451,0.004570097,0.027329381,0.022759285,2018,NTRS
2019-02-26T00:00:00Z,2359,2754,101526,395,0.003890629,0.027126056,0.023235427,2019,NTRS
2010-02-17T00:00:00Z,801,1145,53114,344,0.006476635,0.021557405,0.01508077,2010,FRT
2011-02-15T00:00:00Z,840,1196,53986,356,0.006594302,0.022153892,0.01555959,2011,FRT
2012-02-16T00:00:00Z,813,1161,53839,348,0.006463716,0.021564294,0.015100578,2012,FRT
2013-02-12T00:00:00Z,782,1131,51449,349,0.006783417,0.021982935,0.015199518,2013,FRT
2014-02-11T00:00:00Z,772,1087,50879,315,0.006191159,0.021364414,0.015173254,2014,FRT
2015-02-10T00:00:00Z,780,1084,51061,304,0.005953663,0.02122951,0.015275847,2015,FRT
2016-02-09T00:00:00Z,773,1100,51616,327,0.006335245,0.021311221,0.014975976,2016,FRT
2017-02-13T00:00:00Z,752,1091,51496,339,0.006583036,0.021186112,0.014603076,2017,FRT
2018-02-13T00:00:00Z,723,1081,51955,358,0.006890578,0.020806467,0.013915889,2018,FRT
2019-02-13T00:00:00Z,736,1086,51799,350,0.006756887,0.020965656,0.014208769,2019,FRT
2011-02-08T00:00:00Z,1024,1503,65836,479,0.007275655,0.022829455,0.0155538,2011,LUV
2012-02-09T00:00:00Z,1073,1616,75494,543,0.007192625,0.021405675,0.01421305,2012,LUV
2013-02-07T00:00:00Z,1060,1593,77730,533,0.006857069,0.020494018,0.013636948,2013,LUV
2014-02-04T00:00:00Z,1068,1588,77394,520,0.006718867,0.020518386,0.013799519,2014,LUV
2015-02-06T00:00:00Z,1058,1533,73482,475,0.006464168,0.020862252,0.014398084,2015,LUV
2016-02-03T00:00:00Z,1028,1367,68441,339,0.004953171,0.019973408,0.015020236,2016,LUV
2017-02-07T00:00:00Z,981,1359,68839,378,0.005491073,0.019741716,0.014250643,2017,LUV
2018-02-07T00:00:00Z,1026,1458,68868,432,0.00627287,0.021170936,0.014898066,2018,LUV
2019-02-05T00:00:00Z,1069,1636,70242,567,0.008072094,0.023290909,0.015218815,2019,LUV
2010-02-26T00:00:00Z,1440,2338,119500,898,0.007514644,0.019564854,0.012050209,2010,LNT
2011-02-28T00:00:00Z,1460,2359,127632,899,0.007043688,0.018482826,0.011439138,2011,LNT
2012-02-27T00:00:00Z,1462,2425,132955,963,0.007243052,0.018239254,0.010996202,2012,LNT
2013-02-26T00:00:00Z,1186,2258,119933,1072,0.008938324,0.018827179,0.009888855,2013,LNT
2014-02-25T00:00:00Z,1078,2004,109460,926,0.008459711,0.018308058,0.009848346,2014,LNT
2015-02-25T00:00:00Z,1061,1804,101327,743,0.007332695,0.017803744,0.010471049,2015,LNT
2016-02-24T00:00:00Z,1019,1670,94188,651,0.006911708,0.017730496,0.010818788,2016,LNT
2017-02-24T00:00:00Z,908,1495,80709,587,0.007273043,0.018523337,0.011250294,2017,LNT
2018-02-23T00:00:00Z,828,1473,75025,645,0.008597134,0.019633456,0.011036321,2018,LNT
2019-02-22T00:00:00Z,746,1229,64110,483,0.007533926,0.019170176,0.01163625,2019,LNT
2004-03-30T00:00:00Z,653,921,51473,268,0.005206613,0.017892876,0.012686263,2004,GPS
2005-03-16T00:00:00Z,796,1084,58840,288,0.00489463,0.018422842,0.013528212,2005,GPS
2006-03-15T00:00:00Z,991,1288,67365,297,0.004408818,0.019119721,0.014710903,2006,GPS
2007-04-02T00:00:00Z,934,1293,65331,359,0.005495094,0.019791523,0.014296429,2007,GPS
2008-04-29T00:00:00Z,669,906,44793,237,0.005291005,0.020226375,0.014935369,2008,GPS
2009-03-31T00:00:00Z,644,898,42510,254,0.005975065,0.021124441,0.015149377,2009,GPS
2011-02-28T00:00:00Z,1201,1427,69368,226,0.003257986,0.020571445,0.017313459,2011,AXP
2012-02-24T00:00:00Z,1354,1500,72339,146,0.002018275,0.020735703,0.018717428,2012,AXP
2013-02-22T00:00:00Z,1304,1485,68920,181,0.002626233,0.021546721,0.018920488,2013,AXP
2014-02-25T00:00:00Z,1234,1411,67692,177,0.002614785,0.020844413,0.018229628,2014,AXP
2015-02-24T00:00:00Z,1266,1386,65861,120,0.001822019,0.021044321,0.019222302,2015,AXP
2016-02-19T00:00:00Z,2221,2323,107682,102,0.000947234,0.021572779,0.020625546,2016,AXP
2017-02-17T00:00:00Z,511,525,33149,14,0.000422336,0.015837582,0.015415246,2017,AXP
2018-02-16T00:00:00Z,1985,1975,92231,-10,-0.000108423,0.021413624,0.021522048,2018,AXP
2019-02-13T00:00:00Z,1222,1347,63904,125,0.001956059,0.021078493,0.019122434,2019,AXP
2006-03-15T00:00:00Z,1872,950,54683,-922,-0.016860816,0.017372858,0.034233674,2006,CB
2007-02-28T00:00:00Z,1930,1047,56236,-883,-0.015701686,0.018617967,0.034319653,2007,CB
2008-02-28T00:00:00Z,1982,1105,58042,-877,-0.015109748,0.019037938,0.034147686,2008,CB
2009-03-02T00:00:00Z,2048,1144,57672,-904,-0.015674851,0.019836316,0.035511167,2009,CB
2010-02-26T00:00:00Z,2132,1246,58338,-886,-0.015187356,0.021358291,0.036545648,2010,CB
2011-02-25T00:00:00Z,2212,1285,61082,-927,-0.01517632,0.021037294,0.036213614,2011,CB
2012-02-27T00:00:00Z,2162,1273,60956,-889,-0.01458429,0.020883916,0.035468207,2012,CB
2013-02-28T00:00:00Z,2243,1267,64030,-976,-0.015242855,0.0197876,0.035030454,2013,CB
2014-02-28T00:00:00Z,2339,1274,64451,-1065,-0.016524181,0.019766955,0.036291136,2014,CB
2015-02-26T00:00:00Z,2362,1264,66263,-1098,-0.016570333,0.019075502,0.035645836,2015,CB
2011-02-22T00:00:00Z,1052,1611,78235,559,0.00714514,0.020591807,0.013446667,2011,RKY
2012-02-27T00:00:00Z,1177,1767,78872,590,0.007480475,0.022403388,0.014922913,2012,RKY
2013-02-22T00:00:00Z,1292,1769,84710,477,0.005630976,0.020883013,0.015252036,2013,RKY
2014-02-14T00:00:00Z,1402,2005,92397,603,0.006526186,0.021699839,0.015173653,2014,RKY
2015-02-12T00:00:00Z,1419,2033,91246,614,0.006729062,0.022280429,0.015551367,2015,RKY
2016-02-11T00:00:00Z,1421,2182,93905,761,0.008103935,0.023236249,0.015132315,2016,RKY
2017-02-14T00:00:00Z,1492,2345,101924,853,0.008368981,0.023007339,0.014638358,2017,RKY
2018-02-14T00:00:00Z,1487,2346,99371,859,0.008644373,0.023608497,0.014964124,2018,RKY
2019-02-12T00:00:00Z,1553,2331,97827,778,0.007952815,0.023827778,0.015874963,2019,RKY
2011-02-22T00:00:00Z,1052,1611,78235,559,0.00714514,0.020591807,0.013446667,2011,TAP
2012-02-27T00:00:00Z,1177,1767,78872,590,0.007480475,0.022403388,0.014922913,2012,TAP
2013-02-22T00:00:00Z,1292,1769,84710,477,0.005630976,0.020883013,0.015252036,2013,TAP
2014-02-14T00:00:00Z,1402,2005,92397,603,0.006526186,0.021699839,0.015173653,2014,TAP
2015-02-12T00:00:00Z,1419,2033,91246,614,0.006729062,0.022280429,0.015551367,2015,TAP
2016-02-11T00:00:00Z,1421,2182,93905,761,0.008103935,0.023236249,0.015132315,2016,TAP
2017-02-14T00:00:00Z,1492,2345,101924,853,0.008368981,0.023007339,0.014638358,2017,TAP
2018-02-14T00:00:00Z,1487,2346,99371,859,0.008644373,0.023608497,0.014964124,2018,TAP
2019-02-12T00:00:00Z,1553,2331,97827,778,0.007952815,0.023827778,0.015874963,2019,TAP
2004-03-30T00:00:00Z,653,921,51473,268,0.005206613,0.017892876,0.012686263,2004,UDR
2005-03-16T00:00:00Z,796,1084,58840,288,0.00489463,0.018422842,0.013528212,2005,UDR
2006-03-15T00:00:00Z,991,1288,67365,297,0.004408818,0.019119721,0.014710903,2006,UDR
2007-04-02T00:00:00Z,934,1293,65331,359,0.005495094,0.019791523,0.014296429,2007,UDR
2008-04-29T00:00:00Z,669,906,44793,237,0.005291005,0.020226375,0.014935369,2008,UDR
2009-03-31T00:00:00Z,644,898,42510,254,0.005975065,0.021124441,0.015149377,2009,UDR
2010-02-22T00:00:00Z,1174,1605,66709,431,0.006460897,0.024059722,0.017598825,2010,INTC
2011-02-18T00:00:00Z,1168,1662,66701,494,0.007406186,0.024917168,0.017510982,2011,INTC
2012-02-23T00:00:00Z,1105,1447,61317,342,0.005577572,0.023598676,0.018021103,2012,INTC
2013-02-19T00:00:00Z,1090,1421,60643,331,0.005458173,0.023432218,0.017974045,2013,INTC
2014-02-14T00:00:00Z,1093,1525,62547,432,0.006906806,0.024381665,0.017474859,2014,INTC
2015-02-13T00:00:00Z,1165,1535,63195,370,0.005854894,0.024289896,0.018435003,2015,INTC
2016-02-12T00:00:00Z,1170,1681,66881,511,0.007640436,0.025134194,0.017493758,2016,INTC
2017-02-17T00:00:00Z,1003,1424,58707,421,0.007171206,0.024256051,0.017084845,2017,INTC
2018-02-16T00:00:00Z,918,1373,53373,455,0.00852491,0.025724617,0.017199708,2018,INTC
2019-02-01T00:00:00Z,1062,1644,61065,582,0.009530828,0.026922132,0.017391304,2019,INTC
2004-03-30T00:00:00Z,653,921,51473,268,0.005206613,0.017892876,0.012686263,2004,SPC
2005-03-16T00:00:00Z,796,1084,58840,288,0.00489463,0.018422842,0.013528212,2005,SPC
2006-03-15T00:00:00Z,991,1288,67365,297,0.004408818,0.019119721,0.014710903,2006,SPC
2007-04-02T00:00:00Z,934,1293,65331,359,0.005495094,0.019791523,0.014296429,2007,SPC
2008-04-29T00:00:00Z,669,906,44793,237,0.005291005,0.020226375,0.014935369,2008,SPC
2009-03-31T00:00:00Z,644,898,42510,254,0.005975065,0.021124441,0.015149377,2009,SPC
2004-03-30T00:00:00Z,653,921,51473,268,0.005206613,0.017892876,0.012686263,2004,STA
2005-03-16T00:00:00Z,796,1084,58840,288,0.00489463,0.018422842,0.013528212,2005,STA
2006-03-15T00:00:00Z,991,1288,67365,297,0.004408818,0.019119721,0.014710903,2006,STA
2007-04-02T00:00:00Z,934,1293,65331,359,0.005495094,0.019791523,0.014296429,2007,STA
2008-04-29T00:00:00Z,669,906,44793,237,0.005291005,0.020226375,0.014935369,2008,STA
2009-03-31T00:00:00Z,644,898,42510,254,0.005975065,0.021124441,0.015149377,2009,STA
2004-03-30T00:00:00Z,653,921,51473,268,0.005206613,0.017892876,0.012686263,2004,TRV
2005-03-16T00:00:00Z,796,1084,58840,288,0.00489463,0.018422842,0.013528212,2005,TRV
2006-03-15T00:00:00Z,991,1288,67365,297,0.004408818,0.019119721,0.014710903,2006,TRV
2007-04-02T00:00:00Z,934,1293,65331,359,0.005495094,0.019791523,0.014296429,2007,TRV
2008-04-29T00:00:00Z,669,906,44793,237,0.005291005,0.020226375,0.014935369,2008,TRV
2009-03-31T00:00:00Z,644,898,42510,254,0.005975065,0.021124441,0.015149377,2009,TRV
2004-03-30T00:00:00Z,653,921,51473,268,0.005206613,0.017892876,0.012686263,2004,MDT
2005-03-16T00:00:00Z,796,1084,58840,288,0.00489463,0.018422842,0.013528212,2005,MDT
2006-03-15T00:00:00Z,991,1288,67365,297,0.004408818,0.019119721,0.014710903,2006,MDT
2007-04-02T00:00:00Z,934,1293,65331,359,0.005495094,0.019791523,0.014296429,2007,MDT
2008-04-29T00:00:00Z,669,906,44793,237,0.005291005,0.020226375,0.014935369,2008,MDT
2009-03-31T00:00:00Z,644,898,42510,254,0.005975065,0.021124441,0.015149377,2009,MDT
2004-03-30T00:00:00Z,653,921,51473,268,0.005206613,0.017892876,0.012686263,2004,SNA
2005-03-16T00:00:00Z,796,1084,58840,288,0.00489463,0.018422842,0.013528212,2005,SNA
2006-03-15T00:00:00Z,991,1288,67365,297,0.004408818,0.019119721,0.014710903,2006,SNA
2007-04-02T00:00:00Z,934,1293,65331,359,0.005495094,0.019791523,0.014296429,2007,SNA
2008-04-29T00:00:00Z,669,906,44793,237,0.005291005,0.020226375,0.014935369,2008,SNA
2009-03-31T00:00:00Z,644,898,42510,254,0.005975065,0.021124441,0.015149377,2009,SNA
2011-03-01T00:00:00Z,2974,2958,134771,-16,-0.00011872,0.021948342,0.022067062,2011,PNC
2012-02-29T00:00:00Z,3289,3257,153338,-32,-0.000208689,0.021240658,0.021449347,2012,PNC
2013-03-01T00:00:00Z,3642,3736,172465,94,0.000545038,0.021662366,0.021117328,2013,PNC
2014-03-03T00:00:00Z,3717,3762,170567,45,0.000263826,0.022055849,0.021792023,2014,PNC
2015-03-02T00:00:00Z,3700,3745,171218,45,0.000262823,0.0218727,0.021609877,2015,PNC
2016-02-29T00:00:00Z,3567,3533,161267,-34,-0.00021083,0.021907768,0.022118598,2016,PNC
2017-02-28T00:00:00Z,2920,2851,126204,-69,-0.000546734,0.022590409,0.023137143,2017,PNC
2018-02-28T00:00:00Z,2688,2632,117835,-56,-0.000475241,0.022336318,0.022811559,2018,PNC
2019-03-01T00:00:00Z,2768,2689,117636,-79,-0.000671563,0.022858649,0.023530212,2019,PNC
2004-03-30T00:00:00Z,653,921,51473,268,0.005206613,0.017892876,0.012686263,2004,PCAR
2005-03-16T00:00:00Z,796,1084,58840,288,0.00489463,0.018422842,0.013528212,2005,PCAR
2006-03-15T00:00:00Z,991,1288,67365,297,0.004408818,0.019119721,0.014710903,2006,PCAR
2007-04-02T00:00:00Z,934,1293,65331,359,0.005495094,0.019791523,0.014296429,2007,PCAR
2008-04-29T00:00:00Z,669,906,44793,237,0.005291005,0.020226375,0.014935369,2008,PCAR
2009-03-31T00:00:00Z,644,898,42510,254,0.005975065,0.021124441,0.015149377,2009,PCAR
2004-03-30T00:00:00Z,653,921,51473,268,0.005206613,0.017892876,0.012686263,2004,CTL
2005-03-16T00:00:00Z,796,1084,58840,288,0.00489463,0.018422842,0.013528212,2005,CTL
2006-03-15T00:00:00Z,991,1288,67365,297,0.004408818,0.019119721,0.014710903,2006,CTL
2007-04-02T00:00:00Z,934,1293,65331,359,0.005495094,0.019791523,0.014296429,2007,CTL
2008-04-29T00:00:00Z,669,906,44793,237,0.005291005,0.020226375,0.014935369,2008,CTL
2009-03-31T00:00:00Z,644,898,42510,254,0.005975065,0.021124441,0.015149377,2009,CTL
2009-07-15T00:00:00Z,769,1331,65088,562,0.008634464,0.020449238,0.011814774,2009,FDX
2010-07-15T00:00:00Z,734,1230,61115,496,0.008115847,0.020125992,0.012010145,2010,FDX
2011-07-12T00:00:00Z,708,1247,60800,539,0.008865132,0.020509868,0.011644737,2011,FDX
2012-07-16T00:00:00Z,701,1228,61948,527,0.008507135,0.019823077,0.011315942,2012,FDX
2013-07-15T00:00:00Z,719,1285,65278,566,0.008670609,0.019685039,0.011014431,2013,FDX
2014-07-14T00:00:00Z,749,1284,64385,535,0.008309389,0.019942533,0.011633144,2014,FDX
2015-07-14T00:00:00Z,795,1376,70540,581,0.008236462,0.019506663,0.011270201,2015,FDX
2016-07-18T00:00:00Z,819,1493,75470,674,0.008930701,0.019782695,0.010851994,2016,FDX
2017-07-17T00:00:00Z,897,1521,78318,624,0.007967517,0.019420823,0.011453306,2017,FDX
2018-07-16T00:00:00Z,883,1685,81697,802,0.009816762,0.020624992,0.01080823,2018,FDX
2004-03-30T00:00:00Z,653,921,51473,268,0.005206613,0.017892876,0.012686263,2004,ADI
2005-03-16T00:00:00Z,796,1084,58840,288,0.00489463,0.018422842,0.013528212,2005,ADI
2006-03-15T00:00:00Z,991,1288,67365,297,0.004408818,0.019119721,0.014710903,2006,ADI
2007-04-02T00:00:00Z,934,1293,65331,359,0.005495094,0.019791523,0.014296429,2007,ADI
2008-04-29T00:00:00Z,669,906,44793,237,0.005291005,0.020226375,0.014935369,2008,ADI
2009-03-31T00:00:00Z,644,898,42510,254,0.005975065,0.021124441,0.015149377,2009,ADI
2004-03-30T00:00:00Z,653,921,51473,268,0.005206613,0.017892876,0.012686263,2004,LEG
2005-03-16T00:00:00Z,796,1084,58840,288,0.00489463,0.018422842,0.013528212,2005,LEG
2006-03-15T00:00:00Z,991,1288,67365,297,0.004408818,0.019119721,0.014710903,2006,LEG
2007-04-02T00:00:00Z,934,1293,65331,359,0.005495094,0.019791523,0.014296429,2007,LEG
2008-04-29T00:00:00Z,669,906,44793,237,0.005291005,0.020226375,0.014935369,2008,LEG
2009-03-31T00:00:00Z,644,898,42510,254,0.005975065,0.021124441,0.015149377,2009,LEG
2004-03-30T00:00:00Z,653,921,51473,268,0.005206613,0.017892876,0.012686263,2004,NWL
2005-03-16T00:00:00Z,796,1084,58840,288,0.00489463,0.018422842,0.013528212,2005,NWL
2006-03-15T00:00:00Z,991,1288,67365,297,0.004408818,0.019119721,0.014710903,2006,NWL
2007-04-02T00:00:00Z,934,1293,65331,359,0.005495094,0.019791523,0.014296429,2007,NWL
2008-04-29T00:00:00Z,669,906,44793,237,0.005291005,0.020226375,0.014935369,2008,NWL
2009-03-31T00:00:00Z,644,898,42510,254,0.005975065,0.021124441,0.015149377,2009,NWL
2004-03-30T00:00:00Z,653,921,51473,268,0.005206613,0.017892876,0.012686263,2004,AMD
2005-03-16T00:00:00Z,796,1084,58840,288,0.00489463,0.018422842,0.013528212,2005,AMD
2006-03-15T00:00:00Z,991,1288,67365,297,0.004408818,0.019119721,0.014710903,2006,AMD
2007-04-02T00:00:00Z,934,1293,65331,359,0.005495094,0.019791523,0.014296429,2007,AMD
2008-04-29T00:00:00Z,669,906,44793,237,0.005291005,0.020226375,0.014935369,2008,AMD
2009-03-31T00:00:00Z,644,898,42510,254,0.005975065,0.021124441,0.015149377,2009,AMD
2004-03-30T00:00:00Z,653,921,51473,268,0.005206613,0.017892876,0.012686263,2004,LOW
2005-03-16T00:00:00Z,796,1084,58840,288,0.00489463,0.018422842,0.013528212,2005,LOW
2006-03-15T00:00:00Z,991,1288,67365,297,0.004408818,0.019119721,0.014710903,2006,LOW
2007-04-02T00:00:00Z,934,1293,65331,359,0.005495094,0.019791523,0.014296429,2007,LOW
2008-04-29T00:00:00Z,669,906,44793,237,0.005291005,0.020226375,0.014935369,2008,LOW
2009-03-31T00:00:00Z,644,898,42510,254,0.005975065,0.021124441,0.015149377,2009,LOW
2004-03-30T00:00:00Z,653,921,51473,268,0.005206613,0.017892876,0.012686263,2004,PAYX
2005-03-16T00:00:00Z,796,1084,58840,288,0.00489463,0.018422842,0.013528212,2005,PAYX
2006-03-15T00:00:00Z,991,1288,67365,297,0.004408818,0.019119721,0.014710903,2006,PAYX
2007-04-02T00:00:00Z,934,1293,65331,359,0.005495094,0.019791523,0.014296429,2007,PAYX
2008-04-29T00:00:00Z,669,906,44793,237,0.005291005,0.020226375,0.014935369,2008,PAYX
2009-03-31T00:00:00Z,644,898,42510,254,0.005975065,0.021124441,0.015149377,2009,PAYX
2004-03-30T00:00:00Z,653,921,51473,268,0.005206613,0.017892876,0.012686263,2004,NBL
2005-03-16T00:00:00Z,796,1084,58840,288,0.00489463,0.018422842,0.013528212,2005,NBL
2006-03-15T00:00:00Z,991,1288,67365,297,0.004408818,0.019119721,0.014710903,2006,NBL
2007-04-02T00:00:00Z,934,1293,65331,359,0.005495094,0.019791523,0.014296429,2007,NBL
2008-04-29T00:00:00Z,669,906,44793,237,0.005291005,0.020226375,0.014935369,2008,NBL
2009-03-31T00:00:00Z,644,898,42510,254,0.005975065,0.021124441,0.015149377,2009,NBL
2012-02-29T00:00:00Z,766,1310,55956,544,0.009721924,0.023411252,0.013689327,2012,TMO
2013-02-27T00:00:00Z,802,1337,56728,535,0.009430969,0.023568608,0.014137639,2013,TMO
2014-02-27T00:00:00Z,876,1339,59184,463,0.00782306,0.022624358,0.014801298,2014,TMO
2015-02-26T00:00:00Z,855,1365,58706,510,0.008687357,0.023251456,0.014564099,2015,TMO
2016-02-25T00:00:00Z,769,1243,53975,474,0.008781843,0.02302918,0.014247337,2016,TMO
2017-02-28T00:00:00Z,747,1293,56101,546,0.009732447,0.023047718,0.013315271,2017,TMO
2018-02-28T00:00:00Z,768,1341,56117,573,0.01021081,0.023896502,0.013685692,2018,TMO
2019-02-27T00:00:00Z,735,1321,55273,586,0.010601921,0.023899553,0.013297632,2019,TMO
2010-02-19T00:00:00Z,933,980,47831,47,0.000982626,0.020488804,0.019506178,2010,CSX
2011-02-18T00:00:00Z,790,908,44270,118,0.002665462,0.020510504,0.017845042,2011,CSX
2012-02-21T00:00:00Z,772,923,44383,151,0.003402204,0.020796251,0.017394047,2012,CSX
2013-02-19T00:00:00Z,738,962,43593,224,0.00513844,0.022067763,0.016929324,2013,CSX
2014-02-12T00:00:00Z,743,1006,44557,263,0.005902552,0.022577822,0.01667527,2014,CSX
2015-02-11T00:00:00Z,759,981,42874,222,0.005177963,0.022881,0.017703037,2015,CSX
2016-02-10T00:00:00Z,755,1021,42966,266,0.006190942,0.023762975,0.017572034,2016,CSX
2017-02-14T00:00:00Z,806,1093,45710,287,0.006278714,0.023911617,0.017632903,2017,CSX
2018-02-07T00:00:00Z,719,1100,46034,381,0.008276491,0.023895382,0.01561889,2018,CSX
2019-02-06T00:00:00Z,700,1090,45359,390,0.008598073,0.024030512,0.015432439,2019,CSX
2011-02-28T00:00:00Z,1118,1422,60547,304,0.005020893,0.023485887,0.018464994,2011,TMK
2012-02-28T00:00:00Z,1124,1432,58034,308,0.005307234,0.02467519,0.019367957,2012,TMK
2013-02-28T00:00:00Z,1057,1391,58642,334,0.005695577,0.023720201,0.018024624,2013,TMK
2014-02-28T00:00:00Z,987,1406,58881,419,0.007116048,0.023878671,0.016762623,2014,TMK
2015-02-27T00:00:00Z,977,1435,59571,458,0.007688305,0.024088902,0.016400598,2015,TMK
2016-02-26T00:00:00Z,967,1319,54475,352,0.00646168,0.024212942,0.017751262,2016,TMK
2017-02-27T00:00:00Z,972,1356,55645,384,0.00690089,0.024368766,0.017467877,2017,TMK
2018-02-27T00:00:00Z,939,1332,54515,393,0.007209025,0.024433642,0.017224617,2018,TMK
2019-03-01T00:00:00Z,977,1268,53126,291,0.005477544,0.023867786,0.018390242,2019,TMK
2010-02-25T00:00:00Z,1253,1232,61810,-21,-0.000339751,0.01993205,0.020271801,2010,ESV
2011-02-24T00:00:00Z,1440,1574,70229,134,0.001908044,0.022412394,0.02050435,2011,ESV
2012-02-24T00:00:00Z,1334,1773,78098,439,0.005621143,0.022702246,0.017081103,2012,ESV
2013-02-22T00:00:00Z,1203,1450,71295,247,0.003464479,0.020338032,0.016873554,2013,ESV
2014-02-26T00:00:00Z,1194,1435,69665,241,0.003459413,0.020598579,0.017139166,2014,ESV
2015-03-02T00:00:00Z,1542,1630,77444,88,0.001136305,0.021047467,0.019911162,2015,ESV
2016-02-25T00:00:00Z,1848,1737,82898,-111,-0.001338995,0.020953461,0.022292456,2016,ESV
2017-02-28T00:00:00Z,1693,1546,76973,-147,-0.001909761,0.020084965,0.021994725,2017,ESV
2018-02-27T00:00:00Z,1748,1717,80076,-31,-0.000387132,0.02144213,0.021829262,2018,ESV
2019-02-28T00:00:00Z,1758,1679,80970,-79,-0.00097567,0.020736075,0.021711745,2019,ESV
2019-02-28T00:00:00Z,1588,2512,95354,924,0.009690207,0.026343939,0.016653732,2019,CI
2004-03-30T00:00:00Z,653,921,51473,268,0.005206613,0.017892876,0.012686263,2004,LTD
2005-03-16T00:00:00Z,796,1084,58840,288,0.00489463,0.018422842,0.013528212,2005,LTD
2006-03-15T00:00:00Z,991,1288,67365,297,0.004408818,0.019119721,0.014710903,2006,LTD
2007-04-02T00:00:00Z,934,1293,65331,359,0.005495094,0.019791523,0.014296429,2007,LTD
2008-04-29T00:00:00Z,669,906,44793,237,0.005291005,0.020226375,0.014935369,2008,LTD
2009-03-31T00:00:00Z,644,898,42510,254,0.005975065,0.021124441,0.015149377,2009,LTD
2010-02-17T00:00:00Z,844,864,41608,20,0.000480677,0.020765237,0.020284561,2010,NSC
2011-02-17T00:00:00Z,832,879,42948,47,0.001094347,0.020466611,0.019372264,2011,NSC
2012-02-15T00:00:00Z,795,899,43024,104,0.002417255,0.020895314,0.018478059,2012,NSC
2013-02-15T00:00:00Z,813,862,41814,49,0.001171856,0.020615105,0.019443249,2013,NSC
2014-02-14T00:00:00Z,802,830,39995,28,0.000700088,0.020752594,0.020052507,2014,NSC
2015-02-11T00:00:00Z,684,762,37167,78,0.002098636,0.020502058,0.018403422,2015,NSC
2016-02-08T00:00:00Z,688,756,36742,68,0.001850743,0.020575908,0.018725165,2016,NSC
2017-02-06T00:00:00Z,640,734,34942,94,0.002690172,0.021006239,0.018316067,2017,NSC
2018-02-05T00:00:00Z,620,746,34851,126,0.003615391,0.021405412,0.01779002,2018,NSC
2019-02-08T00:00:00Z,612,714,34865,102,0.00292557,0.02047899,0.01755342,2019,NSC
2010-03-01T00:00:00Z,600,561,22526,-39,-0.001731333,0.024904555,0.026635887,2010,PGR
2011-03-01T00:00:00Z,619,597,23215,-22,-0.000947663,0.025716132,0.026663795,2011,PGR
2012-02-28T00:00:00Z,665,633,24734,-32,-0.001293766,0.025592302,0.026886068,2012,PGR
2013-02-26T00:00:00Z,686,649,25179,-37,-0.001469479,0.025775448,0.027244926,2013,PGR
2014-02-26T00:00:00Z,691,659,25668,-32,-0.001246688,0.025673991,0.026920679,2014,PGR
2015-03-02T00:00:00Z,730,706,27188,-24,-0.000882742,0.025967339,0.026850081,2015,PGR
2016-02-29T00:00:00Z,619,640,24996,21,0.000840134,0.025604097,0.024763962,2016,PGR
2017-03-01T00:00:00Z,548,638,24101,90,0.003734285,0.026471931,0.022737646,2017,PGR
2018-02-27T00:00:00Z,576,676,25118,100,0.003981209,0.026912971,0.022931762,2018,PGR
2019-02-27T00:00:00Z,534,601,23110,67,0.002899178,0.026006058,0.02310688,2019,PGR
2010-03-01T00:00:00Z,784,1175,80209,391,0.004874765,0.014649229,0.009774464,2010,PSA
2011-03-01T00:00:00Z,730,1157,79407,427,0.00537736,0.014570504,0.009193144,2011,PSA
2012-02-27T00:00:00Z,721,1128,75713,407,0.005375563,0.014898366,0.009522803,2012,PSA
2013-02-26T00:00:00Z,642,981,71185,339,0.004762239,0.013780993,0.009018754,2013,PSA
2014-02-26T00:00:00Z,620,910,71652,290,0.00404734,0.012700274,0.008652934,2014,PSA
2015-02-25T00:00:00Z,608,873,71235,265,0.003720081,0.012255212,0.00853513,2015,PSA
2016-02-29T00:00:00Z,508,706,39701,198,0.00498728,0.017782927,0.012795647,2016,PSA
2017-03-01T00:00:00Z,491,737,40806,246,0.006028525,0.018061069,0.012032544,2017,PSA
2018-03-01T00:00:00Z,536,760,41451,224,0.005403971,0.018334901,0.01293093,2018,PSA
2019-02-27T00:00:00Z,587,816,43800,229,0.005228311,0.018630137,0.013401826,2019,PSA
2004-03-30T00:00:00Z,653,921,51473,268,0.005206613,0.017892876,0.012686263,2004,STZ
2005-03-16T00:00:00Z,796,1084,58840,288,0.00489463,0.018422842,0.013528212,2005,STZ
2006-03-15T00:00:00Z,991,1288,67365,297,0.004408818,0.019119721,0.014710903,2006,STZ
2007-04-02T00:00:00Z,934,1293,65331,359,0.005495094,0.019791523,0.014296429,2007,STZ
2008-04-29T00:00:00Z,669,906,44793,237,0.005291005,0.020226375,0.014935369,2008,STZ
2009-03-31T00:00:00Z,644,898,42510,254,0.005975065,0.021124441,0.015149377,2009,STZ
2010-02-26T00:00:00Z,1446,2854,129619,1408,0.010862605,0.022018377,0.011155772,2010,D
2011-02-28T00:00:00Z,1460,2720,124013,1260,0.010160225,0.021933184,0.011772959,2011,D
2012-02-28T00:00:00Z,1479,2735,125696,1256,0.009992363,0.021758847,0.011766484,2012,D
2013-02-28T00:00:00Z,1561,2747,128986,1186,0.009194796,0.021296885,0.012102089,2013,D
2014-02-28T00:00:00Z,1620,2676,128140,1056,0.008240986,0.020883409,0.012642422,2014,D
2015-02-27T00:00:00Z,1525,2252,116796,727,0.006224528,0.019281482,0.013056954,2015,D
2016-02-26T00:00:00Z,1536,2357,122385,821,0.006708338,0.019258896,0.012550558,2016,D
2017-02-28T00:00:00Z,1499,2341,122542,842,0.006871114,0.019103654,0.012232541,2017,D
2018-02-27T00:00:00Z,1633,2636,130970,1003,0.007658242,0.020126747,0.012468504,2018,D
2019-02-28T00:00:00Z,1836,2916,144697,1080,0.007463873,0.020152457,0.012688584,2019,D
2010-02-26T00:00:00Z,465,685,30566,220,0.00719754,0.022410521,0.015212982,2010,AOS
2011-02-24T00:00:00Z,544,694,32407,150,0.00462863,0.021415126,0.016786497,2011,AOS
2012-02-27T00:00:00Z,524,716,34933,192,0.005496236,0.020496379,0.015000143,2012,AOS
2013-02-27T00:00:00Z,549,701,33456,152,0.004543281,0.020952893,0.016409613,2013,AOS
2014-02-20T00:00:00Z,173,170,9206,-3,-0.000325874,0.018466218,0.018792092,2014,AOS
2015-02-17T00:00:00Z,156,158,8901,2,0.000224694,0.017750815,0.017526121,2015,AOS
2016-02-17T00:00:00Z,138,137,8129,-1,-0.000123016,0.016853241,0.016976258,2016,AOS
2017-02-17T00:00:00Z,139,147,8556,8,0.000935016,0.017180926,0.016245909,2017,AOS
2018-02-16T00:00:00Z,136,158,8846,22,0.002487,0.01786118,0.01537418,2018,AOS
2019-02-15T00:00:00Z,458,699,31176,241,0.007730305,0.022421093,0.014690788,2019,AOS
2004-03-30T00:00:00Z,653,921,51473,268,0.005206613,0.017892876,0.012686263,2004,COO
2005-03-16T00:00:00Z,796,1084,58840,288,0.00489463,0.018422842,0.013528212,2005,COO
2006-03-15T00:00:00Z,991,1288,67365,297,0.004408818,0.019119721,0.014710903,2006,COO
2007-04-02T00:00:00Z,934,1293,65331,359,0.005495094,0.019791523,0.014296429,2007,COO
2008-04-29T00:00:00Z,669,906,44793,237,0.005291005,0.020226375,0.014935369,2008,COO
2009-03-31T00:00:00Z,644,898,42510,254,0.005975065,0.021124441,0.015149377,2009,COO
2004-03-30T00:00:00Z,653,921,51473,268,0.005206613,0.017892876,0.012686263,2004,VZ
2005-03-16T00:00:00Z,796,1084,58840,288,0.00489463,0.018422842,0.013528212,2005,VZ
2006-03-15T00:00:00Z,991,1288,67365,297,0.004408818,0.019119721,0.014710903,2006,VZ
2007-04-02T00:00:00Z,934,1293,65331,359,0.005495094,0.019791523,0.014296429,2007,VZ
2008-04-29T00:00:00Z,669,906,44793,237,0.005291005,0.020226375,0.014935369,2008,VZ
2009-03-31T00:00:00Z,644,898,42510,254,0.005975065,0.021124441,0.015149377,2009,VZ
2010-02-25T00:00:00Z,78,199,11821,121,0.010236021,0.016834447,0.006598427,2010,SBC
2011-03-01T00:00:00Z,76,187,10903,111,0.010180684,0.017151243,0.006970559,2011,SBC
2012-02-24T00:00:00Z,72,200,11436,128,0.011192725,0.017488632,0.006295908,2012,SBC
2013-02-22T00:00:00Z,87,207,12636,120,0.009496676,0.016381766,0.00688509,2013,SBC
2014-02-21T00:00:00Z,87,201,12443,114,0.009161778,0.016153661,0.006991883,2014,SBC
2015-02-20T00:00:00Z,80,200,12444,120,0.009643202,0.016072003,0.006428801,2015,SBC
2016-02-18T00:00:00Z,85,242,13899,157,0.011295777,0.017411325,0.006115548,2016,SBC
2017-02-17T00:00:00Z,88,243,13878,155,0.011168756,0.017509728,0.006340971,2017,SBC
2018-02-20T00:00:00Z,88,246,13635,158,0.011587825,0.018041804,0.006453979,2018,SBC
2019-02-20T00:00:00Z,106,257,15559,151,0.009704994,0.016517771,0.006812777,2019,SBC
2011-02-28T00:00:00Z,138,224,12909,86,0.006662019,0.017352235,0.010690216,2011,USB
2012-02-23T00:00:00Z,200,245,13813,45,0.003257801,0.017736915,0.014479114,2012,USB
2013-02-22T00:00:00Z,222,248,14431,26,0.001801677,0.017185226,0.015383549,2013,USB
2014-02-21T00:00:00Z,252,287,16287,35,0.002148953,0.017621416,0.015472463,2014,USB
2015-02-27T00:00:00Z,251,289,16334,38,0.002326436,0.017693155,0.01536672,2015,USB
2016-02-25T00:00:00Z,293,333,18123,40,0.00220714,0.018374441,0.016167301,2016,USB
2017-02-23T00:00:00Z,297,330,17342,33,0.001902895,0.019028947,0.017126052,2017,USB
2018-02-22T00:00:00Z,293,329,17313,36,0.002079362,0.019003061,0.016923699,2018,USB
2019-02-22T00:00:00Z,347,362,18556,15,0.000808364,0.019508515,0.018700151,2019,USB
2010-03-25T00:00:00Z,378,566,30973,188,0.006069803,0.018273981,0.012204178,2010,HD
2011-03-24T00:00:00Z,365,609,31632,244,0.007713708,0.019252656,0.011538948,2011,HD
2012-03-22T00:00:00Z,330,641,31347,311,0.009921205,0.020448528,0.010527323,2012,HD
2013-03-28T00:00:00Z,323,661,30745,338,0.010993658,0.021499431,0.010505773,2013,HD
2014-03-27T00:00:00Z,342,651,31838,309,0.009705384,0.020447264,0.010741881,2014,HD
2015-03-26T00:00:00Z,515,713,36509,198,0.00542332,0.019529431,0.014106111,2015,HD
2016-03-24T00:00:00Z,550,770,39133,220,0.005621854,0.019676488,0.014054634,2016,HD
2017-03-23T00:00:00Z,486,757,37177,271,0.007289453,0.020362052,0.013072599,2017,HD
2018-03-22T00:00:00Z,460,816,34816,356,0.010225184,0.0234375,0.013212316,2018,HD
2019-03-28T00:00:00Z,515,887,37219,372,0.009994895,0.023831914,0.013837019,2019,HD
2001-04-02T00:00:00Z,320,690,36311,370,0.01018975,0.019002506,0.008812756,2001,MNS
2002-04-01T00:00:00Z,348,770,37566,422,0.011233562,0.020497258,0.009263696,2002,MNS
2003-03-31T00:00:00Z,451,913,42354,462,0.010908061,0.021556406,0.010648345,2003,MNS
2006-04-17T00:00:00Z,1007,1421,66366,414,0.006238134,0.021411566,0.015173432,2006,MNS
2006-06-12T00:00:00Z,817,1207,56494,390,0.006903388,0.021365101,0.014461713,2006,MNS
2007-03-01T00:00:00Z,614,1002,44491,388,0.008720865,0.022521409,0.013800544,2007,MNS
2008-03-10T00:00:00Z,628,1041,46144,413,0.008950243,0.022559813,0.01360957,2008,MNS
2009-03-16T00:00:00Z,644,1043,45358,399,0.008796684,0.022994841,0.014198157,2009,MNS
2001-04-02T00:00:00Z,320,690,36311,370,0.01018975,0.019002506,0.008812756,2001,MSCS
2002-04-01T00:00:00Z,348,770,37566,422,0.011233562,0.020497258,0.009263696,2002,MSCS
2003-03-31T00:00:00Z,451,913,42354,462,0.010908061,0.021556406,0.010648345,2003,MSCS
2006-04-17T00:00:00Z,1007,1421,66366,414,0.006238134,0.021411566,0.015173432,2006,MSCS
2006-06-12T00:00:00Z,817,1207,56494,390,0.006903388,0.021365101,0.014461713,2006,MSCS
2007-03-01T00:00:00Z,614,1002,44491,388,0.008720865,0.022521409,0.013800544,2007,MSCS
2008-03-10T00:00:00Z,628,1041,46144,413,0.008950243,0.022559813,0.01360957,2008,MSCS
2009-03-16T00:00:00Z,644,1043,45358,399,0.008796684,0.022994841,0.014198157,2009,MSCS
2009-08-14T00:00:00Z,1091,1202,51638,111,0.00214958,0.023277431,0.021127852,2009,WDC
2010-08-13T00:00:00Z,1077,1153,50055,76,0.00151833,0.023034662,0.021516332,2010,WDC
2011-08-12T00:00:00Z,1053,1034,47144,-19,-0.000403021,0.021932802,0.022335822,2011,WDC
2012-08-20T00:00:00Z,1165,1317,56990,152,0.002667135,0.023109317,0.020442183,2012,WDC
2013-08-19T00:00:00Z,1084,1286,56636,202,0.003566636,0.022706406,0.01913977,2013,WDC
2014-08-15T00:00:00Z,1095,1298,57365,203,0.003538743,0.022627037,0.019088294,2014,WDC
2015-08-21T00:00:00Z,1100,1208,52939,108,0.002040084,0.022818716,0.020778632,2015,WDC
2016-08-29T00:00:00Z,1441,1611,72976,170,0.002329533,0.022075751,0.019746218,2016,WDC
2017-08-29T00:00:00Z,1508,1624,71488,116,0.00162265,0.022717099,0.021094449,2017,WDC
2018-08-24T00:00:00Z,1324,1453,67646,129,0.001906986,0.021479467,0.01957248,2018,WDC
2014-09-04T00:00:00Z,568,1037,45195,469,0.010377254,0.022945016,0.012567762,2014,ODETB
2015-06-18T00:00:00Z,536,883,38318,347,0.009055796,0.023044,0.013988204,2015,ODETB
2016-06-20T00:00:00Z,481,808,35254,327,0.009275543,0.022919385,0.013643842,2016,ODETB
2017-06-13T00:00:00Z,528,850,36496,322,0.008822885,0.023290224,0.014467339,2017,ODETB
2018-06-07T00:00:00Z,654,969,39063,315,0.008063897,0.024806082,0.016742186,2018,ODETB
2013-02-21T00:00:00Z,4847,4353,179158,-494,-0.002757343,0.024296989,0.027054332,2013,AIG
2014-02-20T00:00:00Z,5223,4422,183278,-801,-0.00437041,0.024127282,0.028497692,2014,AIG
2015-02-20T00:00:00Z,5156,4136,173083,-1020,-0.005893126,0.02389605,0.029789176,2015,AIG
2016-02-19T00:00:00Z,5278,3926,171760,-1352,-0.007871449,0.022857476,0.030728924,2016,AIG
2017-02-23T00:00:00Z,5272,3751,168493,-1521,-0.009027081,0.022262052,0.031289134,2017,AIG
2018-02-16T00:00:00Z,5453,3889,174489,-1564,-0.008963316,0.022287938,0.031251254,2018,AIG
2019-02-15T00:00:00Z,5708,4111,181088,-1597,-0.008818917,0.02270167,0.031520587,2019,AIG
2014-09-04T00:00:00Z,568,1037,45195,469,0.010377254,0.022945016,0.012567762,2014,ODETA
2015-06-18T00:00:00Z,536,883,38318,347,0.009055796,0.023044,0.013988204,2015,ODETA
2016-06-20T00:00:00Z,481,808,35254,327,0.009275543,0.022919385,0.013643842,2016,ODETA
2017-06-13T00:00:00Z,528,850,36496,322,0.008822885,0.023290224,0.014467339,2017,ODETA
2018-06-07T00:00:00Z,654,969,39063,315,0.008063897,0.024806082,0.016742186,2018,ODETA
2011-02-15T00:00:00Z,1064,1195,68845,131,0.001902825,0.017357833,0.015455008,2011,HCP
2012-02-14T00:00:00Z,1034,1269,72006,235,0.003263617,0.017623531,0.014359914,2012,HCP
2013-02-12T00:00:00Z,1048,1295,77688,247,0.003179384,0.016669241,0.013489857,2013,HCP
2014-02-11T00:00:00Z,1061,1271,74248,210,0.002828359,0.017118306,0.014289947,2014,HCP
2015-02-10T00:00:00Z,1091,1451,78200,360,0.004603581,0.018554987,0.013951407,2015,HCP
2016-02-09T00:00:00Z,1256,1569,86920,313,0.003601012,0.018051081,0.014450069,2016,HCP
2017-02-13T00:00:00Z,1338,1467,85939,129,0.001501065,0.017070248,0.015569183,2017,HCP
2018-02-13T00:00:00Z,1415,1498,84275,83,0.000984871,0.017775141,0.01679027,2018,HCP
2019-02-14T00:00:00Z,1474,1484,82659,10,0.000120979,0.017953278,0.017832299,2019,HCP
2010-02-23T00:00:00Z,2699,3118,124125,419,0.003375629,0.025119839,0.021744209,2010,STI
2011-02-25T00:00:00Z,2801,3311,136849,510,0.003726735,0.02419455,0.020467815,2011,STI
2012-02-24T00:00:00Z,3085,3260,139874,175,0.001251126,0.02330669,0.022055564,2012,STI
2013-02-27T00:00:00Z,2908,3218,138348,310,0.002240726,0.023260184,0.021019458,2013,STI
2014-02-24T00:00:00Z,2887,3127,136573,240,0.001757302,0.02289618,0.021138878,2014,STI
2015-02-24T00:00:00Z,2577,2748,122086,171,0.001400652,0.022508723,0.021108071,2015,STI
2016-02-23T00:00:00Z,2392,2493,113153,101,0.000892597,0.022032116,0.021139519,2016,STI
2017-02-24T00:00:00Z,2421,2539,115107,118,0.001025133,0.022057738,0.021032604,2017,STI
2018-02-23T00:00:00Z,2289,2551,113608,262,0.002306176,0.022454405,0.020148229,2018,STI
2019-02-22T00:00:00Z,2360,2665,124894,305,0.002442071,0.021338095,0.018896024,2019,STI
2010-02-26T00:00:00Z,2437,2910,125886,473,0.003757368,0.023116153,0.019358785,2010,MWD
2011-02-28T00:00:00Z,2818,3264,139948,446,0.003186898,0.023322949,0.020136051,2011,MWD
2012-02-27T00:00:00Z,3129,3263,143856,134,0.000931487,0.022682405,0.021750918,2012,MWD
2013-02-26T00:00:00Z,3376,3370,152666,-6,-3.93E-05,0.022074332,0.022113634,2013,MWD
2014-02-25T00:00:00Z,3499,3416,156934,-83,-0.000528885,0.021767112,0.022295997,2014,MWD
2015-03-02T00:00:00Z,3697,3621,165436,-76,-0.000459392,0.021887618,0.02234701,2015,MWD
2016-02-23T00:00:00Z,3167,3033,137632,-134,-0.000973611,0.022037026,0.023010637,2016,MWD
2017-02-27T00:00:00Z,3101,2857,130300,-244,-0.001872602,0.021926324,0.023798926,2017,MWD
2018-02-27T00:00:00Z,3013,2722,124788,-291,-0.002331955,0.021812995,0.02414495,2018,MWD
2019-02-26T00:00:00Z,2884,2601,119770,-283,-0.002362862,0.021716624,0.024079486,2019,MWD
2010-02-26T00:00:00Z,2437,2910,125886,473,0.003757368,0.023116153,0.019358785,2010,MS
2011-02-28T00:00:00Z,2818,3264,139948,446,0.003186898,0.023322949,0.020136051,2011,MS
2012-02-27T00:00:00Z,3129,3263,143856,134,0.000931487,0.022682405,0.021750918,2012,MS
2013-02-26T00:00:00Z,3376,3370,152666,-6,-3.93E-05,0.022074332,0.022113634,2013,MS
2014-02-25T00:00:00Z,3499,3416,156934,-83,-0.000528885,0.021767112,0.022295997,2014,MS
2015-03-02T00:00:00Z,3697,3621,165436,-76,-0.000459392,0.021887618,0.02234701,2015,MS
2016-02-23T00:00:00Z,3167,3033,137632,-134,-0.000973611,0.022037026,0.023010637,2016,MS
2017-02-27T00:00:00Z,3101,2857,130300,-244,-0.001872602,0.021926324,0.023798926,2017,MS
2018-02-27T00:00:00Z,3013,2722,124788,-291,-0.002331955,0.021812995,0.02414495,2018,MS
2019-02-26T00:00:00Z,2884,2601,119770,-283,-0.002362862,0.021716624,0.024079486,2019,MS
2013-03-08T00:00:00Z,833,996,50730,163,0.003213089,0.019633353,0.016420264,2013,NOW
2014-02-28T00:00:00Z,857,946,50093,89,0.001776695,0.018884874,0.017108179,2014,NOW
2015-02-27T00:00:00Z,893,959,48361,66,0.001364736,0.019830028,0.018465292,2015,NOW
2016-02-25T00:00:00Z,1002,1069,53528,67,0.001251681,0.019970856,0.018719175,2016,NOW
2017-02-28T00:00:00Z,830,981,51025,151,0.002959334,0.01922587,0.016266536,2017,NOW
2018-02-28T00:00:00Z,857,973,52464,116,0.00221104,0.018546051,0.016335011,2018,NOW
2019-02-27T00:00:00Z,992,1066,57707,74,0.00128234,0.018472629,0.017190289,2019,NOW
2016-02-16T00:00:00Z,1762,2346,108380,584,0.005388448,0.02164606,0.016257612,2016,MYL
2017-03-01T00:00:00Z,1794,2566,115912,772,0.006660225,0.022137484,0.015477259,2017,MYL
2018-03-01T00:00:00Z,1721,2441,107696,720,0.006685485,0.022665651,0.015980166,2018,MYL
2019-02-27T00:00:00Z,1521,2013,89412,492,0.005502617,0.022513757,0.017011139,2019,MYL
2010-11-24T00:00:00Z,1531,1759,83343,228,0.002735683,0.021105552,0.018369869,2010,RJF
2011-11-23T00:00:00Z,1634,1914,87940,280,0.003183989,0.02176484,0.018580851,2011,RJF
2012-11-21T00:00:00Z,1938,2188,106320,250,0.002351392,0.020579383,0.018227991,2012,RJF
2013-11-26T00:00:00Z,1966,2241,111067,275,0.002475983,0.02017701,0.017701027,2013,RJF
2014-11-25T00:00:00Z,2083,2362,114361,279,0.002439643,0.020653894,0.018214251,2014,RJF
2015-11-25T00:00:00Z,2111,2419,114885,308,0.002680942,0.021055838,0.018374897,2015,RJF
2016-11-22T00:00:00Z,2219,2690,121439,471,0.00387849,0.022151039,0.018272548,2016,RJF
2017-11-22T00:00:00Z,1972,2407,105573,435,0.004120372,0.02279939,0.018679018,2017,RJF
2018-11-21T00:00:00Z,1823,2142,95244,319,0.003349292,0.022489606,0.019140313,2018,RJF
2011-02-24T00:00:00Z,1065,1467,64403,402,0.006241945,0.022778442,0.016536497,2011,HDI
2012-02-23T00:00:00Z,1032,1421,61488,389,0.006326438,0.0231102,0.016783763,2012,HDI
2013-02-22T00:00:00Z,921,1292,56551,371,0.00656045,0.022846634,0.016286184,2013,HDI
2014-02-20T00:00:00Z,874,1277,55135,403,0.007309332,0.023161331,0.015852,2014,HDI
2015-02-19T00:00:00Z,870,1210,54578,340,0.006229616,0.022170105,0.015940489,2015,HDI
2016-02-18T00:00:00Z,931,1176,56129,245,0.004364945,0.020951736,0.016586791,2016,HDI
2017-02-21T00:00:00Z,1018,1229,59564,211,0.003542408,0.020633268,0.01709086,2017,HDI
2018-02-21T00:00:00Z,949,1229,58595,280,0.004778565,0.020974486,0.016195921,2018,HDI
2019-02-28T00:00:00Z,974,1253,59304,279,0.004704573,0.021128423,0.01642385,2019,HDI
2011-02-24T00:00:00Z,1065,1467,64403,402,0.006241945,0.022778442,0.016536497,2011,HOG
2012-02-23T00:00:00Z,1032,1421,61488,389,0.006326438,0.0231102,0.016783763,2012,HOG
2013-02-22T00:00:00Z,921,1292,56551,371,0.00656045,0.022846634,0.016286184,2013,HOG
2014-02-20T00:00:00Z,874,1277,55135,403,0.007309332,0.023161331,0.015852,2014,HOG
2015-02-19T00:00:00Z,870,1210,54578,340,0.006229616,0.022170105,0.015940489,2015,HOG
2016-02-18T00:00:00Z,931,1176,56129,245,0.004364945,0.020951736,0.016586791,2016,HOG
2017-02-21T00:00:00Z,1018,1229,59564,211,0.003542408,0.020633268,0.01709086,2017,HOG
2018-02-21T00:00:00Z,949,1229,58595,280,0.004778565,0.020974486,0.016195921,2018,HOG
2019-02-28T00:00:00Z,974,1253,59304,279,0.004704573,0.021128423,0.01642385,2019,HOG
2010-02-23T00:00:00Z,1072,1333,66317,261,0.003935642,0.020100427,0.016164784,2010,APC
2011-02-23T00:00:00Z,1692,1700,87272,8,9.17E-05,0.019479329,0.019387662,2011,APC
2012-02-21T00:00:00Z,1455,1632,80967,177,0.002186076,0.02015636,0.017970284,2012,APC
2013-02-19T00:00:00Z,1460,1590,77901,130,0.001668785,0.020410521,0.018741736,2013,APC
2014-02-28T00:00:00Z,1495,1607,80715,112,0.001387598,0.019909558,0.01852196,2014,APC
2015-02-20T00:00:00Z,1295,1449,75193,154,0.002048063,0.019270411,0.017222348,2015,APC
2016-02-17T00:00:00Z,1285,1479,75005,194,0.002586494,0.019718685,0.017132191,2016,APC
2017-02-17T00:00:00Z,1235,1482,74576,247,0.003312057,0.019872345,0.016560287,2017,APC
2018-02-15T00:00:00Z,1238,1557,76865,319,0.004150133,0.020256294,0.01610616,2018,APC
2019-02-14T00:00:00Z,1297,1490,75517,193,0.002555716,0.019730657,0.017174941,2019,APC
2010-02-26T00:00:00Z,3480,3783,163843,303,0.001849331,0.023089177,0.021239845,2010,C
2011-02-25T00:00:00Z,3676,3810,172241,134,0.00077798,0.022120169,0.021342189,2011,C
2012-02-24T00:00:00Z,3899,3856,179573,-43,-0.000239457,0.021473161,0.021712618,2012,C
2013-03-01T00:00:00Z,4125,4019,187728,-106,-0.000564647,0.021408634,0.02197328,2013,C
2014-03-03T00:00:00Z,3984,4058,182797,74,0.000404821,0.022199489,0.021794668,2014,C
2015-02-25T00:00:00Z,3700,3720,167840,20,0.000119161,0.022163966,0.022044805,2015,C
2016-02-26T00:00:00Z,3495,3657,164457,162,0.00098506,0.022236816,0.021251756,2016,C
2017-02-24T00:00:00Z,3374,3554,160279,180,0.001123042,0.022173834,0.021050793,2017,C
2018-02-23T00:00:00Z,3359,3687,156386,328,0.002097374,0.023576279,0.021478905,2018,C
2019-02-22T00:00:00Z,3360,3520,150902,160,0.001060291,0.023326397,0.022266106,2019,C
2011-02-25T00:00:00Z,210,289,17376,79,0.004546501,0.016632136,0.012085635,2011,ECL
2012-02-28T00:00:00Z,387,529,25935,142,0.005475227,0.020397147,0.01492192,2012,ECL
2013-02-26T00:00:00Z,390,515,26212,125,0.004768808,0.01964749,0.014878682,2013,ECL
2014-02-28T00:00:00Z,365,478,24232,113,0.004663255,0.019725982,0.015062727,2014,ECL
2015-02-27T00:00:00Z,351,460,24163,109,0.004511029,0.019037371,0.014526342,2015,ECL
2016-02-26T00:00:00Z,950,1645,67004,695,0.010372515,0.024550773,0.014178258,2016,ECL
2017-02-24T00:00:00Z,924,1564,65380,640,0.009788926,0.023921689,0.014132762,2017,ECL
2018-02-23T00:00:00Z,909,1497,62798,588,0.009363356,0.023838339,0.014474983,2018,ECL
2019-03-01T00:00:00Z,910,1561,63801,651,0.010203602,0.024466701,0.014263099,2019,ECL
2010-02-26T00:00:00Z,2176,2543,99350,367,0.003694011,0.025596376,0.021902365,2010,UNM
2011-02-25T00:00:00Z,2199,2600,101349,401,0.003956625,0.025653929,0.021697303,2011,UNM
2012-02-24T00:00:00Z,2312,2749,104941,437,0.004164245,0.026195672,0.022031427,2012,UNM
2013-02-22T00:00:00Z,2265,2695,102597,430,0.004191156,0.026267825,0.022076669,2013,UNM
2014-02-26T00:00:00Z,2259,2683,100420,424,0.004222266,0.026717785,0.022495519,2014,UNM
2015-02-25T00:00:00Z,2212,2587,96731,375,0.00387673,0.02674427,0.02286754,2015,UNM
2016-02-24T00:00:00Z,2192,2606,96691,414,0.004281681,0.026951836,0.022670155,2016,UNM
2017-02-22T00:00:00Z,2226,2604,97123,378,0.003891972,0.026811363,0.022919391,2017,UNM
2018-02-21T00:00:00Z,2190,2640,98666,450,0.004560842,0.026756938,0.022196096,2018,UNM
2019-02-19T00:00:00Z,2296,2699,103035,403,0.003911292,0.026194982,0.02228369,2019,UNM
2010-02-26T00:00:00Z,1534,2029,89627,495,0.005522889,0.022638267,0.017115378,2010,BBT
2011-02-25T00:00:00Z,1737,2016,94049,279,0.002966539,0.021435635,0.018469096,2011,BBT
2012-02-27T00:00:00Z,1613,1943,86915,330,0.003796813,0.022355175,0.018558362,2012,BBT
2013-03-01T00:00:00Z,375,478,27079,103,0.003803686,0.017652055,0.01384837,2013,BBT
2014-02-26T00:00:00Z,430,434,28446,4,0.000140617,0.015256978,0.015116361,2014,BBT
2015-02-25T00:00:00Z,433,423,27532,-10,-0.000363214,0.01536394,0.015727154,2015,BBT
2016-02-25T00:00:00Z,431,428,27128,-3,-0.000110587,0.015777057,0.015887644,2016,BBT
2017-02-21T00:00:00Z,1548,1626,78195,78,0.000997506,0.020794168,0.019796662,2017,BBT
2018-02-21T00:00:00Z,1455,1516,71558,61,0.000852455,0.021185612,0.020333156,2018,BBT
2019-02-26T00:00:00Z,1494,1536,72216,42,0.000581589,0.021269525,0.020687936,2019,BBT
2012-02-27T00:00:00Z,2063,2236,102386,173,0.001689684,0.021838923,0.020149239,2012,STT
2013-02-22T00:00:00Z,2077,2340,105944,263,0.002482444,0.02208714,0.019604697,2013,STT
2014-02-21T00:00:00Z,2883,2863,127919,-20,-0.000156349,0.022381351,0.0225377,2014,STT
2015-02-20T00:00:00Z,2890,2636,123680,-254,-0.002053687,0.021313066,0.023366753,2015,STT
2016-02-19T00:00:00Z,2995,2558,123259,-437,-0.00354538,0.020753048,0.024298429,2016,STT
2017-02-17T00:00:00Z,3052,2666,125234,-386,-0.00308223,0.021288149,0.024370379,2017,STT
2018-02-26T00:00:00Z,3053,2679,122195,-374,-0.003060682,0.021923974,0.024984656,2018,STT
2019-02-21T00:00:00Z,3125,2670,124964,-455,-0.003641049,0.021366153,0.025007202,2019,STT
2011-02-18T00:00:00Z,544,922,38105,378,0.009919958,0.0241963,0.014276342,2011,SYK
2012-02-13T00:00:00Z,413,720,29192,307,0.01051658,0.024664292,0.014147712,2012,SYK
2013-02-27T00:00:00Z,453,726,29954,273,0.009113975,0.024237164,0.015123189,2013,SYK
2014-02-13T00:00:00Z,457,768,31971,311,0.009727566,0.02402177,0.014294204,2014,SYK
2015-02-12T00:00:00Z,442,731,30248,289,0.009554351,0.024166887,0.014612536,2015,SYK
2016-02-11T00:00:00Z,437,677,29349,240,0.008177451,0.023067225,0.014889775,2016,SYK
2017-02-09T00:00:00Z,398,632,28476,234,0.008217446,0.022194128,0.013976682,2017,SYK
2018-02-08T00:00:00Z,389,660,28506,271,0.009506771,0.02315302,0.01364625,2018,SYK
2019-02-07T00:00:00Z,402,692,31296,290,0.00926636,0.022111452,0.012845092,2019,SYK
2012-02-24T00:00:00Z,690,1028,46478,338,0.007272258,0.022117991,0.014845733,2012,BHI
2013-02-13T00:00:00Z,684,944,45241,260,0.005746999,0.020866029,0.015119029,2013,BHI
2014-02-12T00:00:00Z,750,977,48122,227,0.004717177,0.020302564,0.015585387,2014,BHI
2015-02-26T00:00:00Z,773,1053,50593,280,0.005534362,0.020813156,0.015278794,2015,BHI
2016-02-17T00:00:00Z,900,1085,50937,185,0.003631937,0.021300823,0.017668885,2016,BHI
2017-02-08T00:00:00Z,1006,1250,57103,244,0.00427298,0.021890268,0.017617288,2017,BHI
2018-02-23T00:00:00Z,932,1282,57598,350,0.0060766,0.022257717,0.016181117,2018,BHI
2019-02-19T00:00:00Z,949,1284,58198,335,0.005756212,0.022062614,0.016306402,2019,BHI
2012-02-24T00:00:00Z,690,1028,46478,338,0.007272258,0.022117991,0.014845733,2012,BHGE
2013-02-13T00:00:00Z,684,944,45241,260,0.005746999,0.020866029,0.015119029,2013,BHGE
2014-02-12T00:00:00Z,750,977,48122,227,0.004717177,0.020302564,0.015585387,2014,BHGE
2015-02-26T00:00:00Z,773,1053,50593,280,0.005534362,0.020813156,0.015278794,2015,BHGE
2016-02-17T00:00:00Z,900,1085,50937,185,0.003631937,0.021300823,0.017668885,2016,BHGE
2017-02-08T00:00:00Z,1006,1250,57103,244,0.00427298,0.021890268,0.017617288,2017,BHGE
2018-02-23T00:00:00Z,932,1282,57598,350,0.0060766,0.022257717,0.016181117,2018,BHGE
2019-02-19T00:00:00Z,949,1284,58198,335,0.005756212,0.022062614,0.016306402,2019,BHGE
2011-03-28T00:00:00Z,548,1002,42475,454,0.01068864,0.023590347,0.012901707,2011,TIF
2012-03-28T00:00:00Z,574,990,42936,416,0.009688839,0.023057574,0.013368735,2012,TIF
2013-03-28T00:00:00Z,563,1001,42448,438,0.010318507,0.023581794,0.013263287,2013,TIF
2014-04-01T00:00:00Z,610,1064,44497,454,0.010202935,0.023911724,0.013708789,2014,TIF
2015-03-20T00:00:00Z,677,1176,47917,499,0.010413841,0.024542438,0.014128597,2015,TIF
2016-03-28T00:00:00Z,734,1250,53309,516,0.009679416,0.023448198,0.013768782,2016,TIF
2017-03-17T00:00:00Z,792,1410,56664,618,0.010906396,0.024883524,0.013977128,2017,TIF
2018-03-16T00:00:00Z,764,1425,57265,661,0.011542827,0.02488431,0.013341483,2018,TIF
2019-03-22T00:00:00Z,694,1337,54396,643,0.011820722,0.024579013,0.012758291,2019,TIF
2010-02-25T00:00:00Z,1011,1436,71513,425,0.005942975,0.020080265,0.01413729,2010,VIA
2011-02-25T00:00:00Z,978,1368,70187,390,0.005556585,0.019490789,0.013934204,2011,VIA
2012-02-23T00:00:00Z,927,1365,70209,438,0.006238516,0.019441952,0.013203435,2012,VIA
2013-02-15T00:00:00Z,872,1250,68978,378,0.005480008,0.01812172,0.012641712,2013,VIA
2014-02-14T00:00:00Z,873,1288,70403,415,0.005894635,0.018294675,0.01240004,2014,VIA
2015-02-13T00:00:00Z,890,1201,64377,311,0.004830918,0.018655731,0.013824813,2015,VIA
2016-02-16T00:00:00Z,847,1261,65382,414,0.006332018,0.019286654,0.012954636,2016,VIA
2017-02-17T00:00:00Z,918,1334,67810,416,0.006134788,0.019672615,0.013537826,2017,VIA
2018-02-20T00:00:00Z,947,1409,69677,462,0.006630595,0.020221881,0.013591286,2018,VIA
2019-02-15T00:00:00Z,1003,1496,77478,493,0.006363097,0.019308707,0.01294561,2019,VIA
2010-02-25T00:00:00Z,1011,1436,71513,425,0.005942975,0.020080265,0.01413729,2010,CBS
2011-02-25T00:00:00Z,978,1368,70187,390,0.005556585,0.019490789,0.013934204,2011,CBS
2012-02-23T00:00:00Z,927,1365,70209,438,0.006238516,0.019441952,0.013203435,2012,CBS
2013-02-15T00:00:00Z,872,1250,68978,378,0.005480008,0.01812172,0.012641712,2013,CBS
2014-02-14T00:00:00Z,873,1288,70403,415,0.005894635,0.018294675,0.01240004,2014,CBS
2015-02-13T00:00:00Z,890,1201,64377,311,0.004830918,0.018655731,0.013824813,2015,CBS
2016-02-16T00:00:00Z,847,1261,65382,414,0.006332018,0.019286654,0.012954636,2016,CBS
2017-02-17T00:00:00Z,918,1334,67810,416,0.006134788,0.019672615,0.013537826,2017,CBS
2018-02-20T00:00:00Z,947,1409,69677,462,0.006630595,0.020221881,0.013591286,2018,CBS
2019-02-15T00:00:00Z,1003,1496,77478,493,0.006363097,0.019308707,0.01294561,2019,CBS
2010-06-08T00:00:00Z,854,1131,43901,277,0.006309651,0.025762511,0.01945286,2010,ABMD
2011-06-02T00:00:00Z,808,1000,37667,192,0.0050973,0.026548438,0.021451138,2011,ABMD
2012-06-04T00:00:00Z,900,1047,41229,147,0.003565452,0.025394746,0.021829295,2012,ABMD
2013-05-28T00:00:00Z,1044,1156,46113,112,0.002428816,0.025068853,0.022640036,2013,ABMD
2014-05-28T00:00:00Z,1068,1243,49861,175,0.003509757,0.024929303,0.021419546,2014,ABMD
2015-05-28T00:00:00Z,1060,1289,51131,229,0.004478692,0.025209755,0.020731063,2015,ABMD
2016-05-26T00:00:00Z,321,537,22270,216,0.009699147,0.024113157,0.01441401,2016,ABMD
2017-05-25T00:00:00Z,942,1259,49363,317,0.006421814,0.025504933,0.019083119,2017,ABMD
2018-05-24T00:00:00Z,1042,1451,53927,409,0.007584327,0.026906744,0.019322417,2018,ABMD
2019-05-23T00:00:00Z,1042,1478,53191,436,0.008196875,0.027786656,0.01958978,2019,ABMD
2010-01-29T00:00:00Z,391,584,32210,193,0.005991928,0.018131015,0.012139087,2010,CCL
2011-01-31T00:00:00Z,409,618,32723,209,0.006386945,0.018885799,0.012498854,2011,CCL
2012-01-30T00:00:00Z,492,687,33945,195,0.005744587,0.020238621,0.014494034,2012,CCL
2013-01-29T00:00:00Z,594,732,36165,138,0.003815844,0.020240564,0.01642472,2013,CCL
2014-01-29T00:00:00Z,550,874,38220,324,0.008477237,0.022867609,0.014390372,2014,CCL
2015-01-29T00:00:00Z,502,1065,40734,563,0.013821378,0.026145235,0.012323857,2015,CCL
2016-01-29T00:00:00Z,501,894,35464,393,0.01108166,0.025208662,0.014127002,2016,CCL
2017-01-30T00:00:00Z,510,860,32550,350,0.010752688,0.026420891,0.015668203,2017,CCL
2018-01-29T00:00:00Z,351,753,27453,402,0.014643208,0.027428696,0.012785488,2018,CCL
2019-01-28T00:00:00Z,237,718,24815,481,0.019383437,0.028934112,0.009550675,2019,CCL
2010-02-25T00:00:00Z,984,1226,52870,242,0.004577265,0.023188954,0.018611689,2010,SCH
2011-02-25T00:00:00Z,1008,1175,54810,167,0.003046889,0.021437694,0.018390805,2011,SCH
2012-02-24T00:00:00Z,972,1205,56452,233,0.0041274,0.021345568,0.017218168,2012,SCH
2013-02-22T00:00:00Z,1019,1209,59552,190,0.003190489,0.020301585,0.017111096,2013,SCH
2014-02-24T00:00:00Z,1086,1215,58534,129,0.002203847,0.020757167,0.018553319,2014,SCH
2015-02-23T00:00:00Z,1085,1179,56973,94,0.001649904,0.020694013,0.019044109,2015,SCH
2016-02-24T00:00:00Z,1142,1273,59910,131,0.002186613,0.021248539,0.019061926,2016,SCH
2017-02-23T00:00:00Z,1064,1234,59203,170,0.002871476,0.020843538,0.017972062,2017,SCH
2018-02-22T00:00:00Z,932,1117,53308,185,0.003470398,0.020953703,0.017483305,2018,SCH
2019-02-22T00:00:00Z,974,1125,54409,151,0.002775276,0.020676726,0.01790145,2019,SCH
2010-02-25T00:00:00Z,984,1226,52870,242,0.004577265,0.023188954,0.018611689,2010,SCHW
2011-02-25T00:00:00Z,1008,1175,54810,167,0.003046889,0.021437694,0.018390805,2011,SCHW
2012-02-24T00:00:00Z,972,1205,56452,233,0.0041274,0.021345568,0.017218168,2012,SCHW
2013-02-22T00:00:00Z,1019,1209,59552,190,0.003190489,0.020301585,0.017111096,2013,SCHW
2014-02-24T00:00:00Z,1086,1215,58534,129,0.002203847,0.020757167,0.018553319,2014,SCHW
2015-02-23T00:00:00Z,1085,1179,56973,94,0.001649904,0.020694013,0.019044109,2015,SCHW
2016-02-24T00:00:00Z,1142,1273,59910,131,0.002186613,0.021248539,0.019061926,2016,SCHW
2017-02-23T00:00:00Z,1064,1234,59203,170,0.002871476,0.020843538,0.017972062,2017,SCHW
2018-02-22T00:00:00Z,932,1117,53308,185,0.003470398,0.020953703,0.017483305,2018,SCHW
2019-02-22T00:00:00Z,974,1125,54409,151,0.002775276,0.020676726,0.01790145,2019,SCHW
2003-03-28T00:00:00Z,299,528,20759,229,0.01103136,0.025434751,0.014403391,2003,GFR
2004-03-12T00:00:00Z,295,496,20895,201,0.009619526,0.023737736,0.01411821,2004,GFR
2005-03-11T00:00:00Z,366,594,23339,228,0.009769056,0.025450962,0.015681906,2005,GFR
2006-03-07T00:00:00Z,392,630,23414,238,0.010164859,0.026906979,0.01674212,2006,GFR
2007-02-28T00:00:00Z,473,676,25586,203,0.007934026,0.026420699,0.018486672,2007,GFR
2011-02-25T00:00:00Z,1269,1545,83779,276,0.003294382,0.018441376,0.015146994,2011,PXD
2012-02-29T00:00:00Z,1278,1499,82726,221,0.00267147,0.018120059,0.015448589,2012,PXD
2013-02-13T00:00:00Z,1318,1516,81726,198,0.00242273,0.018549788,0.016127059,2013,PXD
2014-02-27T00:00:00Z,1476,1660,86492,184,0.002127364,0.019192526,0.017065162,2014,PXD
2015-02-19T00:00:00Z,1344,1500,80282,156,0.00194315,0.018684138,0.016740988,2015,PXD
2016-02-19T00:00:00Z,1378,1482,82034,104,0.001267767,0.01806568,0.016797913,2016,PXD
2017-02-17T00:00:00Z,1349,1423,79619,74,0.000929426,0.017872618,0.016943192,2017,PXD
2018-02-20T00:00:00Z,1337,1344,75036,7,9.33E-05,0.017911403,0.017818114,2018,PXD
2019-02-26T00:00:00Z,1270,1266,71054,-4,-5.63E-05,0.017817435,0.01787373,2019,PXD
2004-03-30T00:00:00Z,653,921,51473,268,0.005206613,0.017892876,0.012686263,2004,FCX
2005-03-16T00:00:00Z,796,1084,58840,288,0.00489463,0.018422842,0.013528212,2005,FCX
2006-03-15T00:00:00Z,991,1288,67365,297,0.004408818,0.019119721,0.014710903,2006,FCX
2007-04-02T00:00:00Z,934,1293,65331,359,0.005495094,0.019791523,0.014296429,2007,FCX
2008-04-29T00:00:00Z,669,906,44793,237,0.005291005,0.020226375,0.014935369,2008,FCX
2009-03-31T00:00:00Z,644,898,42510,254,0.005975065,0.021124441,0.015149377,2009,FCX
2010-03-01T00:00:00Z,682,949,56770,267,0.004703188,0.016716576,0.012013387,2010,DRE
2011-02-25T00:00:00Z,716,1013,61467,297,0.004831861,0.016480388,0.011648527,2011,DRE
2012-02-24T00:00:00Z,629,907,53912,278,0.005156551,0.016823713,0.011667161,2012,DRE
2013-02-22T00:00:00Z,829,1064,60931,235,0.003856822,0.017462375,0.013605554,2013,DRE
2014-02-21T00:00:00Z,829,1010,60474,181,0.002993022,0.016701392,0.013708371,2014,DRE
2015-02-20T00:00:00Z,819,1000,61348,181,0.002950381,0.01630045,0.013350068,2015,DRE
2016-02-19T00:00:00Z,788,1010,60066,222,0.003695934,0.016814837,0.013118903,2016,DRE
2017-02-17T00:00:00Z,796,1072,61216,276,0.004508625,0.017511762,0.013003136,2017,DRE
2018-02-16T00:00:00Z,820,1083,62186,263,0.004229248,0.017415495,0.013186248,2018,DRE
2019-02-22T00:00:00Z,845,1058,60906,213,0.003497192,0.017371031,0.013873838,2019,DRE
2010-01-22T00:00:00Z,1020,2116,76495,1096,0.014327734,0.027661939,0.013334205,2010,ADBE
2011-01-27T00:00:00Z,1046,2344,82590,1298,0.015716188,0.02838116,0.012664972,2011,ADBE
2012-01-26T00:00:00Z,978,2023,76881,1045,0.013592435,0.026313393,0.012720958,2012,ADBE
2013-01-22T00:00:00Z,1072,2058,76813,986,0.012836369,0.02679234,0.013955971,2013,ADBE
2014-01-21T00:00:00Z,1102,1541,61418,439,0.007147742,0.025090364,0.017942623,2014,ADBE
2015-01-20T00:00:00Z,1157,1627,63873,470,0.007358352,0.025472422,0.01811407,2015,ADBE
2016-01-19T00:00:00Z,1183,1631,62538,448,0.007163645,0.026080143,0.018916499,2016,ADBE
2017-01-20T00:00:00Z,1146,1570,60769,424,0.006977242,0.025835541,0.018858299,2017,ADBE
2018-01-22T00:00:00Z,1131,1479,58552,348,0.005943435,0.025259598,0.019316163,2018,ADBE
2019-01-25T00:00:00Z,1229,1564,61233,335,0.005470906,0.025541783,0.020070877,2019,ADBE
2014-05-16T00:00:00Z,229,305,14088,76,0.005394662,0.021649631,0.016254969,2014,SYMC
2015-05-22T00:00:00Z,872,1101,45536,229,0.005028988,0.024178672,0.019149684,2015,SYMC
2016-05-20T00:00:00Z,879,1030,45006,151,0.003355108,0.022885837,0.019530729,2016,SYMC
2017-05-19T00:00:00Z,1003,1154,47922,151,0.003150954,0.024080798,0.020929844,2017,SYMC
2018-10-26T00:00:00Z,1249,2159,89140,910,0.010208661,0.024220328,0.014011667,2018,SYMC
2019-05-24T00:00:00Z,1051,1267,49133,216,0.004396231,0.025787149,0.021390919,2019,SYMC
2006-03-06T00:00:00Z,1174,1471,72693,297,0.004085675,0.020235786,0.016150111,2006,AGN
2007-03-01T00:00:00Z,1258,1845,88027,587,0.006668409,0.020959478,0.01429107,2007,AGN
2008-02-28T00:00:00Z,1355,1898,92188,543,0.005890138,0.020588363,0.014698225,2008,AGN
2009-02-27T00:00:00Z,1522,1948,91739,426,0.004643608,0.021234153,0.016590545,2009,AGN
2010-02-26T00:00:00Z,1507,1930,89322,423,0.004735675,0.021607219,0.016871543,2010,AGN
2011-03-01T00:00:00Z,1708,1972,95428,264,0.002766484,0.020664794,0.017898311,2011,AGN
2012-02-28T00:00:00Z,1516,1733,86905,217,0.002496979,0.019941315,0.017444336,2012,AGN
2013-02-26T00:00:00Z,1371,1610,81081,239,0.00294767,0.019856687,0.016909017,2013,AGN
2014-02-25T00:00:00Z,1403,1706,82673,303,0.003665042,0.020635516,0.016970474,2014,AGN
2015-02-19T00:00:00Z,1812,2752,115667,940,0.008126778,0.023792439,0.015665661,2015,AGN
2012-02-22T00:00:00Z,1622,2172,116712,550,0.004712455,0.018609912,0.013897457,2012,VTR
2013-02-19T00:00:00Z,1587,2095,117250,508,0.004332623,0.017867804,0.013535181,2013,VTR
2014-02-18T00:00:00Z,1509,1933,94716,424,0.00447654,0.020408379,0.015931838,2014,VTR
2015-02-13T00:00:00Z,1567,1944,97479,377,0.0038675,0.019942757,0.016075257,2015,VTR
2016-02-12T00:00:00Z,1569,2046,98772,477,0.004829304,0.020714372,0.015885069,2016,VTR
2017-02-14T00:00:00Z,1588,2070,101036,482,0.004770577,0.020487747,0.01571717,2017,VTR
2018-02-09T00:00:00Z,1451,1857,89781,406,0.004522115,0.020683664,0.016161549,2018,VTR
2019-02-08T00:00:00Z,1446,1836,95765,390,0.004072469,0.019171931,0.015099462,2019,VTR
2010-02-25T00:00:00Z,725,912,49819,187,0.003753588,0.018306269,0.014552681,2010,EOG
2011-02-24T00:00:00Z,939,1015,58999,76,0.001288157,0.017203681,0.015915524,2011,EOG
2012-02-24T00:00:00Z,967,959,56982,-8,-0.000140395,0.016829876,0.016970271,2012,EOG
2013-02-22T00:00:00Z,1000,998,57088,-2,-3.50E-05,0.017481783,0.017516816,2013,EOG
2014-02-24T00:00:00Z,264,235,16993,-29,-0.001706585,0.013829224,0.015535809,2014,EOG
2015-02-18T00:00:00Z,1018,913,53081,-105,-0.001978109,0.017200128,0.019178237,2015,EOG
2016-02-25T00:00:00Z,1055,928,53109,-127,-0.002391308,0.017473498,0.019864806,2016,EOG
2017-02-27T00:00:00Z,1089,987,57321,-102,-0.001779453,0.01721882,0.018998273,2017,EOG
2018-02-27T00:00:00Z,1114,1053,59736,-61,-0.00102116,0.017627561,0.018648721,2018,EOG
2019-02-26T00:00:00Z,1095,981,57923,-114,-0.00196813,0.016936277,0.018904408,2019,EOG
2011-05-24T00:00:00Z,978,1266,59769,288,0.004818551,0.021181549,0.016362998,2011,ERTS
2012-05-25T00:00:00Z,1021,1372,65188,351,0.005384427,0.021046818,0.015662392,2012,ERTS
2013-05-22T00:00:00Z,918,1211,60453,293,0.00484674,0.020032091,0.015185351,2013,ERTS
2014-05-21T00:00:00Z,949,1150,58383,201,0.003442783,0.019697515,0.016254732,2014,ERTS
2015-05-21T00:00:00Z,911,1073,53697,162,0.003016928,0.019982494,0.016965566,2015,ERTS
2016-05-27T00:00:00Z,906,1004,51287,98,0.001910816,0.019576111,0.017665295,2016,ERTS
2017-05-24T00:00:00Z,819,908,47721,89,0.001865007,0.019027263,0.017162256,2017,ERTS
2018-05-23T00:00:00Z,879,1006,50326,127,0.002523546,0.019989667,0.017466121,2018,ERTS
2019-05-24T00:00:00Z,839,1054,49759,215,0.004320826,0.021182098,0.016861271,2019,ERTS
2011-05-24T00:00:00Z,978,1266,59769,288,0.004818551,0.021181549,0.016362998,2011,EA
2012-05-25T00:00:00Z,1021,1372,65188,351,0.005384427,0.021046818,0.015662392,2012,EA
2013-05-22T00:00:00Z,918,1211,60453,293,0.00484674,0.020032091,0.015185351,2013,EA
2014-05-21T00:00:00Z,949,1150,58383,201,0.003442783,0.019697515,0.016254732,2014,EA
2015-05-21T00:00:00Z,911,1073,53697,162,0.003016928,0.019982494,0.016965566,2015,EA
2016-05-27T00:00:00Z,906,1004,51287,98,0.001910816,0.019576111,0.017665295,2016,EA
2017-05-24T00:00:00Z,819,908,47721,89,0.001865007,0.019027263,0.017162256,2017,EA
2018-05-23T00:00:00Z,879,1006,50326,127,0.002523546,0.019989667,0.017466121,2018,EA
2019-05-24T00:00:00Z,839,1054,49759,215,0.004320826,0.021182098,0.016861271,2019,EA
2009-09-11T00:00:00Z,506,514,23836,8,0.000335627,0.021564021,0.021228394,2009,CSCO
2010-09-21T00:00:00Z,549,542,25111,-7,-0.000278762,0.021584166,0.021862929,2010,CSCO
2011-09-14T00:00:00Z,1307,1529,73802,222,0.003008049,0.020717596,0.017709547,2011,CSCO
2012-09-12T00:00:00Z,1300,1562,74088,262,0.003536335,0.021083036,0.017546701,2012,CSCO
2013-09-10T00:00:00Z,1369,1606,75641,237,0.003133221,0.021231872,0.01809865,2013,CSCO
2014-09-09T00:00:00Z,1373,1612,74834,239,0.003193735,0.021541011,0.018347275,2014,CSCO
2015-09-08T00:00:00Z,1359,1571,74649,212,0.002839958,0.021045158,0.0182052,2015,CSCO
2016-09-08T00:00:00Z,1391,1601,76014,210,0.002762649,0.02106191,0.018299261,2016,CSCO
2017-09-07T00:00:00Z,1410,1590,74440,180,0.002418055,0.021359484,0.018941429,2017,CSCO
2018-09-06T00:00:00Z,1374,1525,70133,151,0.002153052,0.0217444,0.019591348,2018,CSCO
2011-02-28T00:00:00Z,1003,1225,57555,222,0.00385718,0.021283989,0.017426809,2011,COG
2012-02-28T00:00:00Z,976,1251,55087,275,0.004992103,0.022709532,0.017717429,2012,COG
2013-02-28T00:00:00Z,958,1128,51807,170,0.00328141,0.021773119,0.01849171,2013,COG
2014-02-28T00:00:00Z,984,1152,51715,168,0.003248574,0.022275935,0.019027362,2014,COG
2015-02-27T00:00:00Z,1063,1144,53253,81,0.001521041,0.021482358,0.019961317,2015,COG
2016-02-22T00:00:00Z,1137,1224,56051,87,0.001552158,0.021837255,0.020285098,2016,COG
2017-02-27T00:00:00Z,1204,1259,57655,55,0.00095395,0.021836788,0.020882838,2017,COG
2018-03-01T00:00:00Z,1138,1208,56777,70,0.001232894,0.021276221,0.020043327,2018,COG
2019-02-26T00:00:00Z,1080,1151,55596,71,0.00127707,0.020702928,0.019425858,2019,COG
2009-11-24T00:00:00Z,1202,1924,89342,722,0.008081306,0.021535224,0.013453919,2009,HOLX
2010-11-24T00:00:00Z,1206,1999,85445,793,0.009280824,0.023395166,0.014114343,2010,HOLX
2011-11-23T00:00:00Z,1286,1952,84583,666,0.007873923,0.023077923,0.015204001,2011,HOLX
2012-11-28T00:00:00Z,1565,2296,101192,731,0.007223891,0.022689541,0.015465649,2012,HOLX
2013-11-26T00:00:00Z,1644,2295,105200,651,0.006188213,0.021815589,0.015627376,2013,HOLX
2014-11-20T00:00:00Z,1423,1952,88890,529,0.005951176,0.021959726,0.01600855,2014,HOLX
2015-11-19T00:00:00Z,1359,1852,84080,493,0.005863463,0.022026641,0.016163178,2015,HOLX
2016-11-17T00:00:00Z,1340,1795,81462,455,0.005585426,0.022034814,0.016449387,2016,HOLX
2017-11-21T00:00:00Z,1387,1932,87113,545,0.006256242,0.022178091,0.015921849,2017,HOLX
2018-11-20T00:00:00Z,1388,1870,84487,482,0.00570502,0.022133583,0.016428563,2018,HOLX
2010-06-01T00:00:00Z,826,1109,48799,283,0.005799299,0.022725876,0.016926576,2010,XLNX
2011-05-31T00:00:00Z,890,1099,50044,209,0.004176325,0.021960675,0.01778435,2011,XLNX
2012-05-25T00:00:00Z,882,1062,48771,180,0.003690718,0.021775235,0.018084517,2012,XLNX
2013-05-23T00:00:00Z,825,1003,45352,178,0.003924854,0.022115893,0.018191039,2013,XLNX
2014-05-16T00:00:00Z,820,987,45130,167,0.003700421,0.021870153,0.018169732,2014,XLNX
2015-05-13T00:00:00Z,781,976,44299,195,0.004401905,0.0220321,0.017630195,2015,XLNX
2016-05-17T00:00:00Z,785,1023,45900,238,0.005185185,0.022287582,0.017102397,2016,XLNX
2017-05-15T00:00:00Z,796,1051,45149,255,0.005647966,0.023278478,0.017630512,2017,XLNX
2018-05-15T00:00:00Z,812,1081,47343,269,0.005681938,0.022833365,0.017151427,2018,XLNX
2019-05-10T00:00:00Z,775,1099,46291,324,0.006999201,0.023741116,0.016741915,2019,XLNX
2010-10-25T00:00:00Z,672,690,36714,18,0.000490276,0.018793921,0.018303644,2010,AZO
2011-10-24T00:00:00Z,691,750,38266,59,0.001541839,0.019599645,0.018057806,2011,AZO
2012-10-22T00:00:00Z,647,692,36680,45,0.001226827,0.018865867,0.01763904,2012,AZO
2013-10-28T00:00:00Z,106,127,9625,21,0.002181818,0.013194805,0.011012987,2013,AZO
2014-10-27T00:00:00Z,126,141,10117,15,0.001482653,0.013936938,0.012454285,2014,AZO
2015-10-26T00:00:00Z,134,135,10503,1,9.52E-05,0.01285347,0.01275826,2015,AZO
2016-10-24T00:00:00Z,131,142,10429,11,0.001054751,0.013615879,0.012561128,2016,AZO
2017-10-25T00:00:00Z,133,156,10347,23,0.002222867,0.015076834,0.012853967,2017,AZO
2018-10-24T00:00:00Z,127,145,10490,18,0.00171592,0.013822688,0.012106768,2018,AZO
2011-02-17T00:00:00Z,1162,1299,65765,137,0.002083175,0.019752148,0.017668973,2011,REGN
2012-02-21T00:00:00Z,1300,1655,81078,355,0.0043785,0.020412442,0.016033943,2012,REGN
2013-02-15T00:00:00Z,1154,1454,77247,300,0.003883646,0.018822737,0.014939091,2013,REGN
2014-02-13T00:00:00Z,1191,1504,83654,313,0.003741602,0.017978818,0.014237215,2014,REGN
2015-02-12T00:00:00Z,1335,1609,89603,274,0.003057933,0.017956988,0.014899055,2015,REGN
2016-02-11T00:00:00Z,1477,1718,96281,241,0.00250309,0.017843604,0.015340514,2016,REGN
2017-02-09T00:00:00Z,1575,1772,95313,197,0.002066874,0.018591378,0.016524503,2017,REGN
2018-02-08T00:00:00Z,1548,1696,90924,148,0.001627733,0.018652941,0.017025208,2018,REGN
2019-02-07T00:00:00Z,1442,1610,84733,168,0.001982699,0.019000862,0.017018163,2019,REGN
2016-02-25T00:00:00Z,328,264,15378,-64,-0.00416179,0.017167382,0.021329172,2016,TSS
2017-02-24T00:00:00Z,334,258,15812,-76,-0.004806476,0.016316721,0.021123198,2017,TSS
2018-02-23T00:00:00Z,385,281,16685,-104,-0.006233144,0.016841474,0.023074618,2018,TSS
2019-02-21T00:00:00Z,399,283,16598,-116,-0.006988794,0.017050247,0.024039041,2019,TSS
2010-02-19T00:00:00Z,696,1145,55370,449,0.008109084,0.020679068,0.012569984,2010,IDXX
2011-02-22T00:00:00Z,699,1132,54988,433,0.007874445,0.02058631,0.012711864,2011,IDXX
2012-02-17T00:00:00Z,138,218,13638,80,0.005865963,0.015984748,0.010118786,2012,IDXX
2013-02-19T00:00:00Z,733,1296,58873,563,0.009562958,0.022013487,0.012450529,2013,IDXX
2014-02-18T00:00:00Z,718,1348,60040,630,0.010493005,0.022451699,0.011958694,2014,IDXX
2015-02-17T00:00:00Z,746,1394,64052,648,0.01011678,0.021763567,0.011646787,2015,IDXX
2016-02-17T00:00:00Z,858,1509,68325,651,0.009527991,0.02208562,0.012557629,2016,IDXX
2017-02-17T00:00:00Z,945,1585,72531,640,0.008823813,0.021852725,0.013028912,2017,IDXX
2018-02-16T00:00:00Z,1027,1645,73897,618,0.008362992,0.022260714,0.013897723,2018,IDXX
2019-02-15T00:00:00Z,1005,1653,73412,648,0.008826895,0.022516755,0.01368986,2019,IDXX
2010-02-26T00:00:00Z,2593,2976,151041,383,0.002535735,0.019703259,0.017167524,2010,AES
2011-02-28T00:00:00Z,2833,3168,165998,335,0.002018097,0.019084567,0.017066471,2011,AES
2012-02-27T00:00:00Z,2573,2880,157666,307,0.001947154,0.018266462,0.016319308,2012,AES
2013-02-27T00:00:00Z,2319,2561,137747,242,0.001756844,0.018592056,0.016835212,2013,AES
2014-02-26T00:00:00Z,2111,2441,124759,330,0.0026451,0.019565723,0.016920623,2014,AES
2015-02-26T00:00:00Z,2216,2544,131611,328,0.002492193,0.019329691,0.016837498,2015,AES
2016-02-24T00:00:00Z,2167,2670,135569,503,0.003710288,0.019694768,0.01598448,2016,AES
2017-02-27T00:00:00Z,2041,2451,124193,410,0.003301313,0.019735412,0.016434099,2017,AES
2018-02-27T00:00:00Z,1989,2135,111583,146,0.001308443,0.019133739,0.017825296,2018,AES
2019-02-27T00:00:00Z,2017,2167,115274,150,0.001301247,0.018798688,0.017497441,2019,AES
2004-03-30T00:00:00Z,653,921,51473,268,0.005206613,0.017892876,0.012686263,2004,VRTX
2005-03-16T00:00:00Z,796,1084,58840,288,0.00489463,0.018422842,0.013528212,2005,VRTX
2006-03-15T00:00:00Z,991,1288,67365,297,0.004408818,0.019119721,0.014710903,2006,VRTX
2007-04-02T00:00:00Z,934,1293,65331,359,0.005495094,0.019791523,0.014296429,2007,VRTX
2008-04-29T00:00:00Z,669,906,44793,237,0.005291005,0.020226375,0.014935369,2008,VRTX
2009-03-31T00:00:00Z,644,898,42510,254,0.005975065,0.021124441,0.015149377,2009,VRTX
2004-03-30T00:00:00Z,653,921,51473,268,0.005206613,0.017892876,0.012686263,2004,IDPH
2005-03-16T00:00:00Z,796,1084,58840,288,0.00489463,0.018422842,0.013528212,2005,IDPH
2006-03-15T00:00:00Z,991,1288,67365,297,0.004408818,0.019119721,0.014710903,2006,IDPH
2007-04-02T00:00:00Z,934,1293,65331,359,0.005495094,0.019791523,0.014296429,2007,IDPH
2008-04-29T00:00:00Z,669,906,44793,237,0.005291005,0.020226375,0.014935369,2008,IDPH
2009-03-31T00:00:00Z,644,898,42510,254,0.005975065,0.021124441,0.015149377,2009,IDPH
2010-02-09T00:00:00Z,1011,1513,74388,502,0.0067484,0.020339302,0.013590902,2010,BIIB
2011-02-04T00:00:00Z,1115,1675,81415,560,0.006878339,0.020573604,0.013695265,2011,BIIB
2012-02-03T00:00:00Z,1225,1848,87745,623,0.00710012,0.021061029,0.013960909,2012,BIIB
2013-02-05T00:00:00Z,1200,1846,85631,646,0.007543997,0.021557613,0.014013617,2013,BIIB
2014-02-06T00:00:00Z,1243,1880,90280,637,0.007055826,0.020824103,0.013768276,2014,BIIB
2015-02-04T00:00:00Z,1117,1633,78971,516,0.006534044,0.020678477,0.014144433,2015,BIIB
2016-02-03T00:00:00Z,1142,1751,82480,609,0.007383608,0.021229389,0.013845781,2016,BIIB
2017-02-02T00:00:00Z,1242,1817,87521,575,0.006569852,0.020760732,0.01419088,2017,BIIB
2018-02-01T00:00:00Z,1333,1974,95889,641,0.006684813,0.020586303,0.01390149,2018,BIIB
2019-02-06T00:00:00Z,1443,2047,105571,604,0.005721268,0.019389795,0.013668526,2019,BIIB
2011-02-28T00:00:00Z,846,1183,66533,337,0.005065156,0.01778065,0.012715495,2011,KIM
2012-02-27T00:00:00Z,850,1176,66166,326,0.004927002,0.017773479,0.012846477,2012,KIM
2013-02-27T00:00:00Z,769,1240,66501,471,0.0070826,0.018646336,0.011563736,2013,KIM
2014-02-26T00:00:00Z,782,1267,65950,485,0.007354056,0.019211524,0.011857468,2014,KIM
2015-02-27T00:00:00Z,826,1319,68048,493,0.007244886,0.019383376,0.01213849,2015,KIM
2016-02-26T00:00:00Z,814,1212,64054,398,0.006213507,0.018921535,0.012708028,2016,KIM
2017-02-27T00:00:00Z,770,1185,61746,415,0.006721083,0.019191527,0.012470443,2017,KIM
2018-02-23T00:00:00Z,774,1255,61431,481,0.007829923,0.020429425,0.012599502,2018,KIM
2019-02-15T00:00:00Z,421,910,44733,489,0.010931527,0.020342924,0.009411397,2019,KIM
2004-03-30T00:00:00Z,653,921,51473,268,0.005206613,0.017892876,0.012686263,2004,QCOM
2005-03-16T00:00:00Z,796,1084,58840,288,0.00489463,0.018422842,0.013528212,2005,QCOM
2006-03-15T00:00:00Z,991,1288,67365,297,0.004408818,0.019119721,0.014710903,2006,QCOM
2007-04-02T00:00:00Z,934,1293,65331,359,0.005495094,0.019791523,0.014296429,2007,QCOM
2008-04-29T00:00:00Z,669,906,44793,237,0.005291005,0.020226375,0.014935369,2008,QCOM
2009-03-31T00:00:00Z,644,898,42510,254,0.005975065,0.021124441,0.015149377,2009,QCOM
2011-02-28T00:00:00Z,1140,1355,76888,215,0.002796275,0.017623036,0.014826761,2011,GILD
2012-02-23T00:00:00Z,1253,1487,84811,234,0.002759076,0.017533103,0.014774027,2012,GILD
2013-02-27T00:00:00Z,1278,1379,79758,101,0.001266331,0.017289802,0.016023471,2013,GILD
2014-02-25T00:00:00Z,1526,1616,89998,90,0.001000022,0.017955955,0.016955932,2014,GILD
2015-02-25T00:00:00Z,1540,1481,84823,-59,-0.000695566,0.017459887,0.018155453,2015,GILD
2016-02-24T00:00:00Z,1336,1295,73925,-41,-0.000554616,0.017517754,0.018072371,2016,GILD
2017-02-27T00:00:00Z,1337,1366,75258,29,0.000385341,0.018150894,0.017765553,2017,GILD
2018-02-27T00:00:00Z,1293,1531,76668,238,0.003104294,0.019969218,0.016864924,2018,GILD
2019-02-26T00:00:00Z,1075,1211,61673,136,0.002205179,0.019635821,0.017430642,2019,GILD
2011-02-25T00:00:00Z,444,533,28370,89,0.003137117,0.018787452,0.015650335,2011,ROP
2012-02-24T00:00:00Z,457,585,29385,128,0.004355964,0.019908116,0.015552152,2012,ROP
2013-02-25T00:00:00Z,381,546,25556,165,0.006456409,0.021364846,0.014908436,2013,ROP
2014-02-21T00:00:00Z,438,589,28031,151,0.005386893,0.021012451,0.015625557,2014,ROP
2015-02-20T00:00:00Z,97,102,7047,5,0.000709522,0.014474244,0.013764723,2015,ROP
2016-02-26T00:00:00Z,109,130,8048,21,0.002609344,0.016153082,0.013543738,2016,ROP
2017-02-27T00:00:00Z,155,160,9533,5,0.000524494,0.016783804,0.01625931,2017,ROP
2018-02-23T00:00:00Z,470,624,30411,154,0.005063957,0.020518891,0.015454934,2018,ROP
2019-02-25T00:00:00Z,485,616,31625,131,0.004142292,0.019478261,0.015335968,2019,ROP
2010-12-17T00:00:00Z,570,864,41519,294,0.007081095,0.02080975,0.013728654,2010,SNPS
2011-12-16T00:00:00Z,643,933,44779,290,0.00647625,0.02083566,0.01435941,2011,SNPS
2012-12-20T00:00:00Z,665,913,45791,248,0.005415911,0.019938416,0.014522504,2012,SNPS
2013-12-20T00:00:00Z,653,865,43286,212,0.004897657,0.019983366,0.015085709,2013,SNPS
2014-12-15T00:00:00Z,712,932,45767,220,0.004806957,0.020364018,0.015557061,2014,SNPS
2015-12-14T00:00:00Z,768,956,45516,188,0.004130416,0.021003603,0.016873187,2015,SNPS
2016-12-12T00:00:00Z,780,986,47142,206,0.004369776,0.020915532,0.016545755,2016,SNPS
2017-12-14T00:00:00Z,806,1018,48406,212,0.004379622,0.021030451,0.016650828,2017,SNPS
2018-12-17T00:00:00Z,747,1014,48080,267,0.005553245,0.02108985,0.015536606,2018,SNPS
2010-03-31T00:00:00Z,611,1023,46034,412,0.008949907,0.022222705,0.013272798,2010,M
2011-03-30T00:00:00Z,576,957,43453,381,0.008768094,0.022023796,0.013255702,2011,M
2012-03-28T00:00:00Z,484,927,39905,443,0.011101366,0.023230172,0.012128806,2012,M
2013-04-03T00:00:00Z,489,861,39169,372,0.009497307,0.021981669,0.012484363,2013,M
2014-04-02T00:00:00Z,481,851,39311,370,0.009412124,0.021647885,0.012235761,2014,M
2015-04-01T00:00:00Z,493,817,38823,324,0.008345568,0.021044226,0.012698658,2015,M
2016-03-30T00:00:00Z,540,906,41540,366,0.008810785,0.021810303,0.012999519,2016,M
2017-03-29T00:00:00Z,607,921,43117,314,0.00728251,0.021360484,0.014077974,2017,M
2018-04-04T00:00:00Z,627,1018,44082,391,0.008869833,0.023093326,0.014223493,2018,M
2019-04-03T00:00:00Z,697,1075,44176,378,0.008556682,0.02433448,0.015777798,2019,M
2011-03-01T00:00:00Z,568,776,35716,208,0.00582372,0.021726957,0.015903237,2011,MHK
2012-02-29T00:00:00Z,571,812,37227,241,0.006473796,0.021812126,0.01533833,2012,MHK
2013-02-27T00:00:00Z,494,755,36031,261,0.007243762,0.020954178,0.013710416,2013,MHK
2014-02-28T00:00:00Z,544,871,38637,327,0.00846339,0.022543158,0.014079768,2014,MHK
2015-02-27T00:00:00Z,559,856,38818,297,0.00765109,0.022051626,0.014400536,2015,MHK
2016-02-29T00:00:00Z,612,847,40814,235,0.005757828,0.020752683,0.014994855,2016,MHK
2017-02-27T00:00:00Z,642,933,42285,291,0.006881873,0.022064562,0.015182689,2017,MHK
2018-02-28T00:00:00Z,618,985,43129,367,0.008509356,0.022838461,0.014329106,2018,MHK
2019-02-28T00:00:00Z,591,1007,43803,416,0.009497066,0.022989293,0.013492227,2019,MHK
2012-02-17T00:00:00Z,1400,2281,87932,881,0.010019106,0.025940499,0.015921394,2012,BSX
2013-02-22T00:00:00Z,1399,2286,86792,887,0.010219836,0.026338833,0.016118997,2013,BSX
2014-02-26T00:00:00Z,1367,2369,85526,1002,0.011715736,0.027699179,0.015983444,2014,BSX
2015-02-25T00:00:00Z,1308,2146,79535,838,0.010536242,0.026981832,0.01644559,2015,BSX
2016-02-24T00:00:00Z,1283,2038,75337,755,0.010021636,0.027051781,0.017030145,2016,BSX
2017-02-23T00:00:00Z,1273,1988,76955,715,0.009291144,0.025833279,0.016542135,2017,BSX
2018-02-20T00:00:00Z,1241,1868,71696,627,0.008745258,0.026054452,0.017309194,2018,BSX
2019-02-19T00:00:00Z,1320,1830,73575,510,0.006931702,0.024872579,0.017940877,2019,BSX
2011-03-18T00:00:00Z,357,471,26036,114,0.004378553,0.018090336,0.013711784,2011,KSS
2012-03-16T00:00:00Z,404,502,26607,98,0.003683241,0.018867215,0.015183974,2012,KSS
2013-03-22T00:00:00Z,358,473,24731,115,0.004650034,0.019125794,0.014475759,2013,KSS
2014-03-21T00:00:00Z,341,494,25081,153,0.006100235,0.019696184,0.013595949,2014,KSS
2015-03-20T00:00:00Z,338,500,24040,162,0.006738769,0.020798669,0.0140599,2015,KSS
2016-03-18T00:00:00Z,371,494,24386,123,0.005043878,0.020257525,0.015213647,2016,KSS
2017-03-17T00:00:00Z,351,452,23011,101,0.004389205,0.01964278,0.015253574,2017,KSS
2018-03-23T00:00:00Z,362,500,24303,138,0.005678311,0.020573592,0.01489528,2018,KSS
2019-03-22T00:00:00Z,414,491,25267,77,0.003047453,0.019432461,0.016385008,2019,KSS
2004-03-30T00:00:00Z,653,921,51473,268,0.005206613,0.017892876,0.012686263,2004,DHI
2005-03-16T00:00:00Z,796,1084,58840,288,0.00489463,0.018422842,0.013528212,2005,DHI
2006-03-15T00:00:00Z,991,1288,67365,297,0.004408818,0.019119721,0.014710903,2006,DHI
2007-04-02T00:00:00Z,934,1293,65331,359,0.005495094,0.019791523,0.014296429,2007,DHI
2008-04-29T00:00:00Z,669,906,44793,237,0.005291005,0.020226375,0.014935369,2008,DHI
2009-03-31T00:00:00Z,644,898,42510,254,0.005975065,0.021124441,0.015149377,2009,DHI
2009-11-23T00:00:00Z,1037,1255,51999,218,0.004192388,0.02413508,0.019942691,2009,TSN
2010-11-22T00:00:00Z,1102,1229,53599,127,0.002369447,0.022929532,0.020560085,2010,TSN
2011-11-21T00:00:00Z,1035,1212,51496,177,0.00343716,0.023535809,0.020098648,2011,TSN
2012-11-19T00:00:00Z,847,1176,48078,329,0.006843047,0.024460252,0.017617205,2012,TSN
2013-11-18T00:00:00Z,841,1132,47809,291,0.00608672,0.02367755,0.01759083,2013,TSN
2014-11-17T00:00:00Z,968,1363,56876,395,0.006944933,0.023964414,0.017019481,2014,TSN
2015-11-23T00:00:00Z,955,1447,58770,492,0.008371618,0.024621405,0.016249787,2015,TSN
2016-11-21T00:00:00Z,937,1478,57656,541,0.009383239,0.0256348,0.016251561,2016,TSN
2017-11-13T00:00:00Z,981,1654,63744,673,0.010557856,0.02594754,0.015389684,2017,TSN
2018-11-13T00:00:00Z,994,1734,64312,740,0.011506406,0.026962309,0.015455902,2018,TSN
2004-03-12T00:00:00Z,746,826,42295,80,0.001891477,0.019529495,0.017638019,2004,WPI
2005-03-15T00:00:00Z,793,913,47983,120,0.002500886,0.019027572,0.016526687,2005,WPI
2006-03-10T00:00:00Z,792,951,49741,159,0.003196558,0.019119037,0.015922478,2006,WPI
2007-03-01T00:00:00Z,925,1151,59810,226,0.003778632,0.019244274,0.015465641,2007,WPI
2008-02-25T00:00:00Z,980,1142,60643,162,0.002671372,0.018831522,0.01616015,2008,WPI
2009-02-23T00:00:00Z,997,1143,58285,146,0.002504933,0.019610534,0.017105602,2009,WPI
2010-03-01T00:00:00Z,1075,1380,66549,305,0.004583089,0.0207366,0.016153511,2010,WPI
2011-02-22T00:00:00Z,1057,1360,65859,303,0.004600738,0.020650177,0.016049439,2011,WPI
2012-02-16T00:00:00Z,1145,1496,71104,351,0.004936431,0.021039604,0.016103173,2012,WPI
2013-02-28T00:00:00Z,1283,1656,80967,373,0.004606815,0.020452777,0.015845962,2013,WPI
2004-03-12T00:00:00Z,746,826,42295,80,0.001891477,0.019529495,0.017638019,2004,ACT
2005-03-15T00:00:00Z,793,913,47983,120,0.002500886,0.019027572,0.016526687,2005,ACT
2006-03-10T00:00:00Z,792,951,49741,159,0.003196558,0.019119037,0.015922478,2006,ACT
2007-03-01T00:00:00Z,925,1151,59810,226,0.003778632,0.019244274,0.015465641,2007,ACT
2008-02-25T00:00:00Z,980,1142,60643,162,0.002671372,0.018831522,0.01616015,2008,ACT
2009-02-23T00:00:00Z,997,1143,58285,146,0.002504933,0.019610534,0.017105602,2009,ACT
2010-03-01T00:00:00Z,1075,1380,66549,305,0.004583089,0.0207366,0.016153511,2010,ACT
2011-02-22T00:00:00Z,1057,1360,65859,303,0.004600738,0.020650177,0.016049439,2011,ACT
2012-02-16T00:00:00Z,1145,1496,71104,351,0.004936431,0.021039604,0.016103173,2012,ACT
2013-02-28T00:00:00Z,1283,1656,80967,373,0.004606815,0.020452777,0.015845962,2013,ACT
2009-09-15T00:00:00Z,862,1228,58472,366,0.006259406,0.021001505,0.014742099,2009,INTU
2010-09-16T00:00:00Z,848,1298,57370,450,0.007843821,0.022625065,0.014781245,2010,INTU
2011-09-14T00:00:00Z,826,1349,57422,523,0.009108007,0.023492738,0.014384731,2011,INTU
2012-09-13T00:00:00Z,915,1435,60162,520,0.00864333,0.023852266,0.015208936,2012,INTU
2013-09-13T00:00:00Z,981,1435,60410,454,0.007515312,0.023754345,0.016239033,2013,INTU
2014-09-12T00:00:00Z,934,1371,56889,437,0.007681626,0.024099562,0.016417937,2014,INTU
2015-09-01T00:00:00Z,989,1369,57035,380,0.006662576,0.024002805,0.01734023,2015,INTU
2016-09-01T00:00:00Z,1007,1411,57345,404,0.007045078,0.024605458,0.01756038,2016,INTU
2017-09-01T00:00:00Z,998,1365,56222,367,0.006527694,0.024278752,0.017751058,2017,INTU
2018-08-31T00:00:00Z,997,1397,57892,400,0.006909418,0.024131141,0.017221723,2018,INTU
2011-05-31T00:00:00Z,853,1128,52493,275,0.005238794,0.021488579,0.016249786,2011,MCHP
2012-05-30T00:00:00Z,857,1115,52253,258,0.004937516,0.021338488,0.016400972,2012,MCHP
2013-05-30T00:00:00Z,893,1152,54178,259,0.004780538,0.021263243,0.016482705,2013,MCHP
2014-05-30T00:00:00Z,831,1102,51301,271,0.005282548,0.021481063,0.016198515,2014,MCHP
2015-05-27T00:00:00Z,925,1289,56858,364,0.006401914,0.022670513,0.016268599,2015,MCHP
2016-05-24T00:00:00Z,958,1335,59875,377,0.006296451,0.022296451,0.016,2016,MCHP
2017-05-30T00:00:00Z,1213,1435,65831,222,0.003372271,0.021798241,0.01842597,2017,MCHP
2018-05-18T00:00:00Z,1287,1581,71458,294,0.004114305,0.022124885,0.01801058,2018,MCHP
2010-02-26T00:00:00Z,578,952,48887,374,0.007650296,0.01947348,0.011823184,2010,ORLY
2011-02-28T00:00:00Z,616,1029,51425,413,0.008031113,0.020009723,0.01197861,2011,ORLY
2012-02-28T00:00:00Z,623,1032,49411,409,0.008277509,0.020886038,0.012608528,2012,ORLY
2013-02-28T00:00:00Z,610,930,47626,320,0.006719019,0.019527149,0.01280813,2013,ORLY
2014-02-28T00:00:00Z,590,938,45864,348,0.00758765,0.02045177,0.01286412,2014,ORLY
2015-02-27T00:00:00Z,558,902,42781,344,0.008040953,0.021084126,0.013043173,2015,ORLY
2016-02-26T00:00:00Z,588,971,45170,383,0.008479079,0.021496569,0.013017489,2016,ORLY
2017-02-28T00:00:00Z,586,1051,47158,465,0.009860469,0.022286781,0.012426312,2017,ORLY
2018-02-28T00:00:00Z,585,1054,48453,469,0.009679483,0.021753039,0.012073556,2018,ORLY
2019-02-27T00:00:00Z,566,1026,47969,460,0.009589527,0.021388814,0.011799287,2019,ORLY
2010-02-23T00:00:00Z,764,1099,52157,335,0.006422915,0.021070997,0.014648082,2010,RCL
2011-02-24T00:00:00Z,800,1178,54215,378,0.00697224,0.021728304,0.014756064,2011,RCL
2012-02-29T00:00:00Z,872,1290,60999,418,0.006852571,0.021147888,0.014295316,2012,RCL
2013-02-25T00:00:00Z,885,1358,60670,473,0.007796275,0.022383386,0.014587111,2013,RCL
2014-02-20T00:00:00Z,828,1346,59920,518,0.00864486,0.022463284,0.013818425,2014,RCL
2015-02-23T00:00:00Z,844,1386,60694,542,0.008930043,0.022835865,0.013905823,2015,RCL
2016-02-22T00:00:00Z,868,1432,62406,564,0.009037593,0.022946512,0.013908919,2016,RCL
2017-02-23T00:00:00Z,896,1426,61731,530,0.008585638,0.023100225,0.014514587,2017,RCL
2018-02-21T00:00:00Z,922,1339,60060,417,0.006943057,0.022294372,0.015351315,2018,RCL
2019-02-22T00:00:00Z,1004,1427,66552,423,0.006355932,0.02144188,0.015085948,2019,RCL
2010-02-26T00:00:00Z,479,704,32696,225,0.006881576,0.021531686,0.01465011,2010,FLIR
2011-03-01T00:00:00Z,566,1074,40098,508,0.012668961,0.026784378,0.014115417,2011,FLIR
2012-02-29T00:00:00Z,531,1089,38411,558,0.014527089,0.028351254,0.013824165,2012,FLIR
2013-03-01T00:00:00Z,545,1093,38992,548,0.014054165,0.028031391,0.013977226,2013,FLIR
2014-03-03T00:00:00Z,562,1099,40629,537,0.01321716,0.027049644,0.013832484,2014,FLIR
2015-02-27T00:00:00Z,591,1105,40848,514,0.012583235,0.027051508,0.014468273,2015,FLIR
2016-02-26T00:00:00Z,664,1179,44445,515,0.011587355,0.026527168,0.014939813,2016,FLIR
2017-02-24T00:00:00Z,720,1270,48802,550,0.01127003,0.026023524,0.014753494,2017,FLIR
2018-02-23T00:00:00Z,786,1323,52084,537,0.010310268,0.025401275,0.015091007,2018,FLIR
2019-02-28T00:00:00Z,775,1308,52658,533,0.010121919,0.024839531,0.014717612,2019,FLIR
2010-02-25T00:00:00Z,3619,3065,127160,-554,-0.004356716,0.024103492,0.028460208,2010,ALL
2011-02-24T00:00:00Z,3747,3216,129117,-531,-0.004112549,0.024907642,0.029020191,2011,ALL
2012-02-22T00:00:00Z,3378,3062,122830,-316,-0.002572661,0.024928763,0.027501425,2012,ALL
2013-02-20T00:00:00Z,3185,2946,118419,-239,-0.002018257,0.024877765,0.026896022,2013,ALL
2014-02-20T00:00:00Z,3296,3074,124149,-222,-0.001788174,0.02476057,0.026548744,2014,ALL
2015-02-19T00:00:00Z,3329,3120,125810,-209,-0.001661235,0.024799301,0.026460536,2015,ALL
2016-02-19T00:00:00Z,3461,3150,129005,-311,-0.002410759,0.024417658,0.026828418,2016,ALL
2017-02-17T00:00:00Z,3763,3334,139407,-429,-0.00307732,0.023915585,0.026992906,2017,ALL
2018-02-26T00:00:00Z,3565,3246,134742,-319,-0.002367487,0.024090484,0.026457972,2018,ALL
2019-02-15T00:00:00Z,3655,3403,137409,-252,-0.001833941,0.024765481,0.026599422,2019,ALL
2000-03-31T00:00:00Z,109,246,15925,137,0.008602826,0.01544741,0.006844584,2000,DFS
2002-03-28T00:00:00Z,191,280,19524,89,0.004558492,0.014341323,0.009782831,2002,DFS
2003-03-18T00:00:00Z,251,350,22793,99,0.004343439,0.015355592,0.011012153,2003,DFS
2004-03-17T00:00:00Z,248,346,23173,98,0.00422906,0.01493117,0.01070211,2004,DFS
2005-03-17T00:00:00Z,295,413,26592,118,0.004437425,0.015530987,0.011093562,2005,DFS
2006-03-16T00:00:00Z,390,536,32454,146,0.004498675,0.016515684,0.012017009,2006,DFS
2007-03-15T00:00:00Z,495,802,41638,307,0.007373073,0.019261252,0.011888179,2007,DFS
2008-03-13T00:00:00Z,537,844,42346,307,0.007249799,0.019931044,0.012681245,2008,DFS
2000-03-31T00:00:00Z,109,246,15925,137,0.008602826,0.01544741,0.006844584,2000,LNX
2002-03-28T00:00:00Z,191,280,19524,89,0.004558492,0.014341323,0.009782831,2002,LNX
2003-03-18T00:00:00Z,251,350,22793,99,0.004343439,0.015355592,0.011012153,2003,LNX
2004-03-17T00:00:00Z,248,346,23173,98,0.00422906,0.01493117,0.01070211,2004,LNX
2005-03-17T00:00:00Z,295,413,26592,118,0.004437425,0.015530987,0.011093562,2005,LNX
2006-03-16T00:00:00Z,390,536,32454,146,0.004498675,0.016515684,0.012017009,2006,LNX
2007-03-15T00:00:00Z,495,802,41638,307,0.007373073,0.019261252,0.011888179,2007,LNX
2008-03-13T00:00:00Z,537,844,42346,307,0.007249799,0.019931044,0.012681245,2008,LNX
2004-03-05T00:00:00Z,757,980,54919,223,0.004060526,0.017844462,0.013783936,2004,NXL
2005-03-04T00:00:00Z,844,1088,59298,244,0.00411481,0.018348005,0.014233195,2005,NXL
2006-03-06T00:00:00Z,854,1217,62478,363,0.005810045,0.019478857,0.013668811,2006,NXL
2007-02-26T00:00:00Z,803,1234,64087,431,0.006725233,0.019255075,0.012529842,2007,NXL
2008-04-16T00:00:00Z,1042,1996,83773,954,0.011387917,0.023826292,0.012438375,2008,NXL
2009-03-31T00:00:00Z,1082,1962,81119,880,0.01084826,0.024186689,0.013338429,2009,NXL
2012-02-14T00:00:00Z,696,999,45591,303,0.006646049,0.02191222,0.015266171,2012,BWA
2013-02-14T00:00:00Z,674,916,44159,242,0.005480197,0.020743223,0.015263027,2013,BWA
2014-02-13T00:00:00Z,694,922,43504,228,0.005240897,0.021193453,0.015952556,2014,BWA
2015-02-12T00:00:00Z,715,1025,45314,310,0.006841153,0.022619941,0.015778788,2015,BWA
2016-02-11T00:00:00Z,761,1117,47541,356,0.007488273,0.023495509,0.016007236,2016,BWA
2017-02-09T00:00:00Z,807,1249,52692,442,0.00838837,0.023703788,0.015315418,2017,BWA
2018-02-08T00:00:00Z,764,1168,51098,404,0.007906376,0.022858037,0.014951662,2018,BWA
2019-02-19T00:00:00Z,797,1273,55062,476,0.0086448,0.023119393,0.014474592,2019,BWA
2004-03-30T00:00:00Z,653,921,51473,268,0.005206613,0.017892876,0.012686263,2004,EQR
2005-03-16T00:00:00Z,796,1084,58840,288,0.00489463,0.018422842,0.013528212,2005,EQR
2006-03-15T00:00:00Z,991,1288,67365,297,0.004408818,0.019119721,0.014710903,2006,EQR
2007-04-02T00:00:00Z,934,1293,65331,359,0.005495094,0.019791523,0.014296429,2007,EQR
2008-04-29T00:00:00Z,669,906,44793,237,0.005291005,0.020226375,0.014935369,2008,EQR
2009-03-31T00:00:00Z,644,898,42510,254,0.005975065,0.021124441,0.015149377,2009,EQR
2011-02-28T00:00:00Z,1268,1402,74158,134,0.001806953,0.01890558,0.017098627,2011,UHS
2012-02-27T00:00:00Z,1289,1537,76778,248,0.003230092,0.020018755,0.016788663,2012,UHS
2013-02-28T00:00:00Z,1367,1645,83414,278,0.003332774,0.01972091,0.016388136,2013,UHS
2014-02-27T00:00:00Z,1339,1626,81382,287,0.003526578,0.019979848,0.01645327,2014,UHS
2015-02-26T00:00:00Z,322,401,22663,79,0.003485858,0.017694039,0.014208181,2015,UHS
2016-02-25T00:00:00Z,1416,1735,84405,319,0.003779397,0.020555654,0.016776257,2016,UHS
2017-02-28T00:00:00Z,1355,1622,81751,267,0.003266015,0.019840736,0.016574721,2017,UHS
2018-02-28T00:00:00Z,1407,1644,83710,237,0.002831203,0.019639231,0.016808028,2018,UHS
2019-02-27T00:00:00Z,1493,1744,88677,251,0.002830497,0.019666881,0.016836384,2019,UHS
2004-03-30T00:00:00Z,653,921,51473,268,0.005206613,0.017892876,0.012686263,2004,ATVI
2005-03-16T00:00:00Z,796,1084,58840,288,0.00489463,0.018422842,0.013528212,2005,ATVI
2006-03-15T00:00:00Z,991,1288,67365,297,0.004408818,0.019119721,0.014710903,2006,ATVI
2007-04-02T00:00:00Z,934,1293,65331,359,0.005495094,0.019791523,0.014296429,2007,ATVI
2008-04-29T00:00:00Z,669,906,44793,237,0.005291005,0.020226375,0.014935369,2008,ATVI
2009-03-31T00:00:00Z,644,898,42510,254,0.005975065,0.021124441,0.015149377,2009,ATVI
2011-02-15T00:00:00Z,546,866,36492,320,0.008769045,0.023731229,0.014962183,2011,IT
2012-02-23T00:00:00Z,507,924,36178,417,0.011526342,0.025540384,0.014014042,2012,IT
2013-02-22T00:00:00Z,493,883,35774,390,0.010901772,0.02468273,0.013780958,2013,IT
2014-02-26T00:00:00Z,472,825,34547,353,0.010217964,0.023880511,0.013662547,2014,IT
2015-02-27T00:00:00Z,520,864,35845,344,0.009596875,0.02410378,0.014506905,2015,IT
2016-02-24T00:00:00Z,536,883,36712,347,0.00945195,0.024052081,0.014600131,2016,IT
2017-02-22T00:00:00Z,569,1021,42413,452,0.01065711,0.024072808,0.013415698,2017,IT
2018-02-22T00:00:00Z,601,1164,45200,563,0.012455752,0.025752212,0.01329646,2018,IT
2019-02-22T00:00:00Z,702,1226,49576,524,0.01056963,0.024729708,0.014160077,2019,IT
2011-03-01T00:00:00Z,1041,1209,69274,168,0.002425152,0.017452435,0.015027283,2011,REG
2012-02-29T00:00:00Z,887,1080,58100,193,0.003321859,0.01858864,0.015266781,2012,REG
2013-03-01T00:00:00Z,894,1158,59903,264,0.004407125,0.019331252,0.014924127,2013,REG
2014-02-19T00:00:00Z,854,1114,61267,260,0.00424372,0.018182708,0.013938988,2014,REG
2015-02-20T00:00:00Z,886,1262,63792,376,0.005894156,0.019783045,0.013888889,2015,REG
2016-02-18T00:00:00Z,821,1242,59644,421,0.007058547,0.020823553,0.013765006,2016,REG
2017-02-27T00:00:00Z,899,1353,66841,454,0.006792238,0.020242067,0.013449829,2017,REG
2018-02-27T00:00:00Z,850,1347,70241,497,0.00707564,0.019176834,0.012101194,2018,REG
2019-02-21T00:00:00Z,825,1305,69987,480,0.006858417,0.01864632,0.011787903,2019,REG
2013-02-21T00:00:00Z,975,1264,54125,289,0.005339492,0.023353349,0.018013857,2013,INCY
2014-02-21T00:00:00Z,1115,1315,58553,200,0.003415709,0.022458286,0.019042577,2014,INCY
2015-02-17T00:00:00Z,1169,1356,62473,187,0.002993293,0.021705377,0.018712084,2015,INCY
2016-02-12T00:00:00Z,1186,1410,65513,224,0.003419169,0.021522446,0.018103277,2016,INCY
2017-02-14T00:00:00Z,1282,1691,80257,409,0.005096129,0.021069813,0.015973685,2017,INCY
2018-02-15T00:00:00Z,1354,1776,81092,422,0.005203966,0.021901051,0.016697085,2018,INCY
2019-02-14T00:00:00Z,1330,1687,79451,357,0.004493336,0.021233213,0.016739877,2019,INCY
2011-02-23T00:00:00Z,672,1232,54851,560,0.010209477,0.022460848,0.012251372,2011,EMN
2012-02-22T00:00:00Z,694,1381,58144,687,0.011815493,0.023751376,0.011935883,2012,EMN
2013-02-28T00:00:00Z,817,1856,76129,1039,0.013647887,0.024379671,0.010731784,2013,EMN
2014-02-28T00:00:00Z,714,1688,68970,974,0.014122082,0.024474409,0.010352327,2014,EMN
2015-02-27T00:00:00Z,748,1748,71689,1000,0.013949141,0.024383099,0.010433958,2015,EMN
2016-02-25T00:00:00Z,746,1703,66897,957,0.014305574,0.025457046,0.011151472,2016,EMN
2017-02-27T00:00:00Z,805,1650,64215,845,0.013158919,0.025694931,0.012536012,2017,EMN
2018-03-01T00:00:00Z,790,1679,60495,889,0.014695429,0.02775436,0.01305893,2018,EMN
2019-02-27T00:00:00Z,774,1594,59683,820,0.013739256,0.026707773,0.012968517,2019,EMN
2010-02-25T00:00:00Z,732,1057,52677,325,0.006169676,0.020065683,0.013896008,2010,MAA
2011-02-24T00:00:00Z,722,1000,51193,278,0.00543043,0.019533921,0.014103491,2011,MAA
2012-02-24T00:00:00Z,301,399,24266,98,0.004038572,0.016442759,0.012404187,2012,MAA
2013-02-22T00:00:00Z,836,1061,54163,225,0.004154127,0.019589018,0.015434891,2013,MAA
2014-02-21T00:00:00Z,1250,1599,80565,349,0.004331906,0.019847328,0.015515422,2014,MAA
2015-02-25T00:00:00Z,1151,1378,72198,227,0.003144131,0.019086401,0.01594227,2015,MAA
2016-02-26T00:00:00Z,1168,1367,68576,199,0.00290189,0.019934088,0.017032198,2016,MAA
2017-02-24T00:00:00Z,1205,1505,75909,300,0.003952101,0.019826371,0.015874271,2017,MAA
2018-02-23T00:00:00Z,985,1234,61645,249,0.004039257,0.020017844,0.015978587,2018,MAA
2019-02-21T00:00:00Z,978,1179,59492,201,0.003378606,0.019817791,0.016439185,2019,MAA
2010-02-26T00:00:00Z,871,1671,58203,800,0.013744996,0.02870986,0.014964864,2010,ALB
2011-02-25T00:00:00Z,894,1587,61212,693,0.01132131,0.025926289,0.014604979,2011,ALB
2012-02-22T00:00:00Z,856,1627,60633,771,0.012715848,0.026833572,0.014117725,2012,ALB
2013-02-15T00:00:00Z,967,1705,63807,738,0.011566129,0.026721206,0.015155077,2013,ALB
2014-02-25T00:00:00Z,900,1589,61281,689,0.011243289,0.025929734,0.014686444,2014,ALB
2015-03-02T00:00:00Z,1149,1815,73316,666,0.009083965,0.024755851,0.015671886,2015,ALB
2016-02-29T00:00:00Z,1171,1840,74131,669,0.009024565,0.024820925,0.01579636,2016,ALB
2017-02-28T00:00:00Z,1220,1860,74272,640,0.008616975,0.025043085,0.016426109,2017,ALB
2018-02-28T00:00:00Z,1196,1877,75769,681,0.008987845,0.024772664,0.01578482,2018,ALB
2019-02-27T00:00:00Z,1161,1806,73829,645,0.008736404,0.024461932,0.015725528,2019,ALB
2011-02-25T00:00:00Z,343,331,23105,-12,-0.000519368,0.014325903,0.014845272,2011,MLM
2012-02-29T00:00:00Z,491,523,31925,32,0.001002349,0.016382146,0.015379796,2012,MLM
2013-02-22T00:00:00Z,363,409,24724,46,0.00186054,0.016542631,0.01468209,2013,MLM
2014-02-24T00:00:00Z,434,483,28248,49,0.001734636,0.017098556,0.01536392,2014,MLM
2015-02-24T00:00:00Z,449,533,30660,84,0.002739726,0.017384214,0.014644488,2015,MLM
2016-02-23T00:00:00Z,439,567,31557,128,0.004056152,0.017967487,0.013911335,2016,MLM
2017-02-24T00:00:00Z,427,574,31011,147,0.004740253,0.018509561,0.013769308,2017,MLM
2018-02-23T00:00:00Z,439,568,29946,129,0.004307754,0.018967475,0.014659721,2018,MLM
2019-02-25T00:00:00Z,91,61,6407,-30,-0.004682379,0.009520837,0.014203215,2019,MLM
2004-03-30T00:00:00Z,653,921,51473,268,0.005206613,0.017892876,0.012686263,2004,TSCO
2005-03-16T00:00:00Z,796,1084,58840,288,0.00489463,0.018422842,0.013528212,2005,TSCO
2006-03-15T00:00:00Z,991,1288,67365,297,0.004408818,0.019119721,0.014710903,2006,TSCO
2007-04-02T00:00:00Z,934,1293,65331,359,0.005495094,0.019791523,0.014296429,2007,TSCO
2008-04-29T00:00:00Z,669,906,44793,237,0.005291005,0.020226375,0.014935369,2008,TSCO
2009-03-31T00:00:00Z,644,898,42510,254,0.005975065,0.021124441,0.015149377,2009,TSCO
2011-09-28T00:00:00Z,712,850,47396,138,0.002911638,0.017934003,0.015022365,2011,CPRT
2012-10-01T00:00:00Z,682,907,48933,225,0.004598124,0.018535549,0.013937425,2012,CPRT
2013-09-30T00:00:00Z,659,878,47177,219,0.004642093,0.018610764,0.013968671,2013,CPRT
2014-09-29T00:00:00Z,786,918,49552,132,0.002663868,0.018525993,0.015862125,2014,CPRT
2015-09-25T00:00:00Z,824,912,50389,88,0.001746413,0.018099188,0.016352775,2015,CPRT
2016-09-28T00:00:00Z,848,1031,54719,183,0.003344359,0.018841719,0.015497359,2016,CPRT
2017-09-28T00:00:00Z,856,1115,56775,259,0.004561867,0.019638926,0.015077059,2017,CPRT
2018-10-01T00:00:00Z,824,1118,56864,294,0.005170231,0.019660945,0.014490715,2018,CPRT
2011-02-23T00:00:00Z,864,1220,63610,356,0.005596604,0.019179374,0.01358277,2011,AVB
2012-02-27T00:00:00Z,868,1209,64100,341,0.005319813,0.018861154,0.013541342,2012,AVB
2013-02-22T00:00:00Z,946,1226,67959,280,0.004120131,0.018040289,0.013920158,2013,AVB
2014-03-03T00:00:00Z,962,1282,72899,320,0.004389635,0.017585975,0.01319634,2014,AVB
2015-02-19T00:00:00Z,1024,1186,70041,162,0.002312931,0.016932939,0.014620008,2015,AVB
2016-02-26T00:00:00Z,1082,1325,72103,243,0.003370179,0.018376489,0.01500631,2016,AVB
2017-02-24T00:00:00Z,1171,1369,70115,198,0.002823932,0.019525066,0.016701134,2017,AVB
2018-02-23T00:00:00Z,1206,1340,69587,134,0.001925647,0.01925647,0.017330823,2018,AVB
2019-02-22T00:00:00Z,1208,1361,68887,153,0.002221029,0.019756993,0.017535965,2019,AVB
2012-02-24T00:00:00Z,810,1149,65351,339,0.005187373,0.01758198,0.012394608,2012,MAC
2013-02-22T00:00:00Z,867,1252,69265,385,0.005558363,0.018075507,0.012517144,2013,MAC
2014-02-21T00:00:00Z,796,1094,64546,298,0.004616862,0.016949153,0.01233229,2014,MAC
2015-02-23T00:00:00Z,768,1097,65158,329,0.005049265,0.016835999,0.011786734,2015,MAC
2016-02-23T00:00:00Z,783,1071,66693,288,0.004318294,0.016058657,0.011740363,2016,MAC
2017-02-24T00:00:00Z,735,1014,64279,279,0.004340453,0.015774981,0.011434528,2017,MAC
2018-02-23T00:00:00Z,735,997,60868,262,0.004304396,0.016379707,0.012075311,2018,MAC
2019-02-25T00:00:00Z,737,959,60482,222,0.003670514,0.015855957,0.012185444,2019,MAC
2005-03-16T00:00:00Z,981,1400,90793,419,0.004614893,0.015419691,0.010804798,2005,PLD
2006-03-16T00:00:00Z,773,1163,73400,390,0.005313351,0.015844687,0.010531335,2006,PLD
2007-02-28T00:00:00Z,740,1104,70834,364,0.005138775,0.015585736,0.01044696,2007,PLD
2008-02-28T00:00:00Z,766,1178,75093,412,0.00548653,0.015687215,0.010200684,2008,PLD
2009-03-02T00:00:00Z,944,1360,77733,416,0.005351652,0.017495787,0.012144134,2009,PLD
2010-02-26T00:00:00Z,1009,1447,78886,438,0.005552316,0.018342925,0.012790609,2010,PLD
2011-02-28T00:00:00Z,1020,1394,77165,374,0.004846757,0.018065185,0.013218428,2011,PLD
2011-03-01T00:00:00Z,1072,1228,58559,156,0.00266398,0.020970303,0.018306324,2011,INHL
2012-02-29T00:00:00Z,1120,1320,59894,200,0.003339233,0.022038935,0.018699703,2012,INHL
2013-03-01T00:00:00Z,1255,1394,65674,139,0.002116515,0.021226056,0.019109541,2013,INHL
2014-02-27T00:00:00Z,1326,1328,66170,2,3.02E-05,0.020069518,0.020039293,2014,INHL
2015-02-26T00:00:00Z,1308,1282,63974,-26,-0.000406415,0.020039391,0.020445806,2015,INHL
2016-02-29T00:00:00Z,1273,1355,65216,82,0.00125736,0.02077711,0.01951975,2016,INHL
2017-03-01T00:00:00Z,1283,1392,66395,109,0.00164169,0.020965434,0.019323744,2017,INHL
2018-03-01T00:00:00Z,1378,1462,71933,84,0.001167753,0.020324469,0.019156715,2018,INHL
2019-03-01T00:00:00Z,1396,1486,70188,90,0.00128227,0.02117171,0.01988944,2019,INHL
2011-03-01T00:00:00Z,1072,1228,58559,156,0.00266398,0.020970303,0.018306324,2011,NKTR
2012-02-29T00:00:00Z,1120,1320,59894,200,0.003339233,0.022038935,0.018699703,2012,NKTR
2013-03-01T00:00:00Z,1255,1394,65674,139,0.002116515,0.021226056,0.019109541,2013,NKTR
2014-02-27T00:00:00Z,1326,1328,66170,2,3.02E-05,0.020069518,0.020039293,2014,NKTR
2015-02-26T00:00:00Z,1308,1282,63974,-26,-0.000406415,0.020039391,0.020445806,2015,NKTR
2016-02-29T00:00:00Z,1273,1355,65216,82,0.00125736,0.02077711,0.01951975,2016,NKTR
2017-03-01T00:00:00Z,1283,1392,66395,109,0.00164169,0.020965434,0.019323744,2017,NKTR
2018-03-01T00:00:00Z,1378,1462,71933,84,0.001167753,0.020324469,0.019156715,2018,NKTR
2019-03-01T00:00:00Z,1396,1486,70188,90,0.00128227,0.02117171,0.01988944,2019,NKTR
2011-02-25T00:00:00Z,651,820,48001,169,0.00352076,0.017082977,0.013562217,2011,ESS
2012-02-27T00:00:00Z,680,855,50091,175,0.003493642,0.017068935,0.013575293,2012,ESS
2013-02-25T00:00:00Z,703,884,51742,181,0.003498125,0.017084767,0.013586641,2013,ESS
2014-02-26T00:00:00Z,807,1127,60030,320,0.005330668,0.018773946,0.013443278,2014,ESS
2015-03-02T00:00:00Z,838,1131,62533,293,0.004685526,0.01808645,0.013400924,2015,ESS
2016-02-26T00:00:00Z,869,1165,62223,296,0.004757083,0.01872298,0.013965897,2016,ESS
2017-02-24T00:00:00Z,899,1254,63461,355,0.005593987,0.019760168,0.014166181,2017,ESS
2018-02-22T00:00:00Z,1017,1291,68148,274,0.004020661,0.018944063,0.014923402,2018,ESS
2019-02-21T00:00:00Z,1059,1355,70452,296,0.004201442,0.019232953,0.015031511,2019,ESS
2010-02-26T00:00:00Z,1065,1245,68492,180,0.002628044,0.018177305,0.015549261,2010,AIV
2011-02-25T00:00:00Z,1048,1284,68638,236,0.003438329,0.018706839,0.01526851,2011,AIV
2012-02-23T00:00:00Z,1027,1200,61628,173,0.002807166,0.019471669,0.016664503,2012,AIV
2013-02-25T00:00:00Z,989,1220,57753,231,0.003999792,0.021124444,0.017124652,2013,AIV
2014-02-21T00:00:00Z,917,1140,54289,223,0.004107646,0.020998729,0.016891083,2014,AIV
2015-02-27T00:00:00Z,893,1171,56997,278,0.00487745,0.020544941,0.015667491,2015,AIV
2016-02-29T00:00:00Z,865,1180,56573,315,0.005568027,0.020858006,0.015289979,2016,AIV
2017-02-24T00:00:00Z,822,1191,54710,369,0.006744654,0.021769329,0.015024676,2017,AIV
2018-03-01T00:00:00Z,848,1212,56862,364,0.006401463,0.021314762,0.014913299,2018,AIV
2019-02-20T00:00:00Z,822,1203,55803,381,0.00682759,0.021557981,0.014730391,2019,AIV
2011-02-10T00:00:00Z,593,883,79862,290,0.003631264,0.011056573,0.007425309,2011,O
2012-02-13T00:00:00Z,613,1002,86266,389,0.004509308,0.011615237,0.007105928,2012,O
2013-02-14T00:00:00Z,722,1205,102409,483,0.004716382,0.011766544,0.007050162,2013,O
2014-02-14T00:00:00Z,681,1191,113120,510,0.004508487,0.010528642,0.006020156,2014,O
2015-02-18T00:00:00Z,722,1279,118844,557,0.004686816,0.010762007,0.006075191,2015,O
2016-02-11T00:00:00Z,694,1168,118183,474,0.004010729,0.009882978,0.005872249,2016,O
2017-02-23T00:00:00Z,718,1224,123477,506,0.004097929,0.009912777,0.005814848,2017,O
2018-02-22T00:00:00Z,737,1279,127864,542,0.004238879,0.010002815,0.005763937,2018,O
2019-02-22T00:00:00Z,784,1480,88134,696,0.007897066,0.016792611,0.008895545,2019,O
2011-03-01T00:00:00Z,2548,2656,122144,108,0.000884202,0.021744826,0.020860624,2011,COF
2012-02-29T00:00:00Z,2871,2766,136800,-105,-0.000767544,0.020219298,0.020986842,2012,COF
2013-02-28T00:00:00Z,2823,2915,142154,92,0.000647185,0.02050593,0.019858745,2013,COF
2014-02-27T00:00:00Z,980,764,51985,-216,-0.004155045,0.014696547,0.018851592,2014,COF
2015-02-24T00:00:00Z,2631,2714,129108,83,0.000642873,0.021021161,0.020378288,2015,COF
2016-02-25T00:00:00Z,2633,2617,125865,-16,-0.00012712,0.020792119,0.020919239,2016,COF
2017-02-23T00:00:00Z,2639,2581,124144,-58,-0.000467199,0.020790372,0.021257572,2017,COF
2018-02-21T00:00:00Z,2473,2519,118368,46,0.000388619,0.021281089,0.020892471,2018,COF
2019-02-20T00:00:00Z,2385,2338,116899,-47,-0.000402056,0.020000171,0.020402228,2019,COF
2010-05-04T00:00:00Z,1047,1182,60455,135,0.002233066,0.019551733,0.017318667,2010,MCK
2011-05-05T00:00:00Z,1135,1230,62509,95,0.001519781,0.019677166,0.018157385,2011,MCK
2012-05-02T00:00:00Z,1136,1257,62499,121,0.001936031,0.020112322,0.018176291,2012,MCK
2013-05-07T00:00:00Z,1075,1414,63655,339,0.005325583,0.022213495,0.016887911,2013,MCK
2014-05-14T00:00:00Z,1128,1512,66363,384,0.005786357,0.02278378,0.016997423,2014,MCK
2015-05-12T00:00:00Z,1135,1507,64628,372,0.005756019,0.023318066,0.017562047,2015,MCK
2016-05-05T00:00:00Z,1184,1589,66668,405,0.006074879,0.023834523,0.017759645,2016,MCK
2017-05-22T00:00:00Z,1277,1841,71946,564,0.007839213,0.025588636,0.017749423,2017,MCK
2018-05-24T00:00:00Z,1378,2056,78996,678,0.008582713,0.026026634,0.017443921,2018,MCK
2019-05-15T00:00:00Z,1311,1810,73213,499,0.006815729,0.024722385,0.017906656,2019,MCK
2012-03-15T00:00:00Z,324,521,29828,197,0.006604533,0.01746681,0.010862277,2012,DLTR
2013-03-15T00:00:00Z,342,550,30936,208,0.006723558,0.01777864,0.011055081,2013,DLTR
2014-03-14T00:00:00Z,342,513,29902,171,0.005718681,0.017156043,0.011437362,2014,DLTR
2015-03-13T00:00:00Z,477,709,38193,232,0.006074412,0.018563611,0.0124892,2015,DLTR
2016-03-28T00:00:00Z,525,836,44029,311,0.007063526,0.018987486,0.011923959,2016,DLTR
2017-03-28T00:00:00Z,599,917,49764,318,0.006390162,0.018426975,0.012036814,2017,DLTR
2018-03-16T00:00:00Z,603,939,49025,336,0.006853646,0.019153493,0.012299847,2018,DLTR
2019-03-27T00:00:00Z,633,908,42438,275,0.006480041,0.021395919,0.014915877,2019,DLTR
2009-11-25T00:00:00Z,781,1035,54841,254,0.004631571,0.018872741,0.01424117,2009,ABC
2010-11-23T00:00:00Z,713,960,49406,247,0.004999393,0.019430838,0.014431446,2010,ABC
2011-11-22T00:00:00Z,625,936,46219,311,0.006728834,0.020251412,0.013522577,2011,ABC
2012-11-27T00:00:00Z,665,907,46196,242,0.005238549,0.019633735,0.014395186,2012,ABC
2013-11-26T00:00:00Z,785,1001,49236,216,0.004387034,0.020330652,0.015943618,2013,ABC
2014-11-25T00:00:00Z,821,988,50076,167,0.003334931,0.01973001,0.016395079,2014,ABC
2015-11-24T00:00:00Z,865,1020,53892,155,0.002876123,0.018926742,0.01605062,2015,ABC
2016-11-22T00:00:00Z,862,1069,56106,207,0.003689445,0.019053221,0.015363776,2016,ABC
2017-11-21T00:00:00Z,861,1080,54784,219,0.003997518,0.019713785,0.015716268,2017,ABC
2018-11-20T00:00:00Z,910,1178,58912,268,0.004549158,0.019995926,0.015446768,2018,ABC
2004-03-30T00:00:00Z,653,921,51473,268,0.005206613,0.017892876,0.012686263,2004,WMIH
2005-03-16T00:00:00Z,796,1084,58840,288,0.00489463,0.018422842,0.013528212,2005,WMIH
2006-03-15T00:00:00Z,991,1288,67365,297,0.004408818,0.019119721,0.014710903,2006,WMIH
2007-04-02T00:00:00Z,934,1293,65331,359,0.005495094,0.019791523,0.014296429,2007,WMIH
2008-04-29T00:00:00Z,669,906,44793,237,0.005291005,0.020226375,0.014935369,2008,WMIH
2009-03-31T00:00:00Z,644,898,42510,254,0.005975065,0.021124441,0.015149377,2009,WMIH
2008-02-29T00:00:00Z,1853,2312,96389,459,0.004761954,0.023986139,0.019224185,2008,COOP
2013-03-15T00:00:00Z,740,969,42132,229,0.005435299,0.022999146,0.017563847,2013,COOP
2014-03-14T00:00:00Z,744,979,44164,235,0.005321076,0.022167376,0.0168463,2014,COOP
2015-02-27T00:00:00Z,804,1128,49906,324,0.006492205,0.022602493,0.016110287,2015,COOP
2016-03-11T00:00:00Z,258,263,12828,5,0.000389772,0.020502027,0.020112254,2016,COOP
2017-03-14T00:00:00Z,827,1129,50714,302,0.005954963,0.022262097,0.016307134,2017,COOP
2018-03-02T00:00:00Z,865,1254,54578,389,0.007127414,0.022976291,0.015848877,2018,COOP
2019-03-11T00:00:00Z,1237,1905,89180,668,0.007490469,0.021361292,0.013870823,2019,COOP
2010-07-23T00:00:00Z,379,416,19247,37,0.001922378,0.021613758,0.01969138,2010,DRI
2011-07-22T00:00:00Z,435,480,20629,45,0.002181395,0.023268215,0.02108682,2011,DRI
2012-07-20T00:00:00Z,473,615,23907,142,0.005939683,0.025724683,0.019785,2012,DRI
2013-07-19T00:00:00Z,473,599,24469,126,0.005149373,0.024479954,0.019330582,2013,DRI
2014-07-18T00:00:00Z,486,596,25301,110,0.004347654,0.023556381,0.019208727,2014,DRI
2015-07-24T00:00:00Z,474,566,23945,92,0.003842138,0.023637503,0.019795364,2015,DRI
2016-07-25T00:00:00Z,477,533,21742,56,0.00257566,0.024514764,0.021939104,2016,DRI
2017-07-21T00:00:00Z,930,1284,49986,354,0.007081983,0.025687192,0.018605209,2017,DRI
2018-07-20T00:00:00Z,938,1333,51438,395,0.007679148,0.025914693,0.018235546,2018,DRI
2010-02-24T00:00:00Z,653,808,41117,155,0.00376973,0.019651239,0.015881509,2010,WAB
2011-02-25T00:00:00Z,665,777,40256,112,0.002782194,0.019301471,0.016519277,2011,WAB
2012-02-24T00:00:00Z,657,785,41391,128,0.00309246,0.018965476,0.015873016,2012,WAB
2013-02-22T00:00:00Z,633,782,41227,149,0.003614136,0.018968152,0.015354016,2013,WAB
2014-02-21T00:00:00Z,602,792,41310,190,0.004599371,0.019172113,0.014572743,2014,WAB
2015-02-20T00:00:00Z,595,785,40443,190,0.00469797,0.019410034,0.014712064,2015,WAB
2016-02-19T00:00:00Z,586,761,40743,175,0.004295216,0.018678055,0.014382839,2016,WAB
2017-02-28T00:00:00Z,668,944,47491,276,0.005811627,0.01987745,0.014065823,2017,WAB
2018-02-26T00:00:00Z,706,1002,47273,296,0.006261502,0.021196032,0.014934529,2018,WAB
2019-02-27T00:00:00Z,855,1097,54381,242,0.004450084,0.020172487,0.015722403,2019,WAB
2012-02-23T00:00:00Z,1623,1774,88481,151,0.001706581,0.020049502,0.018342921,2012,DISH
2013-02-20T00:00:00Z,1904,2026,105734,122,0.001153839,0.019161292,0.018007453,2013,DISH
2014-02-21T00:00:00Z,2174,1919,111510,-255,-0.00228679,0.017209219,0.019496009,2014,DISH
2015-02-23T00:00:00Z,1976,1959,111299,-17,-0.000152742,0.017601236,0.017753978,2015,DISH
2016-02-18T00:00:00Z,1993,2022,110095,29,0.000263409,0.018365957,0.018102548,2016,DISH
2017-02-22T00:00:00Z,1977,2199,122441,222,0.001813118,0.01795967,0.016146552,2017,DISH
2018-02-21T00:00:00Z,2025,2172,119625,147,0.00122884,0.01815674,0.0169279,2018,DISH
2019-02-13T00:00:00Z,2007,2250,123697,243,0.001964478,0.018189608,0.016225131,2019,DISH
2010-08-17T00:00:00Z,709,1055,43459,346,0.007961527,0.024275754,0.016314227,2010,RMD
2011-08-17T00:00:00Z,619,1013,39983,394,0.009854188,0.025335768,0.01548158,2011,RMD
2012-08-14T00:00:00Z,576,1013,40462,437,0.010800257,0.025035836,0.014235579,2012,RMD
2013-08-13T00:00:00Z,558,959,39642,401,0.010115534,0.024191514,0.01407598,2013,RMD
2014-08-08T00:00:00Z,626,1002,40298,376,0.009330488,0.024864758,0.01553427,2014,RMD
2015-08-07T00:00:00Z,645,1008,40942,363,0.008866201,0.024620194,0.015753993,2015,RMD
2016-08-05T00:00:00Z,859,1155,48466,296,0.006107374,0.023831139,0.017723765,2016,RMD
2017-08-04T00:00:00Z,882,1210,51323,328,0.006390897,0.023576174,0.017185278,2017,RMD
2018-08-17T00:00:00Z,948,1232,53034,284,0.005355055,0.023230381,0.017875325,2018,RMD
2010-02-26T00:00:00Z,1003,1062,49477,59,0.001192473,0.021464519,0.020272046,2010,WABC
2011-02-28T00:00:00Z,1067,1106,51937,39,0.00075091,0.021295031,0.020544121,2011,WABC
2012-02-28T00:00:00Z,997,1056,48143,59,0.001225516,0.021934653,0.020709137,2012,WABC
2013-02-28T00:00:00Z,1011,1035,48950,24,0.000490296,0.021144025,0.020653728,2013,WABC
2014-02-27T00:00:00Z,1017,1049,49036,32,0.000652582,0.021392446,0.020739865,2014,WABC
2015-03-02T00:00:00Z,969,1019,47924,50,0.001043319,0.021262833,0.020219514,2015,WABC
2016-02-26T00:00:00Z,479,576,26224,97,0.003698902,0.021964613,0.018265711,2016,WABC
2017-02-28T00:00:00Z,479,574,25987,95,0.003655674,0.022087967,0.018432293,2017,WABC
2018-02-27T00:00:00Z,497,597,26448,100,0.003781004,0.022572595,0.018791591,2018,WABC
2019-02-28T00:00:00Z,569,617,27163,48,0.00176711,0.022714722,0.020947613,2019,WABC
2004-03-30T00:00:00Z,653,921,51473,268,0.005206613,0.017892876,0.012686263,2004,PLI
2005-03-16T00:00:00Z,796,1084,58840,288,0.00489463,0.018422842,0.013528212,2005,PLI
2006-03-15T00:00:00Z,991,1288,67365,297,0.004408818,0.019119721,0.014710903,2006,PLI
2007-04-02T00:00:00Z,934,1293,65331,359,0.005495094,0.019791523,0.014296429,2007,PLI
2008-04-29T00:00:00Z,669,906,44793,237,0.005291005,0.020226375,0.014935369,2008,PLI
2009-03-31T00:00:00Z,644,898,42510,254,0.005975065,0.021124441,0.015149377,2009,PLI
2010-03-01T00:00:00Z,2048,1771,76393,-277,-0.003625987,0.023182752,0.026808739,2010,RE
2011-03-01T00:00:00Z,2012,1804,75913,-208,-0.002739979,0.023764046,0.026504024,2011,RE
2012-02-29T00:00:00Z,2038,1849,76326,-189,-0.00247622,0.024225035,0.026701255,2012,RE
2013-03-01T00:00:00Z,2069,1823,76470,-246,-0.003216948,0.023839414,0.027056362,2013,RE
2014-03-03T00:00:00Z,2004,1785,74592,-219,-0.002935972,0.02393018,0.026866152,2014,RE
2015-03-02T00:00:00Z,1931,1683,71618,-248,-0.003462817,0.023499679,0.026962495,2015,RE
2016-02-29T00:00:00Z,1956,1798,74593,-158,-0.002118161,0.024104138,0.0262223,2016,RE
2017-03-01T00:00:00Z,2003,1851,77366,-152,-0.001964687,0.023925238,0.025889926,2017,RE
2018-03-01T00:00:00Z,1556,1577,64719,21,0.00032448,0.024366878,0.024042399,2018,RE
2019-03-01T00:00:00Z,2099,2058,83001,-41,-0.00049397,0.024794882,0.025288852,2019,RE
2012-02-24T00:00:00Z,1074,1659,73596,585,0.007948802,0.022541986,0.014593184,2012,DVA
2013-03-01T00:00:00Z,1717,2493,106311,776,0.007299339,0.023450066,0.016150728,2013,DVA
2014-02-21T00:00:00Z,1707,2455,105701,748,0.007076565,0.023225892,0.016149327,2014,DVA
2015-02-26T00:00:00Z,1762,2520,107512,758,0.007050376,0.023439244,0.016388868,2015,DVA
2016-02-26T00:00:00Z,1796,2603,107222,807,0.00752644,0.024276734,0.016750294,2016,DVA
2017-02-24T00:00:00Z,1852,2630,107159,778,0.007260239,0.024542969,0.017282729,2017,DVA
2018-02-23T00:00:00Z,1940,2546,102987,606,0.005884238,0.024721567,0.018837329,2018,DVA
2019-02-22T00:00:00Z,2039,2659,107707,620,0.005756358,0.024687346,0.018930989,2019,DVA
2010-02-23T00:00:00Z,791,1189,50867,398,0.007824326,0.023374683,0.015550357,2010,HSIC
2011-02-22T00:00:00Z,753,1151,50081,398,0.007947126,0.022982768,0.015035642,2011,HSIC
2012-02-15T00:00:00Z,849,1266,54290,417,0.007680973,0.023319212,0.015638239,2012,HSIC
2013-02-13T00:00:00Z,873,1232,54379,359,0.006601813,0.022655805,0.016053991,2013,HSIC
2014-02-11T00:00:00Z,850,1196,52629,346,0.006574322,0.022725114,0.016150791,2014,HSIC
2015-02-11T00:00:00Z,932,1238,55341,306,0.005529354,0.022370394,0.01684104,2015,HSIC
2016-02-10T00:00:00Z,1009,1358,60294,349,0.005788304,0.022522971,0.016734667,2016,HSIC
2017-02-21T00:00:00Z,1044,1400,62301,356,0.005714194,0.022471549,0.016757355,2017,HSIC
2018-02-21T00:00:00Z,1198,1541,68221,343,0.005027777,0.022588353,0.017560575,2018,HSIC
2019-02-20T00:00:00Z,1348,1648,73915,300,0.004058716,0.02229588,0.018237164,2019,HSIC
2009-06-17T00:00:00Z,1265,1574,71948,309,0.004294768,0.021876911,0.017582143,2009,NTAP
2010-06-18T00:00:00Z,1041,1312,59648,271,0.004543321,0.021995708,0.017452387,2010,NTAP
2011-06-23T00:00:00Z,1138,1463,67223,325,0.004834655,0.021763385,0.01692873,2011,NTAP
2012-06-19T00:00:00Z,1095,1397,64469,302,0.004684422,0.021669329,0.016984907,2012,NTAP
2013-06-17T00:00:00Z,941,1238,55642,297,0.005337695,0.02224938,0.016911685,2013,NTAP
2014-06-17T00:00:00Z,941,1204,53464,263,0.004919198,0.022519826,0.017600628,2014,NTAP
2015-06-12T00:00:00Z,986,1206,51208,220,0.004296204,0.023551008,0.019254804,2015,NTAP
2016-06-22T00:00:00Z,984,1252,53853,268,0.00497651,0.023248473,0.018271963,2016,NTAP
2017-06-20T00:00:00Z,947,1182,52468,235,0.00447892,0.022528017,0.018049097,2017,NTAP
2018-06-19T00:00:00Z,1020,1243,54313,223,0.004105831,0.022885865,0.018780034,2018,NTAP
2004-03-30T00:00:00Z,653,921,51473,268,0.005206613,0.017892876,0.012686263,2004,MSS
2005-03-16T00:00:00Z,796,1084,58840,288,0.00489463,0.018422842,0.013528212,2005,MSS
2006-03-15T00:00:00Z,991,1288,67365,297,0.004408818,0.019119721,0.014710903,2006,MSS
2007-04-02T00:00:00Z,934,1293,65331,359,0.005495094,0.019791523,0.014296429,2007,MSS
2008-04-29T00:00:00Z,669,906,44793,237,0.005291005,0.020226375,0.014935369,2008,MSS
2009-03-31T00:00:00Z,644,898,42510,254,0.005975065,0.021124441,0.015149377,2009,MSS
2004-03-30T00:00:00Z,653,921,51473,268,0.005206613,0.017892876,0.012686263,2004,MLSS
2005-03-16T00:00:00Z,796,1084,58840,288,0.00489463,0.018422842,0.013528212,2005,MLSS
2006-03-15T00:00:00Z,991,1288,67365,297,0.004408818,0.019119721,0.014710903,2006,MLSS
2007-04-02T00:00:00Z,934,1293,65331,359,0.005495094,0.019791523,0.014296429,2007,MLSS
2008-04-29T00:00:00Z,669,906,44793,237,0.005291005,0.020226375,0.014935369,2008,MLSS
2009-03-31T00:00:00Z,644,898,42510,254,0.005975065,0.021124441,0.015149377,2009,MLSS
2009-08-19T00:00:00Z,842,1483,64739,641,0.009901296,0.022907367,0.013006071,2009,EL
2010-08-20T00:00:00Z,830,1654,67255,824,0.012251877,0.024592967,0.01234109,2010,EL
2011-08-22T00:00:00Z,780,1568,65914,788,0.011954972,0.023788573,0.011833601,2011,EL
2012-08-17T00:00:00Z,757,1579,66132,822,0.012429686,0.023876489,0.011446803,2012,EL
2013-08-23T00:00:00Z,742,1594,66809,852,0.012752773,0.023859061,0.011106288,2013,EL
2014-08-20T00:00:00Z,732,1474,64487,742,0.011506195,0.02285732,0.011351125,2014,EL
2015-08-20T00:00:00Z,692,1307,61339,615,0.010026248,0.021307814,0.011281566,2015,EL
2016-08-24T00:00:00Z,749,1526,65576,777,0.011848847,0.023270709,0.011421862,2016,EL
2017-08-25T00:00:00Z,699,1643,69243,944,0.013633147,0.02372803,0.010094883,2017,EL
2018-08-24T00:00:00Z,671,1684,67125,1013,0.015091248,0.025087523,0.009996276,2018,EL
2012-02-23T00:00:00Z,812,1589,61611,777,0.012611384,0.025790849,0.013179465,2012,CTXS
2013-02-21T00:00:00Z,875,1535,63557,660,0.010384379,0.024151549,0.01376717,2013,CTXS
2014-02-20T00:00:00Z,897,1485,59410,588,0.009897324,0.024995792,0.015098468,2014,CTXS
2015-02-19T00:00:00Z,920,1574,64814,654,0.010090413,0.024284877,0.014194464,2015,CTXS
2016-02-18T00:00:00Z,956,1651,67217,695,0.010339646,0.024562239,0.014222592,2016,CTXS
2017-02-16T00:00:00Z,911,1542,66107,631,0.009545131,0.02332582,0.013780689,2017,CTXS
2018-02-16T00:00:00Z,996,1529,66659,533,0.00799592,0.022937638,0.014941718,2018,CTXS
2019-02-15T00:00:00Z,1029,1562,65862,533,0.008092679,0.023716255,0.015623577,2019,CTXS
2011-02-25T00:00:00Z,4559,3557,153811,-1002,-0.006514489,0.023125784,0.029640273,2011,HIG
2012-02-24T00:00:00Z,4800,3455,153094,-1345,-0.008785452,0.022567834,0.031353286,2012,HIG
2013-03-01T00:00:00Z,4645,3330,143783,-1315,-0.009145727,0.023159901,0.032305627,2013,HIG
2014-02-28T00:00:00Z,4754,3286,140549,-1468,-0.010444756,0.023379747,0.033824502,2014,HIG
2015-02-27T00:00:00Z,4605,3245,137013,-1360,-0.009926065,0.023683884,0.033609949,2015,HIG
2016-02-26T00:00:00Z,4537,3167,132231,-1370,-0.010360657,0.023950511,0.034311168,2016,HIG
2017-02-24T00:00:00Z,4254,2980,129361,-1274,-0.009848409,0.023036309,0.032884718,2017,HIG
2018-02-23T00:00:00Z,4035,2738,123501,-1297,-0.010501939,0.022169861,0.0326718,2018,HIG
2019-02-22T00:00:00Z,4053,2752,132104,-1301,-0.009848301,0.020832072,0.030680373,2019,HIG
2012-02-17T00:00:00Z,1370,1431,61147,61,0.000997596,0.02340262,0.022405024,2012,ALXN
2013-02-19T00:00:00Z,1451,1486,65388,35,0.000535266,0.022725882,0.022190616,2013,ALXN
2014-02-10T00:00:00Z,1562,1731,72871,169,0.002319167,0.023754306,0.021435139,2014,ALXN
2015-02-06T00:00:00Z,1659,1778,78674,119,0.001512571,0.022599588,0.021087017,2015,ALXN
2016-02-08T00:00:00Z,1542,1715,76851,173,0.002251109,0.02231591,0.020064801,2016,ALXN
2017-02-16T00:00:00Z,1614,1769,78305,155,0.001979439,0.02259115,0.020611711,2017,ALXN
2018-02-08T00:00:00Z,1558,1871,80907,313,0.003868639,0.023125317,0.019256677,2018,ALXN
2019-02-06T00:00:00Z,1768,2170,91466,402,0.004395076,0.023724663,0.019329587,2019,ALXN
2010-02-26T00:00:00Z,827,1283,57550,456,0.007923545,0.022293658,0.014370113,2010,IRM
2011-03-01T00:00:00Z,974,1395,63544,421,0.00662533,0.021953292,0.015327962,2011,IRM
2012-02-28T00:00:00Z,1263,1540,71787,277,0.003858637,0.021452352,0.017593715,2012,IRM
2013-03-01T00:00:00Z,1196,1553,70981,357,0.005029515,0.021879094,0.016849579,2013,IRM
2014-02-28T00:00:00Z,1215,1683,73801,468,0.006341377,0.022804569,0.016463192,2014,IRM
2015-02-27T00:00:00Z,1290,1647,80217,357,0.004450428,0.020531807,0.016081379,2015,IRM
2016-02-26T00:00:00Z,1290,1716,84756,426,0.005026193,0.020246354,0.015220161,2016,IRM
2017-02-23T00:00:00Z,1258,1749,92099,491,0.00533122,0.018990434,0.013659215,2017,IRM
2018-02-16T00:00:00Z,1408,1991,104192,583,0.005595439,0.019108953,0.013513514,2018,IRM
2019-02-14T00:00:00Z,1358,1794,95508,436,0.004565063,0.018783767,0.014218704,2019,IRM
2011-02-25T00:00:00Z,491,884,42469,393,0.009253809,0.020815183,0.011561374,2011,ANSS
2012-02-23T00:00:00Z,528,958,44813,430,0.00959543,0.021377725,0.011782295,2012,ANSS
2013-02-28T00:00:00Z,575,1034,47016,459,0.009762634,0.021992513,0.012229879,2013,ANSS
2014-02-27T00:00:00Z,499,934,42246,435,0.010296833,0.022108602,0.011811769,2014,ANSS
2015-02-26T00:00:00Z,528,963,43304,435,0.010045261,0.02223813,0.012192869,2015,ANSS
2016-02-25T00:00:00Z,531,953,42663,422,0.009891475,0.022337857,0.012446382,2016,ANSS
2017-02-23T00:00:00Z,541,1020,44084,479,0.01086562,0.023137646,0.012272026,2017,ANSS
2018-02-22T00:00:00Z,570,1064,46077,494,0.010721184,0.023091781,0.012370597,2018,ANSS
2019-02-28T00:00:00Z,587,1160,50455,573,0.011356654,0.022990784,0.011634129,2019,ANSS
2011-02-22T00:00:00Z,2125,1929,85862,-196,-0.002282733,0.022466283,0.024749016,2011,EGRP
2012-02-23T00:00:00Z,1927,1865,83889,-62,-0.000739072,0.022231759,0.022970831,2012,EGRP
2013-02-26T00:00:00Z,2122,1961,90483,-161,-0.00177934,0.021672579,0.023451919,2013,EGRP
2014-02-25T00:00:00Z,2100,2058,92196,-42,-0.000455551,0.02232201,0.022777561,2014,EGRP
2015-02-24T00:00:00Z,2153,1988,89614,-165,-0.00184123,0.022184034,0.024025264,2015,EGRP
2016-02-24T00:00:00Z,1908,1903,82538,-5,-6.06E-05,0.023056047,0.023116625,2016,EGRP
2017-02-22T00:00:00Z,1710,1710,74679,0,0,0.022898003,0.022898003,2017,EGRP
2018-02-21T00:00:00Z,1470,1603,66615,133,0.001996547,0.024063649,0.022067102,2018,EGRP
2019-02-20T00:00:00Z,1393,1712,70064,319,0.00455298,0.024434802,0.019881822,2019,EGRP
2011-02-22T00:00:00Z,2125,1929,85862,-196,-0.002282733,0.022466283,0.024749016,2011,ET
2012-02-23T00:00:00Z,1927,1865,83889,-62,-0.000739072,0.022231759,0.022970831,2012,ET
2013-02-26T00:00:00Z,2122,1961,90483,-161,-0.00177934,0.021672579,0.023451919,2013,ET
2014-02-25T00:00:00Z,2100,2058,92196,-42,-0.000455551,0.02232201,0.022777561,2014,ET
2015-02-24T00:00:00Z,2153,1988,89614,-165,-0.00184123,0.022184034,0.024025264,2015,ET
2016-02-24T00:00:00Z,1908,1903,82538,-5,-6.06E-05,0.023056047,0.023116625,2016,ET
2017-02-22T00:00:00Z,1710,1710,74679,0,0,0.022898003,0.022898003,2017,ET
2018-02-21T00:00:00Z,1470,1603,66615,133,0.001996547,0.024063649,0.022067102,2018,ET
2019-02-20T00:00:00Z,1393,1712,70064,319,0.00455298,0.024434802,0.019881822,2019,ET
2011-02-22T00:00:00Z,2125,1929,85862,-196,-0.002282733,0.022466283,0.024749016,2011,ETFC
2012-02-23T00:00:00Z,1927,1865,83889,-62,-0.000739072,0.022231759,0.022970831,2012,ETFC
2013-02-26T00:00:00Z,2122,1961,90483,-161,-0.00177934,0.021672579,0.023451919,2013,ETFC
2014-02-25T00:00:00Z,2100,2058,92196,-42,-0.000455551,0.02232201,0.022777561,2014,ETFC
2015-02-24T00:00:00Z,2153,1988,89614,-165,-0.00184123,0.022184034,0.024025264,2015,ETFC
2016-02-24T00:00:00Z,1908,1903,82538,-5,-6.06E-05,0.023056047,0.023116625,2016,ETFC
2017-02-22T00:00:00Z,1710,1710,74679,0,0,0.022898003,0.022898003,2017,ETFC
2018-02-21T00:00:00Z,1470,1603,66615,133,0.001996547,0.024063649,0.022067102,2018,ETFC
2019-02-20T00:00:00Z,1393,1712,70064,319,0.00455298,0.024434802,0.019881822,2019,ETFC
2002-03-29T00:00:00Z,427,533,28479,106,0.003722041,0.018715545,0.014993504,2002,LTBG
2003-03-31T00:00:00Z,504,630,33175,126,0.003798041,0.018990203,0.015192163,2003,LTBG
2004-03-15T00:00:00Z,503,626,33616,123,0.003658972,0.018622085,0.014963113,2004,LTBG
2005-03-17T00:00:00Z,791,972,48753,181,0.003712592,0.019937235,0.016224643,2005,LTBG
2006-03-24T00:00:00Z,924,986,48053,62,0.001290242,0.02051901,0.019228768,2006,LTBG
2007-03-15T00:00:00Z,680,925,42400,245,0.005778302,0.021816038,0.016037736,2007,LTBG
2010-02-26T00:00:00Z,747,1172,52865,425,0.008039346,0.022169677,0.014130332,2010,NOI
2011-02-23T00:00:00Z,730,1134,51215,404,0.007888314,0.022141951,0.014253637,2011,NOI
2012-02-23T00:00:00Z,783,1237,54259,454,0.008367275,0.022798061,0.014430786,2012,NOI
2013-02-22T00:00:00Z,759,1203,54550,444,0.008139322,0.022053162,0.013913841,2013,NOI
2014-02-14T00:00:00Z,792,1285,57045,493,0.0086423,0.022526076,0.013883776,2014,NOI
2015-02-17T00:00:00Z,171,229,12647,58,0.004586068,0.018107061,0.013520993,2015,NOI
2016-02-19T00:00:00Z,216,243,12581,27,0.002146093,0.01931484,0.017168747,2016,NOI
2017-02-17T00:00:00Z,235,255,13424,20,0.001489869,0.018995828,0.017505959,2017,NOI
2018-02-16T00:00:00Z,251,313,14343,62,0.004322666,0.021822492,0.017499826,2018,NOI
2019-02-14T00:00:00Z,736,1136,43817,400,0.009128877,0.02592601,0.016797134,2019,NOI
2010-02-26T00:00:00Z,747,1172,52865,425,0.008039346,0.022169677,0.014130332,2010,NOV
2011-02-23T00:00:00Z,730,1134,51215,404,0.007888314,0.022141951,0.014253637,2011,NOV
2012-02-23T00:00:00Z,783,1237,54259,454,0.008367275,0.022798061,0.014430786,2012,NOV
2013-02-22T00:00:00Z,759,1203,54550,444,0.008139322,0.022053162,0.013913841,2013,NOV
2014-02-14T00:00:00Z,792,1285,57045,493,0.0086423,0.022526076,0.013883776,2014,NOV
2015-02-17T00:00:00Z,171,229,12647,58,0.004586068,0.018107061,0.013520993,2015,NOV
2016-02-19T00:00:00Z,216,243,12581,27,0.002146093,0.01931484,0.017168747,2016,NOV
2017-02-17T00:00:00Z,235,255,13424,20,0.001489869,0.018995828,0.017505959,2017,NOV
2018-02-16T00:00:00Z,251,313,14343,62,0.004322666,0.021822492,0.017499826,2018,NOV
2019-02-14T00:00:00Z,736,1136,43817,400,0.009128877,0.02592601,0.016797134,2019,NOV
2008-02-21T00:00:00Z,826,956,45654,130,0.002847505,0.020940115,0.01809261,2008,TMPW
2009-02-12T00:00:00Z,878,1022,47160,144,0.003053435,0.021670908,0.018617472,2009,TMPW
2010-02-04T00:00:00Z,853,1258,51854,405,0.007810391,0.024260423,0.016450033,2010,TMPW
2011-02-02T00:00:00Z,890,1120,47561,230,0.004835895,0.023548706,0.018712811,2011,TMPW
2012-01-31T00:00:00Z,844,1138,47712,294,0.006161972,0.023851442,0.01768947,2012,TMPW
2013-02-13T00:00:00Z,977,1156,47977,179,0.003730954,0.024094879,0.020363924,2013,TMPW
2014-02-10T00:00:00Z,294,164,9087,-130,-0.014306152,0.018047761,0.032353912,2014,TMPW
2015-02-10T00:00:00Z,335,207,10517,-128,-0.012170771,0.019682419,0.03185319,2015,TMPW
2016-02-11T00:00:00Z,1134,1255,52181,121,0.002318852,0.0240509,0.021732048,2016,TMPW
2008-02-21T00:00:00Z,826,956,45654,130,0.002847505,0.020940115,0.01809261,2008,MNST
2009-02-12T00:00:00Z,878,1022,47160,144,0.003053435,0.021670908,0.018617472,2009,MNST
2010-02-04T00:00:00Z,853,1258,51854,405,0.007810391,0.024260423,0.016450033,2010,MNST
2011-02-02T00:00:00Z,890,1120,47561,230,0.004835895,0.023548706,0.018712811,2011,MNST
2012-01-31T00:00:00Z,844,1138,47712,294,0.006161972,0.023851442,0.01768947,2012,MNST
2013-02-13T00:00:00Z,977,1156,47977,179,0.003730954,0.024094879,0.020363924,2013,MNST
2014-02-10T00:00:00Z,294,164,9087,-130,-0.014306152,0.018047761,0.032353912,2014,MNST
2015-02-10T00:00:00Z,335,207,10517,-128,-0.012170771,0.019682419,0.03185319,2015,MNST
2016-02-11T00:00:00Z,1134,1255,52181,121,0.002318852,0.0240509,0.021732048,2016,MNST
2008-02-21T00:00:00Z,826,956,45654,130,0.002847505,0.020940115,0.01809261,2008,MWW
2009-02-12T00:00:00Z,878,1022,47160,144,0.003053435,0.021670908,0.018617472,2009,MWW
2010-02-04T00:00:00Z,853,1258,51854,405,0.007810391,0.024260423,0.016450033,2010,MWW
2011-02-02T00:00:00Z,890,1120,47561,230,0.004835895,0.023548706,0.018712811,2011,MWW
2012-01-31T00:00:00Z,844,1138,47712,294,0.006161972,0.023851442,0.01768947,2012,MWW
2013-02-13T00:00:00Z,977,1156,47977,179,0.003730954,0.024094879,0.020363924,2013,MWW
2014-02-10T00:00:00Z,294,164,9087,-130,-0.014306152,0.018047761,0.032353912,2014,MWW
2015-02-10T00:00:00Z,335,207,10517,-128,-0.012170771,0.019682419,0.03185319,2015,MWW
2016-02-11T00:00:00Z,1134,1255,52181,121,0.002318852,0.0240509,0.021732048,2016,MWW
2009-11-18T00:00:00Z,663,991,44248,328,0.007412764,0.022396492,0.014983728,2009,ROK
2010-11-18T00:00:00Z,618,987,42513,369,0.008679698,0.023216428,0.01453673,2010,ROK
2011-11-14T00:00:00Z,588,914,40037,326,0.008142468,0.022828883,0.014686415,2011,ROK
2012-11-19T00:00:00Z,545,841,39235,296,0.007544284,0.021434943,0.013890659,2012,ROK
2013-11-18T00:00:00Z,561,892,39635,331,0.008351205,0.022505361,0.014154157,2013,ROK
2014-11-18T00:00:00Z,570,859,39173,289,0.00737753,0.021928369,0.014550839,2014,ROK
2015-11-17T00:00:00Z,605,874,39546,269,0.006802205,0.022100845,0.01529864,2015,ROK
2016-11-15T00:00:00Z,573,857,38753,284,0.007328465,0.022114417,0.014785952,2016,ROK
2017-11-15T00:00:00Z,571,887,39106,316,0.008080601,0.022681941,0.01460134,2017,ROK
2018-11-09T00:00:00Z,623,957,41380,334,0.008071532,0.023127115,0.015055582,2018,ROK
2010-04-07T00:00:00Z,418,597,32801,179,0.005457151,0.018200665,0.012743514,2010,CME
2011-03-29T00:00:00Z,406,555,30100,149,0.004950166,0.018438538,0.013488372,2011,CME
2012-03-16T00:00:00Z,390,617,31228,227,0.007269117,0.01975791,0.012488792,2012,CME
2013-03-27T00:00:00Z,382,593,30310,211,0.006961399,0.0195645,0.012603101,2013,CME
2014-03-20T00:00:00Z,394,561,28847,167,0.005789164,0.01944743,0.013658266,2014,CME
2015-03-13T00:00:00Z,417,600,30809,183,0.005939823,0.019474829,0.013535006,2015,CME
2016-03-11T00:00:00Z,424,664,32725,240,0.007333843,0.020290298,0.012956455,2016,CME
2017-03-09T00:00:00Z,446,677,32503,231,0.007107036,0.020828847,0.01372181,2017,CME
2018-03-07T00:00:00Z,502,731,34859,229,0.006569322,0.020970194,0.014400872,2018,CME
2019-03-18T00:00:00Z,635,891,38553,256,0.00664021,0.023111042,0.016470832,2019,CME
2010-04-07T00:00:00Z,418,597,32801,179,0.005457151,0.018200665,0.012743514,2010,CMT
2011-03-29T00:00:00Z,406,555,30100,149,0.004950166,0.018438538,0.013488372,2011,CMT
2012-03-16T00:00:00Z,390,617,31228,227,0.007269117,0.01975791,0.012488792,2012,CMT
2013-03-27T00:00:00Z,382,593,30310,211,0.006961399,0.0195645,0.012603101,2013,CMT
2014-03-20T00:00:00Z,394,561,28847,167,0.005789164,0.01944743,0.013658266,2014,CMT
2015-03-13T00:00:00Z,417,600,30809,183,0.005939823,0.019474829,0.013535006,2015,CMT
2016-03-11T00:00:00Z,424,664,32725,240,0.007333843,0.020290298,0.012956455,2016,CMT
2017-03-09T00:00:00Z,446,677,32503,231,0.007107036,0.020828847,0.01372181,2017,CMT
2018-03-07T00:00:00Z,502,731,34859,229,0.006569322,0.020970194,0.014400872,2018,CMT
2019-03-18T00:00:00Z,635,891,38553,256,0.00664021,0.023111042,0.016470832,2019,CMT
2011-05-25T00:00:00Z,902,996,51349,94,0.00183061,0.019396678,0.017566067,2011,TTWO
2012-05-23T00:00:00Z,950,1112,53697,162,0.003016928,0.020708792,0.017691864,2012,TTWO
2013-05-14T00:00:00Z,974,1123,53538,149,0.00278307,0.020975756,0.018192686,2013,TTWO
2014-05-14T00:00:00Z,1051,1176,55957,125,0.002233858,0.021016137,0.018782279,2014,TTWO
2015-05-22T00:00:00Z,1052,1197,55838,145,0.002596798,0.021437014,0.018840216,2015,TTWO
2016-05-19T00:00:00Z,1024,1266,56335,242,0.004295731,0.022472708,0.018176977,2016,TTWO
2017-05-24T00:00:00Z,1013,1352,58416,339,0.005803205,0.023144344,0.017341139,2017,TTWO
2018-05-17T00:00:00Z,1000,1282,54996,282,0.005127646,0.023310786,0.018183141,2018,TTWO
2019-05-14T00:00:00Z,995,1354,58386,359,0.006148734,0.023190491,0.017041757,2019,TTWO
2010-03-01T00:00:00Z,969,1293,59712,324,0.005426045,0.021653939,0.016227894,2010,ARE
2011-03-01T00:00:00Z,1125,1381,68790,256,0.003721471,0.020075592,0.016354121,2011,ARE
2012-02-21T00:00:00Z,1314,1555,76990,241,0.003130277,0.020197428,0.017067152,2012,ARE
2013-02-26T00:00:00Z,1409,1708,87883,299,0.003402251,0.019434931,0.01603268,2013,ARE
2014-03-03T00:00:00Z,1320,1599,80450,279,0.003467993,0.019875699,0.016407707,2014,ARE
2015-02-24T00:00:00Z,1405,1663,85360,258,0.003022493,0.019482193,0.0164597,2015,ARE
2016-02-03T00:00:00Z,1459,1817,89149,358,0.004015749,0.020381608,0.016365859,2016,ARE
2017-01-31T00:00:00Z,1640,1920,92755,280,0.003018705,0.020699693,0.017680988,2017,ARE
2018-01-30T00:00:00Z,1715,2230,100928,515,0.005102647,0.022094959,0.016992311,2018,ARE
2019-02-05T00:00:00Z,1838,2302,106320,464,0.004364184,0.021651618,0.017287434,2019,ARE
2004-03-30T00:00:00Z,653,921,51473,268,0.005206613,0.017892876,0.012686263,2004,APH
2005-03-16T00:00:00Z,796,1084,58840,288,0.00489463,0.018422842,0.013528212,2005,APH
2006-03-15T00:00:00Z,991,1288,67365,297,0.004408818,0.019119721,0.014710903,2006,APH
2007-04-02T00:00:00Z,934,1293,65331,359,0.005495094,0.019791523,0.014296429,2007,APH
2008-04-29T00:00:00Z,669,906,44793,237,0.005291005,0.020226375,0.014935369,2008,APH
2009-03-31T00:00:00Z,644,898,42510,254,0.005975065,0.021124441,0.015149377,2009,APH
2011-01-28T00:00:00Z,668,786,33187,118,0.003555609,0.023683973,0.020128364,2011,AMZN
2012-02-01T00:00:00Z,734,825,36294,91,0.002507301,0.02273103,0.020223728,2012,AMZN
2013-01-30T00:00:00Z,827,851,37766,24,0.000635492,0.022533496,0.021898003,2013,AMZN
2014-01-31T00:00:00Z,815,837,37278,22,0.00059016,0.022452921,0.021862761,2014,AMZN
2015-01-30T00:00:00Z,833,901,40031,68,0.001698684,0.022507557,0.020808873,2015,AMZN
2016-01-29T00:00:00Z,745,886,39359,141,0.003582408,0.022510735,0.018928326,2016,AMZN
2017-02-10T00:00:00Z,746,878,39441,132,0.003346771,0.022261099,0.018914328,2017,AMZN
2018-02-02T00:00:00Z,709,940,41657,231,0.005545287,0.022565235,0.017019949,2018,AMZN
2019-02-01T00:00:00Z,704,873,38890,169,0.00434559,0.02244793,0.01810234,2019,AMZN
2005-06-14T00:00:00Z,590,880,46073,290,0.006294359,0.019100124,0.012805765,2005,RFMD
2006-05-31T00:00:00Z,529,859,43525,330,0.00758185,0.019735784,0.012153935,2006,RFMD
2007-05-30T00:00:00Z,614,1033,47964,419,0.008735718,0.021536986,0.012801268,2007,RFMD
2008-05-28T00:00:00Z,613,1090,50614,477,0.00942427,0.021535544,0.012111274,2008,RFMD
2009-05-27T00:00:00Z,768,1515,64434,747,0.011593258,0.023512431,0.011919173,2009,RFMD
2010-06-02T00:00:00Z,761,1464,60738,703,0.011574303,0.024103527,0.012529224,2010,RFMD
2011-06-01T00:00:00Z,663,1195,51857,532,0.010258981,0.023044141,0.012785159,2011,RFMD
2012-05-25T00:00:00Z,665,1133,49674,468,0.009421428,0.022808713,0.013387285,2012,RFMD
2013-05-24T00:00:00Z,701,1150,50517,449,0.008888097,0.022764614,0.013876517,2013,RFMD
2014-05-21T00:00:00Z,981,1839,74943,858,0.011448701,0.024538649,0.013089948,2014,RFMD
2015-05-27T00:00:00Z,749,1257,51917,508,0.009784849,0.024211723,0.014426874,2015,QRVO
2016-05-31T00:00:00Z,860,1489,59700,629,0.010536013,0.024941374,0.01440536,2016,QRVO
2017-05-23T00:00:00Z,868,1425,59325,557,0.009388959,0.024020228,0.014631268,2017,QRVO
2018-05-21T00:00:00Z,866,1418,58422,552,0.009448495,0.024271678,0.014823183,2018,QRVO
2019-05-17T00:00:00Z,852,1196,52926,344,0.006499641,0.022597589,0.016097948,2019,QRVO
2010-02-25T00:00:00Z,1333,1658,88433,325,0.003675099,0.018748657,0.015073559,2010,BXP
2011-02-25T00:00:00Z,1284,1766,89247,482,0.005400742,0.01978778,0.014387038,2011,BXP
2012-02-28T00:00:00Z,1321,1719,91094,398,0.004369113,0.018870617,0.014501504,2012,BXP
2013-02-28T00:00:00Z,1359,1785,92365,426,0.004612137,0.019325502,0.014713365,2013,BXP
2014-02-28T00:00:00Z,1435,1961,101294,526,0.005192805,0.019359488,0.014166683,2014,BXP
2015-03-02T00:00:00Z,1416,2010,104144,594,0.005703641,0.0193002,0.013596559,2015,BXP
2016-02-29T00:00:00Z,1689,2119,108839,430,0.00395079,0.019469124,0.015518334,2016,BXP
2017-02-28T00:00:00Z,1681,2130,111635,449,0.004022036,0.019080038,0.015058002,2017,BXP
2018-02-28T00:00:00Z,1660,2065,107889,405,0.003753858,0.019140042,0.015386184,2018,BXP
2019-02-28T00:00:00Z,1634,2126,111542,492,0.004410895,0.019060085,0.01464919,2019,BXP
2010-06-02T00:00:00Z,1034,1688,68091,654,0.009604794,0.024790354,0.01518556,2010,RL
2011-05-26T00:00:00Z,1048,1641,66555,593,0.008909924,0.024656299,0.015746375,2011,RL
2012-05-24T00:00:00Z,1070,1670,67477,600,0.008891919,0.024749174,0.015857255,2012,RL
2013-05-23T00:00:00Z,1113,1738,70459,625,0.008870407,0.024666828,0.015796421,2013,RL
2014-05-15T00:00:00Z,1047,1687,68160,640,0.009389671,0.024750587,0.015360915,2014,RL
2015-05-15T00:00:00Z,1060,1594,68242,534,0.007825093,0.023358049,0.015532956,2015,RL
2016-05-19T00:00:00Z,1017,1581,67046,564,0.008412135,0.023580825,0.01516869,2016,RL
2017-05-18T00:00:00Z,1183,1734,71825,551,0.007671424,0.024142012,0.016470588,2017,RL
2018-05-23T00:00:00Z,1181,1807,75688,626,0.008270796,0.023874326,0.01560353,2018,RL
2019-05-16T00:00:00Z,1152,1846,76574,694,0.009063128,0.024107399,0.015044271,2019,RL
2011-02-28T00:00:00Z,1150,1628,80079,478,0.005969106,0.020329924,0.014360819,2011,SLG
2012-02-28T00:00:00Z,1148,1607,82577,459,0.005558448,0.019460625,0.013902176,2012,SLG
2013-02-27T00:00:00Z,1125,1500,79597,375,0.004711233,0.018844931,0.014133699,2013,SLG
2014-02-25T00:00:00Z,1189,1551,80685,362,0.004486584,0.019222904,0.01473632,2014,SLG
2015-02-24T00:00:00Z,1249,1662,86324,413,0.004784301,0.019253047,0.014468746,2015,SLG
2016-02-29T00:00:00Z,1280,1687,89598,407,0.004542512,0.018828545,0.014286033,2016,SLG
2017-02-21T00:00:00Z,1335,1684,90571,349,0.003853331,0.018593148,0.014739817,2017,SLG
2018-02-23T00:00:00Z,1179,1617,86565,438,0.005059782,0.018679605,0.013619823,2018,SLG
2019-02-27T00:00:00Z,1160,1560,82402,400,0.004854251,0.018931579,0.014077328,2019,SLG
2010-02-17T00:00:00Z,761,1148,54357,387,0.007119598,0.021119635,0.014000037,2010,YUM
2011-02-15T00:00:00Z,858,1237,57695,379,0.006569027,0.021440333,0.014871306,2011,YUM
2012-02-21T00:00:00Z,793,1202,55643,409,0.00735043,0.021601998,0.014251568,2012,YUM
2013-02-20T00:00:00Z,805,1211,55847,406,0.007269862,0.021684244,0.014414382,2013,YUM
2014-02-18T00:00:00Z,912,1354,58709,442,0.007528658,0.023062903,0.015534245,2014,YUM
2015-02-17T00:00:00Z,780,1120,49518,340,0.00686619,0.022618038,0.015751848,2015,YUM
2016-02-16T00:00:00Z,795,1144,51169,349,0.006820536,0.022357287,0.015536751,2016,YUM
2017-02-22T00:00:00Z,939,1265,58587,326,0.005564374,0.021591821,0.016027446,2017,YUM
2018-02-22T00:00:00Z,864,1281,60185,417,0.006928637,0.021284373,0.014355736,2018,YUM
2019-02-21T00:00:00Z,890,1280,63726,390,0.006119951,0.020085993,0.013966042,2019,YUM
2010-03-01T00:00:00Z,403,614,29964,211,0.007041783,0.020491256,0.013449473,2010,CHRW
2011-03-01T00:00:00Z,367,598,28607,231,0.008074947,0.020903975,0.012829028,2011,CHRW
2012-02-29T00:00:00Z,355,570,27889,215,0.007709133,0.020438166,0.012729033,2012,CHRW
2013-03-01T00:00:00Z,366,600,29463,234,0.007942165,0.020364525,0.01242236,2013,CHRW
2014-03-03T00:00:00Z,383,659,31642,276,0.008722584,0.020826749,0.012104165,2014,CHRW
2015-03-02T00:00:00Z,384,652,31978,268,0.008380762,0.020389017,0.012008256,2015,CHRW
2016-02-29T00:00:00Z,378,627,31415,249,0.00792615,0.019958618,0.012032469,2016,CHRW
2017-03-01T00:00:00Z,420,776,35831,356,0.009935531,0.021657224,0.011721694,2017,CHRW
2018-02-28T00:00:00Z,421,748,35480,327,0.00921646,0.0210823,0.01186584,2018,CHRW
2019-02-25T00:00:00Z,414,740,36537,326,0.008922462,0.020253442,0.01133098,2019,CHRW
2011-02-18T00:00:00Z,2334,2719,144699,385,0.002660696,0.018790731,0.016130035,2011,AMB
2012-02-29T00:00:00Z,1194,1607,89809,413,0.004598648,0.01789353,0.013294881,2012,AMB
2013-02-28T00:00:00Z,1265,1640,89745,375,0.004178506,0.018273999,0.014095493,2013,AMB
2014-02-26T00:00:00Z,1235,1512,83788,277,0.003305963,0.018045544,0.014739581,2014,AMB
2015-02-25T00:00:00Z,1074,1247,73954,173,0.002339292,0.016861833,0.014522541,2015,AMB
2016-02-19T00:00:00Z,1009,1266,74758,257,0.003437759,0.016934642,0.013496883,2016,AMB
2017-02-15T00:00:00Z,922,1248,72869,326,0.004473782,0.017126624,0.012652843,2017,AMB
2018-02-15T00:00:00Z,911,1205,67074,294,0.004383219,0.017965232,0.013582014,2018,AMB
2019-02-13T00:00:00Z,902,1184,60026,282,0.004697964,0.019724786,0.015026822,2019,AMB
2015-02-23T00:00:00Z,474,864,39060,390,0.009984639,0.022119816,0.012135177,2015,AMG
2016-02-25T00:00:00Z,514,946,40599,432,0.010640656,0.023301067,0.01266041,2016,AMG
2017-02-24T00:00:00Z,522,1021,43791,499,0.011395036,0.023315293,0.011920258,2017,AMG
2018-02-23T00:00:00Z,508,1001,42786,493,0.011522461,0.023395503,0.011873043,2018,AMG
2019-02-22T00:00:00Z,532,1001,43692,469,0.010734231,0.022910373,0.012176142,2019,AMG
2010-02-09T00:00:00Z,534,877,39163,343,0.008758267,0.022393586,0.013635319,2010,MTD
2011-02-16T00:00:00Z,523,912,39918,389,0.009744977,0.022846836,0.013101859,2011,MTD
2012-02-13T00:00:00Z,520,861,39561,341,0.0086196,0.021763858,0.013144258,2012,MTD
2013-02-08T00:00:00Z,583,883,40187,300,0.007465101,0.02197228,0.014507179,2013,MTD
2014-02-07T00:00:00Z,594,843,38524,249,0.006463503,0.021882463,0.01541896,2014,MTD
2015-02-06T00:00:00Z,567,825,37981,258,0.00679287,0.021721387,0.014928517,2015,MTD
2016-02-04T00:00:00Z,617,906,39526,289,0.007311643,0.022921621,0.015609978,2016,MTD
2017-02-02T00:00:00Z,621,921,40376,300,0.007430157,0.022810581,0.015380424,2017,MTD
2018-02-09T00:00:00Z,625,940,41952,315,0.007508581,0.02240656,0.014897979,2018,MTD
2019-02-08T00:00:00Z,645,935,42361,290,0.00684592,0.022072189,0.015226269,2019,MTD
2010-03-19T00:00:00Z,778,1243,52521,465,0.008853601,0.023666724,0.014813122,2010,ADSK
2011-03-18T00:00:00Z,757,1204,51648,447,0.00865474,0.023311648,0.014656908,2011,ADSK
2012-03-15T00:00:00Z,754,1237,50640,483,0.009537915,0.02442733,0.014889415,2012,ADSK
2013-03-18T00:00:00Z,866,1309,54390,443,0.00814488,0.024066924,0.015922044,2013,ADSK
2014-03-10T00:00:00Z,875,1349,56240,474,0.008428165,0.023986486,0.015558321,2014,ADSK
2015-03-18T00:00:00Z,905,1438,58512,533,0.009109243,0.024576155,0.015466913,2015,ADSK
2016-03-23T00:00:00Z,1091,1608,64854,517,0.007971752,0.024794153,0.016822401,2016,ADSK
2017-03-21T00:00:00Z,1108,1532,63320,424,0.006696147,0.024194567,0.017498421,2017,ADSK
2018-03-22T00:00:00Z,1096,1498,63012,402,0.006379737,0.02377325,0.017393512,2018,ADSK
2019-03-25T00:00:00Z,1115,1455,63962,340,0.005315656,0.022747882,0.017432225,2019,ADSK
2012-01-25T00:00:00Z,874,1114,53446,240,0.004490514,0.020843468,0.016352954,2012,URI
2013-01-23T00:00:00Z,922,1258,60031,336,0.005597108,0.020955839,0.015358731,2013,URI
2014-01-22T00:00:00Z,839,1257,59924,418,0.006975502,0.02097657,0.014001068,2014,URI
2015-01-21T00:00:00Z,822,1228,59550,406,0.0068178,0.020621327,0.013803526,2015,URI
2016-01-27T00:00:00Z,816,1210,55236,394,0.007133029,0.021906003,0.014772974,2016,URI
2017-01-25T00:00:00Z,782,1174,52804,392,0.00742368,0.022233164,0.014809484,2017,URI
2018-01-24T00:00:00Z,816,1349,58138,533,0.009167842,0.023203413,0.014035571,2018,URI
2019-01-23T00:00:00Z,859,1339,65665,480,0.00730983,0.02039138,0.01308155,2019,URI
2004-03-30T00:00:00Z,653,921,51473,268,0.005206613,0.017892876,0.012686263,2004,VRSN
2005-03-16T00:00:00Z,796,1084,58840,288,0.00489463,0.018422842,0.013528212,2005,VRSN
2006-03-15T00:00:00Z,991,1288,67365,297,0.004408818,0.019119721,0.014710903,2006,VRSN
2007-04-02T00:00:00Z,934,1293,65331,359,0.005495094,0.019791523,0.014296429,2007,VRSN
2008-04-29T00:00:00Z,669,906,44793,237,0.005291005,0.020226375,0.014935369,2008,VRSN
2009-03-31T00:00:00Z,644,898,42510,254,0.005975065,0.021124441,0.015149377,2009,VRSN
2011-03-01T00:00:00Z,1244,1478,72296,234,0.003236694,0.020443731,0.017207038,2011,PWR
2012-02-29T00:00:00Z,1341,1722,79140,381,0.004814253,0.021758908,0.016944655,2012,PWR
2013-03-01T00:00:00Z,1345,1700,78029,355,0.004549591,0.021786772,0.017237181,2013,PWR
2014-03-03T00:00:00Z,1408,1742,82779,334,0.00403484,0.021043985,0.017009145,2014,PWR
2015-03-02T00:00:00Z,1516,1837,89096,321,0.003602855,0.02061821,0.017015354,2015,PWR
2016-02-29T00:00:00Z,1573,1868,89349,295,0.00330166,0.020906781,0.017605121,2016,PWR
2017-03-01T00:00:00Z,1718,2066,95130,348,0.003658152,0.02171765,0.018059498,2017,PWR
2018-02-28T00:00:00Z,1657,1974,88196,317,0.003594267,0.022381967,0.0187877,2018,PWR
2019-02-28T00:00:00Z,1646,1944,89284,298,0.003337664,0.021773218,0.018435554,2019,PWR
2010-04-28T00:00:00Z,843,1833,63217,990,0.015660345,0.028995365,0.013335021,2010,BBY
2011-04-25T00:00:00Z,862,1808,64895,946,0.014577394,0.02786039,0.013282996,2011,BBY
2012-05-01T00:00:00Z,983,1935,66309,952,0.014357025,0.029181559,0.014824534,2012,BBY
2014-03-28T00:00:00Z,917,1586,57398,669,0.011655458,0.027631625,0.015976166,2014,BBY
2015-03-31T00:00:00Z,839,1461,54191,622,0.011477921,0.026960196,0.015482276,2015,BBY
2016-03-23T00:00:00Z,803,1409,52263,606,0.011595201,0.026959799,0.015364598,2016,BBY
2017-03-24T00:00:00Z,767,1300,50692,533,0.01051448,0.025645072,0.015130593,2017,BBY
2018-04-02T00:00:00Z,789,1320,51940,531,0.010223335,0.025413939,0.015190605,2018,BBY
2019-03-28T00:00:00Z,741,1308,51523,567,0.011004794,0.02538672,0.014381927,2019,BBY
2012-02-29T00:00:00Z,819,1565,73183,746,0.010193624,0.021384748,0.011191124,2012,LLL
2013-02-27T00:00:00Z,855,1531,74364,676,0.00909042,0.020587919,0.011497499,2013,LLL
2014-02-25T00:00:00Z,261,442,24850,181,0.007283702,0.01778672,0.010503018,2014,LLL
2015-02-26T00:00:00Z,256,467,25406,211,0.008305125,0.018381485,0.01007636,2015,LLL
2016-02-26T00:00:00Z,322,457,25817,135,0.005229113,0.017701515,0.012472402,2016,LLL
2017-02-23T00:00:00Z,866,1632,74858,766,0.010232707,0.021801277,0.01156857,2017,LLL
2018-02-22T00:00:00Z,831,1652,73829,821,0.011120291,0.022376031,0.01125574,2018,LLL
2019-02-21T00:00:00Z,856,1693,78080,837,0.010719775,0.021682889,0.010963115,2019,LLL
2012-02-28T00:00:00Z,327,301,24682,-26,-0.001053399,0.012195122,0.013248521,2012,SRE
2013-02-26T00:00:00Z,395,376,28695,-19,-0.000662136,0.013103328,0.013765464,2013,SRE
2014-02-27T00:00:00Z,447,464,31367,17,0.000541971,0.014792616,0.014250646,2014,SRE
2015-02-26T00:00:00Z,520,543,33381,23,0.000689015,0.016266739,0.015577724,2015,SRE
2016-02-26T00:00:00Z,658,688,39259,30,0.000764156,0.017524644,0.016760488,2016,SRE
2017-02-28T00:00:00Z,715,770,41501,55,0.001325269,0.01855377,0.017228501,2017,SRE
2018-02-27T00:00:00Z,2655,3330,175616,675,0.003843613,0.018961826,0.015118212,2018,SRE
2019-02-26T00:00:00Z,2510,3084,178288,574,0.00321951,0.017297855,0.014078345,2019,SRE
2010-02-25T00:00:00Z,863,1461,56278,598,0.010625822,0.025960411,0.015334589,2010,CTSH
2011-02-23T00:00:00Z,900,1404,55335,504,0.009108159,0.02537273,0.01626457,2011,CTSH
2012-02-27T00:00:00Z,947,1423,56504,476,0.008424182,0.025184058,0.016759875,2012,CTSH
2013-02-26T00:00:00Z,1005,1467,56545,462,0.008170484,0.025943938,0.017773455,2013,CTSH
2014-02-25T00:00:00Z,1040,1402,55790,362,0.006488618,0.025129952,0.018641334,2014,CTSH
2015-02-27T00:00:00Z,1031,1411,57764,380,0.006578492,0.024426979,0.017848487,2015,CTSH
2016-02-25T00:00:00Z,1028,1367,56326,339,0.006018535,0.024269432,0.018250897,2016,CTSH
2017-03-01T00:00:00Z,1322,1492,65253,170,0.002605244,0.022864849,0.020259605,2017,CTSH
2018-02-27T00:00:00Z,1156,1437,61731,281,0.004552008,0.023278418,0.01872641,2018,CTSH
2019-02-19T00:00:00Z,772,1166,52017,394,0.007574447,0.022415749,0.014841302,2019,CTSH
2010-02-24T00:00:00Z,1788,2047,94196,259,0.002749586,0.021731284,0.018981698,2010,RSG
2011-02-18T00:00:00Z,1775,1954,89420,179,0.002001789,0.021851935,0.019850145,2011,RSG
2012-02-17T00:00:00Z,1639,1761,79933,122,0.001526278,0.022030951,0.020504673,2012,RSG
2013-02-15T00:00:00Z,1459,1618,73658,159,0.002158625,0.021966385,0.01980776,2013,RSG
2014-02-13T00:00:00Z,1415,1653,73186,238,0.003251988,0.022586287,0.019334299,2014,RSG
2015-02-23T00:00:00Z,1238,1562,69146,324,0.004685737,0.022589882,0.017904145,2015,RSG
2016-02-12T00:00:00Z,1221,1690,71719,469,0.006539411,0.023564188,0.017024777,2016,RSG
2017-02-17T00:00:00Z,1283,1734,73374,451,0.006146591,0.023632349,0.017485758,2017,RSG
2018-02-09T00:00:00Z,1316,1842,77032,526,0.006828331,0.02391214,0.017083809,2018,RSG
2019-02-08T00:00:00Z,1338,1747,78978,409,0.005178657,0.022120084,0.016941427,2019,RSG
2011-02-15T00:00:00Z,868,862,48128,-6,-0.000124668,0.017910572,0.018035239,2011,TWRS
2012-02-13T00:00:00Z,884,895,49027,11,0.000224366,0.018255247,0.018030881,2012,TWRS
2013-02-12T00:00:00Z,929,952,53009,23,0.000433889,0.017959214,0.017525326,2013,TWRS
2014-02-24T00:00:00Z,899,1012,58312,113,0.001937852,0.017354918,0.015417067,2014,TWRS
2015-02-19T00:00:00Z,792,923,55576,131,0.002357133,0.016607888,0.014250756,2015,TWRS
2016-02-22T00:00:00Z,854,969,54624,115,0.002105302,0.017739455,0.015634153,2016,TWRS
2017-02-22T00:00:00Z,849,984,54999,135,0.00245459,0.017891234,0.015436644,2017,TWRS
2018-02-26T00:00:00Z,904,1065,59595,161,0.002701569,0.017870627,0.015169058,2018,TWRS
2019-02-25T00:00:00Z,815,990,56235,175,0.003111941,0.017604695,0.014492754,2019,TWRS
2011-02-15T00:00:00Z,868,862,48128,-6,-0.000124668,0.017910572,0.018035239,2011,CCI
2012-02-13T00:00:00Z,884,895,49027,11,0.000224366,0.018255247,0.018030881,2012,CCI
2013-02-12T00:00:00Z,929,952,53009,23,0.000433889,0.017959214,0.017525326,2013,CCI
2014-02-24T00:00:00Z,899,1012,58312,113,0.001937852,0.017354918,0.015417067,2014,CCI
2015-02-19T00:00:00Z,792,923,55576,131,0.002357133,0.016607888,0.014250756,2015,CCI
2016-02-22T00:00:00Z,854,969,54624,115,0.002105302,0.017739455,0.015634153,2016,CCI
2017-02-22T00:00:00Z,849,984,54999,135,0.00245459,0.017891234,0.015436644,2017,CCI
2018-02-26T00:00:00Z,904,1065,59595,161,0.002701569,0.017870627,0.015169058,2018,CCI
2019-02-25T00:00:00Z,815,990,56235,175,0.003111941,0.017604695,0.014492754,2019,CCI
2011-01-28T00:00:00Z,1529,1520,70816,-9,-0.00012709,0.021464076,0.021591166,2011,EBAY
2012-01-31T00:00:00Z,1670,1522,76103,-148,-0.001944733,0.019999212,0.021943944,2012,EBAY
2013-02-01T00:00:00Z,1822,1645,80900,-177,-0.002187886,0.020333745,0.022521632,2013,EBAY
2014-01-31T00:00:00Z,1887,1730,85901,-157,-0.001827685,0.020139463,0.021967148,2014,EBAY
2015-02-06T00:00:00Z,1562,1507,73516,-55,-0.000748136,0.020498939,0.021247075,2015,EBAY
2016-02-01T00:00:00Z,1338,1184,57100,-154,-0.002697023,0.020735552,0.023432574,2016,EBAY
2017-02-06T00:00:00Z,1272,1207,55828,-65,-0.00116429,0.021619976,0.022784266,2017,EBAY
2018-02-05T00:00:00Z,1214,1227,56441,13,0.000230329,0.021739516,0.021509187,2018,EBAY
2019-01-30T00:00:00Z,1189,1337,58373,148,0.002535419,0.022904425,0.020369006,2019,EBAY
2010-03-18T00:00:00Z,1459,1479,70147,20,0.000285116,0.021084294,0.020799179,2010,NVDA
2011-03-16T00:00:00Z,1382,1471,66307,89,0.001342241,0.022184686,0.020842445,2011,NVDA
2012-03-13T00:00:00Z,1430,1473,65539,43,0.000656098,0.022475167,0.02181907,2012,NVDA
2013-03-12T00:00:00Z,1264,1401,61600,137,0.002224026,0.022743506,0.020519481,2013,NVDA
2014-03-13T00:00:00Z,1055,1221,56395,166,0.002943523,0.021650856,0.018707332,2014,NVDA
2015-03-12T00:00:00Z,757,886,46168,129,0.002794143,0.019190781,0.016396638,2015,NVDA
2016-03-17T00:00:00Z,834,957,48945,123,0.002513025,0.019552559,0.017039534,2016,NVDA
2017-03-01T00:00:00Z,792,918,48945,126,0.002574318,0.018755746,0.016181428,2017,NVDA
2018-02-28T00:00:00Z,758,939,44267,181,0.004088825,0.02121219,0.017123365,2018,NVDA
2019-02-21T00:00:00Z,754,854,42847,100,0.002333886,0.019931384,0.017597498,2019,NVDA
2011-02-25T00:00:00Z,1237,1377,71788,140,0.001950187,0.019181479,0.017231292,2011,PCLN
2012-02-27T00:00:00Z,1108,1381,67846,273,0.004023819,0.020354921,0.016331103,2012,PCLN
2013-02-27T00:00:00Z,1226,1539,73170,313,0.004277709,0.02103321,0.016755501,2013,PCLN
2014-02-20T00:00:00Z,1283,1740,76891,457,0.005943478,0.022629436,0.016685958,2014,PCLN
2015-02-19T00:00:00Z,1358,1559,76511,201,0.002627073,0.020376155,0.017749082,2015,PCLN
2016-02-17T00:00:00Z,1376,1536,76713,160,0.002085696,0.020022682,0.017936986,2016,PCLN
2017-02-27T00:00:00Z,1248,1421,71977,173,0.002403546,0.019742418,0.017338872,2017,PCLN
2018-02-27T00:00:00Z,1287,1545,76901,258,0.003354963,0.020090766,0.016735803,2018,PCLN
2019-02-27T00:00:00Z,1216,1458,74443,242,0.003250809,0.019585455,0.016334645,2019,PCLN
2009-11-20T00:00:00Z,681,1038,45247,357,0.007890026,0.022940747,0.015050722,2009,FFIV
2010-11-23T00:00:00Z,635,1000,42336,365,0.008621504,0.023620559,0.014999055,2010,FFIV
2011-11-22T00:00:00Z,610,1006,40959,396,0.009668205,0.024561147,0.014892942,2011,FFIV
2012-11-21T00:00:00Z,662,1049,43697,387,0.008856443,0.024006225,0.015149781,2012,FFIV
2013-11-22T00:00:00Z,714,1087,44467,373,0.008388243,0.024445094,0.016056851,2013,FFIV
2014-11-26T00:00:00Z,738,1107,45149,369,0.008172938,0.024518815,0.016345877,2014,FFIV
2015-11-06T00:00:00Z,791,1057,44467,266,0.005981964,0.023770437,0.017788472,2015,FFIV
2016-11-04T00:00:00Z,788,1091,45264,303,0.006694062,0.02410304,0.017408978,2016,FFIV
2017-11-03T00:00:00Z,860,1191,48144,331,0.006875208,0.024738285,0.017863077,2017,FFIV
2018-11-21T00:00:00Z,887,1213,48661,326,0.00669941,0.02492756,0.01822815,2018,FFIV
2010-03-04T00:00:00Z,2254,2860,121987,606,0.004967742,0.023445121,0.018477379,2010,CNC
2011-02-24T00:00:00Z,2172,2855,117274,683,0.005823968,0.024344697,0.018520729,2011,CNC
2012-02-27T00:00:00Z,2019,2677,111975,658,0.005876312,0.023907122,0.01803081,2012,CNC
2013-02-19T00:00:00Z,2035,2778,115973,743,0.006406664,0.023953851,0.017547188,2013,CNC
2014-02-24T00:00:00Z,1938,2757,114251,819,0.007168427,0.02413108,0.016962652,2014,CNC
2015-02-20T00:00:00Z,1882,2656,110910,774,0.006978631,0.023947345,0.016968713,2015,CNC
2016-02-19T00:00:00Z,1864,2625,107603,761,0.007072294,0.024395231,0.017322937,2016,CNC
2017-02-21T00:00:00Z,1952,2689,110039,737,0.006697625,0.024436791,0.017739165,2017,CNC
2018-02-23T00:00:00Z,1898,2712,106652,814,0.007632299,0.025428496,0.017796197,2018,CNC
2019-02-26T00:00:00Z,1897,2827,108057,930,0.008606569,0.026162118,0.017555549,2019,CNC
2010-02-26T00:00:00Z,993,1366,64218,373,0.00580834,0.021271295,0.015462954,2010,JNPR
2011-02-25T00:00:00Z,927,1241,61103,314,0.005138864,0.020309968,0.015171105,2011,JNPR
2012-02-24T00:00:00Z,981,1311,60535,330,0.005451392,0.021656893,0.016205501,2012,JNPR
2013-02-26T00:00:00Z,971,1427,61274,456,0.007441982,0.023288834,0.015846852,2013,JNPR
2014-02-26T00:00:00Z,946,1389,58787,443,0.00753568,0.023627673,0.016091993,2014,JNPR
2015-02-20T00:00:00Z,1074,1557,64488,483,0.007489766,0.024144027,0.016654261,2015,JNPR
2016-02-19T00:00:00Z,1233,1718,70762,485,0.006853961,0.024278568,0.017424606,2016,JNPR
2017-02-24T00:00:00Z,1269,1648,70233,379,0.005396324,0.023464753,0.018068429,2017,JNPR
2018-02-23T00:00:00Z,1245,1511,66110,266,0.004023597,0.022855846,0.018832249,2018,JNPR
2019-02-22T00:00:00Z,1321,1545,67020,224,0.003342286,0.02305282,0.019710534,2019,JNPR
2010-03-01T00:00:00Z,831,974,58875,143,0.002428875,0.016543524,0.01411465,2010,SBAC
2011-02-25T00:00:00Z,754,864,54452,110,0.002020128,0.015867186,0.013847058,2011,SBAC
2012-02-27T00:00:00Z,712,822,51334,110,0.002142829,0.016012779,0.01386995,2012,SBAC
2013-02-27T00:00:00Z,756,919,59496,163,0.00273968,0.015446417,0.012706737,2013,SBAC
2014-02-27T00:00:00Z,740,924,59251,184,0.003105433,0.015594674,0.012489241,2014,SBAC
2015-03-02T00:00:00Z,704,943,56200,239,0.004252669,0.016779359,0.01252669,2015,SBAC
2016-02-26T00:00:00Z,683,901,53933,218,0.004042052,0.016705913,0.012663861,2016,SBAC
2017-03-01T00:00:00Z,759,1050,62446,291,0.004660026,0.016814528,0.012154501,2017,SBAC
2018-03-01T00:00:00Z,710,1049,61708,339,0.005493615,0.016999417,0.011505802,2018,SBAC
2019-02-28T00:00:00Z,710,1021,60978,311,0.0051002,0.016743744,0.011643544,2019,SBAC
2011-02-25T00:00:00Z,867,1137,64173,270,0.004207377,0.017717732,0.013510355,2011,DVN
2012-02-24T00:00:00Z,605,839,46205,234,0.005064387,0.018158208,0.013093821,2012,DVN
2013-02-21T00:00:00Z,633,815,46362,182,0.003925629,0.017579052,0.013653423,2013,DVN
2014-02-28T00:00:00Z,670,865,48024,195,0.00406047,0.018011827,0.013951358,2014,DVN
2015-02-20T00:00:00Z,737,1033,53035,296,0.00558122,0.019477703,0.013896483,2015,DVN
2016-02-17T00:00:00Z,809,1083,54862,274,0.004994349,0.01974044,0.01474609,2016,DVN
2017-02-15T00:00:00Z,859,1279,60870,420,0.006899951,0.021011993,0.014112042,2017,DVN
2018-02-21T00:00:00Z,849,1242,57313,393,0.006857083,0.021670476,0.014813393,2018,DVN
2019-02-20T00:00:00Z,652,900,46033,248,0.005387439,0.019551192,0.014163752,2019,DVN
2004-03-30T00:00:00Z,653,921,51473,268,0.005206613,0.017892876,0.012686263,2004,BLK
2005-03-16T00:00:00Z,796,1084,58840,288,0.00489463,0.018422842,0.013528212,2005,BLK
2006-03-15T00:00:00Z,991,1288,67365,297,0.004408818,0.019119721,0.014710903,2006,BLK
2007-04-02T00:00:00Z,934,1293,65331,359,0.005495094,0.019791523,0.014296429,2007,BLK
2008-04-29T00:00:00Z,669,906,44793,237,0.005291005,0.020226375,0.014935369,2008,BLK
2009-03-31T00:00:00Z,644,898,42510,254,0.005975065,0.021124441,0.015149377,2009,BLK
2010-02-18T00:00:00Z,1274,1833,75530,559,0.007401033,0.024268503,0.01686747,2010,WCG
2011-02-16T00:00:00Z,1307,1769,76354,462,0.006050764,0.0231684,0.017117636,2011,WCG
2012-02-15T00:00:00Z,1414,1846,83431,432,0.005177931,0.022126068,0.016948137,2012,WCG
2013-02-13T00:00:00Z,1158,1705,72548,547,0.007539836,0.023501682,0.015961846,2013,WCG
2014-02-14T00:00:00Z,1212,1818,79391,606,0.007633107,0.022899321,0.015266214,2014,WCG
2015-02-17T00:00:00Z,1230,1895,82089,665,0.008100964,0.023084701,0.014983737,2015,WCG
2016-02-12T00:00:00Z,1180,1796,76425,616,0.00806019,0.023500164,0.015439974,2016,WCG
2017-02-13T00:00:00Z,1138,1801,73848,663,0.008977901,0.024387932,0.015410031,2017,WCG
2018-02-16T00:00:00Z,1208,1904,77406,696,0.008991551,0.024597576,0.015606025,2018,WCG
2019-02-12T00:00:00Z,1253,1945,79266,692,0.008730099,0.024537633,0.015807534,2019,WCG
2009-12-21T00:00:00Z,958,1533,61281,575,0.009383006,0.02501591,0.015632904,2009,A
2010-12-20T00:00:00Z,915,1630,63628,715,0.011237191,0.025617653,0.014380461,2010,A
2011-12-16T00:00:00Z,844,1591,62184,747,0.012012736,0.02558536,0.013572623,2011,A
2012-12-20T00:00:00Z,898,1644,66800,746,0.011167665,0.024610778,0.013443114,2012,A
2013-12-19T00:00:00Z,913,1636,66800,723,0.010823353,0.024491018,0.013667665,2013,A
2014-12-22T00:00:00Z,946,1754,71387,808,0.011318587,0.0245703,0.013251712,2014,A
2015-12-21T00:00:00Z,1038,1665,67879,627,0.009237025,0.024528941,0.015291916,2015,A
2016-12-20T00:00:00Z,964,1647,65314,683,0.010457176,0.025216646,0.01475947,2016,A
2017-12-21T00:00:00Z,895,1578,62058,683,0.011005833,0.025427826,0.014421992,2017,A
2018-12-20T00:00:00Z,863,1574,62037,711,0.011460902,0.025371955,0.013911053,2018,A
2010-02-26T00:00:00Z,935,1385,56881,450,0.007911253,0.02434908,0.016437826,2010,UPS
2011-02-28T00:00:00Z,981,1447,58567,466,0.007956699,0.024706746,0.016750047,2011,UPS
2012-02-27T00:00:00Z,1011,1578,64760,567,0.008755405,0.024366893,0.015611489,2012,UPS
2013-02-28T00:00:00Z,931,1521,62307,590,0.009469241,0.024411382,0.014942141,2013,UPS
2014-02-28T00:00:00Z,991,1655,66645,664,0.009963238,0.024833071,0.014869833,2014,UPS
2015-02-27T00:00:00Z,945,1730,66718,785,0.01176594,0.025930034,0.014164094,2015,UPS
2016-02-25T00:00:00Z,954,1791,68064,837,0.01229725,0.02631347,0.01401622,2016,UPS
2017-02-21T00:00:00Z,939,1887,68892,948,0.013760669,0.027390698,0.01363003,2017,UPS
2018-02-21T00:00:00Z,945,1812,70209,867,0.012348844,0.025808657,0.013459813,2018,UPS
2019-02-21T00:00:00Z,964,1884,73388,920,0.012536109,0.025671772,0.013135663,2019,UPS
2010-02-17T00:00:00Z,401,660,33487,259,0.007734345,0.019709141,0.011974796,2010,PKG
2011-02-22T00:00:00Z,438,651,35767,213,0.00595521,0.018201135,0.012245925,2011,PKG
2012-02-21T00:00:00Z,443,707,36822,264,0.007169627,0.019200478,0.012030851,2012,PKG
2013-02-28T00:00:00Z,387,673,34118,286,0.008382672,0.019725658,0.011342986,2013,PKG
2014-02-28T00:00:00Z,533,841,43133,308,0.007140704,0.019497832,0.012357128,2014,PKG
2015-02-27T00:00:00Z,530,835,44730,305,0.00681869,0.018667561,0.011848871,2015,PKG
2016-02-26T00:00:00Z,502,863,43512,361,0.008296562,0.019833609,0.011537047,2016,PKG
2017-02-28T00:00:00Z,483,913,42997,430,0.010000698,0.02123404,0.011233342,2017,PKG
2018-02-28T00:00:00Z,552,985,46469,433,0.00931804,0.021196927,0.011878887,2018,PKG
2019-02-28T00:00:00Z,563,979,46057,416,0.009032286,0.021256269,0.012223983,2019,PKG
2010-02-26T00:00:00Z,864,1234,48707,370,0.007596444,0.025335167,0.017738723,2010,EW
2011-02-28T00:00:00Z,848,1088,45494,240,0.005275421,0.023915242,0.018639821,2011,EW
2012-02-27T00:00:00Z,867,1086,45670,219,0.00479527,0.023779286,0.018984016,2012,EW
2013-02-28T00:00:00Z,810,1033,44735,223,0.004984911,0.023091539,0.018106628,2013,EW
2014-02-28T00:00:00Z,876,1013,43928,137,0.00311874,0.023060463,0.019941723,2014,EW
2015-02-20T00:00:00Z,866,1056,43954,190,0.004322701,0.024025117,0.019702416,2015,EW
2016-02-19T00:00:00Z,863,1068,43615,205,0.004700218,0.024486988,0.019786771,2016,EW
2017-02-17T00:00:00Z,877,1107,44768,230,0.005137598,0.024727484,0.019589886,2017,EW
2018-02-16T00:00:00Z,913,1213,49192,300,0.006098553,0.024658481,0.018559928,2018,EW
2019-02-15T00:00:00Z,914,1225,48469,311,0.006416472,0.025273886,0.018857414,2019,EW
2010-02-26T00:00:00Z,453,597,32498,144,0.004431042,0.018370361,0.013939319,2010,EXPD
2011-02-28T00:00:00Z,463,578,32554,115,0.003532592,0.017755115,0.014222523,2011,EXPD
2012-02-28T00:00:00Z,487,606,32133,119,0.003703358,0.018859117,0.015155759,2012,EXPD
2013-02-27T00:00:00Z,443,550,28389,107,0.003769065,0.019373701,0.015604636,2013,EXPD
2014-02-27T00:00:00Z,469,576,30468,107,0.003511881,0.018905081,0.015393199,2014,EXPD
2015-02-26T00:00:00Z,474,605,31644,131,0.004139805,0.019118948,0.014979143,2015,EXPD
2016-02-25T00:00:00Z,471,651,32505,180,0.00553761,0.020027688,0.014490078,2016,EXPD
2017-02-23T00:00:00Z,479,671,32889,192,0.005837818,0.020401958,0.01456414,2017,EXPD
2018-02-23T00:00:00Z,497,708,34014,211,0.006203328,0.020814959,0.014611631,2018,EXPD
2019-02-22T00:00:00Z,490,712,33781,222,0.006571742,0.021076937,0.014505195,2019,EXPD
2011-02-25T00:00:00Z,5001,6657,237610,1656,0.006969404,0.028016498,0.021047094,2011,MET
2012-02-28T00:00:00Z,5052,6300,235941,1248,0.005289458,0.026701591,0.021412133,2012,MET
2013-02-27T00:00:00Z,4509,5280,210575,771,0.003661403,0.025074202,0.021412798,2013,MET
2014-02-27T00:00:00Z,4560,5260,209984,700,0.003333587,0.025049528,0.02171594,2014,MET
2015-02-27T00:00:00Z,4416,5249,206161,833,0.004040531,0.025460684,0.021420152,2015,MET
2016-02-25T00:00:00Z,4334,5095,201995,761,0.00376742,0.025223397,0.021455977,2016,MET
2017-03-01T00:00:00Z,4670,5443,218767,773,0.00353344,0.024880352,0.021346912,2017,MET
2018-03-01T00:00:00Z,4831,5613,221184,782,0.003535518,0.025377062,0.021841544,2018,MET
2019-02-22T00:00:00Z,4232,5119,199983,887,0.004435377,0.025597176,0.021161799,2019,MET
2012-02-29T00:00:00Z,1318,1081,56194,-237,-0.004217532,0.019236929,0.023454461,2012,HANS
2013-03-01T00:00:00Z,1370,1079,53710,-291,-0.005417985,0.020089369,0.025507354,2013,HANS
2014-03-03T00:00:00Z,1392,1053,53164,-339,-0.006376495,0.019806636,0.026183131,2014,HANS
2015-03-02T00:00:00Z,1497,1150,58191,-347,-0.005963121,0.019762506,0.025725628,2015,HANS
2016-02-29T00:00:00Z,1507,1189,59507,-318,-0.005343909,0.019980843,0.025324752,2016,HANS
2017-03-01T00:00:00Z,1388,1134,57919,-254,-0.004385435,0.019579067,0.023964502,2017,HANS
2018-03-01T00:00:00Z,1363,1126,56704,-237,-0.004179599,0.019857506,0.024037105,2018,HANS
2019-02-28T00:00:00Z,1348,1080,56106,-268,-0.004776673,0.019249278,0.024025951,2019,HANS
2012-02-28T00:00:00Z,1624,2161,108598,537,0.004944842,0.019899077,0.014954235,2012,NRG
2013-02-27T00:00:00Z,1772,2473,120558,701,0.005814629,0.020512948,0.014698319,2013,NRG
2014-02-28T00:00:00Z,1830,2400,121733,570,0.004682379,0.019715279,0.0150329,2014,NRG
2015-02-27T00:00:00Z,1955,2461,125409,506,0.004034798,0.019623791,0.015588993,2015,NRG
2016-02-29T00:00:00Z,2076,2513,127204,437,0.003435427,0.019755668,0.016320242,2016,NRG
2017-02-28T00:00:00Z,2283,2637,134998,354,0.002622261,0.019533623,0.016911362,2017,NRG
2018-03-01T00:00:00Z,2306,2556,129103,250,0.001936438,0.019798146,0.017861707,2018,NRG
2019-02-28T00:00:00Z,2053,2130,103306,77,0.000745358,0.020618357,0.019872999,2019,NRG
2010-01-29T00:00:00Z,790,1128,45647,338,0.007404649,0.024711372,0.017306723,2010,ISRG
2011-02-01T00:00:00Z,817,1140,48110,323,0.006713781,0.023695697,0.016981916,2011,ISRG
2012-02-06T00:00:00Z,835,1047,47518,212,0.004461467,0.022033756,0.017572288,2012,ISRG
2013-02-04T00:00:00Z,885,1089,50748,204,0.004019863,0.021458974,0.017439111,2013,ISRG
2014-02-03T00:00:00Z,1109,1258,57355,149,0.002597855,0.021933572,0.019335716,2014,ISRG
2015-02-06T00:00:00Z,1198,1291,61370,93,0.001515398,0.021036337,0.019520939,2015,ISRG
2016-02-02T00:00:00Z,1237,1295,61187,58,0.000947914,0.021164626,0.020216713,2016,ISRG
2017-02-06T00:00:00Z,1229,1315,62384,86,0.001378559,0.021079123,0.019700564,2017,ISRG
2018-02-02T00:00:00Z,1272,1376,65517,104,0.001587374,0.021002183,0.019414808,2018,ISRG
2019-02-04T00:00:00Z,1270,1406,66884,136,0.002033371,0.02102147,0.018988099,2019,ISRG
2011-02-28T00:00:00Z,695,1087,47123,392,0.008318655,0.023067292,0.014748637,2011,ILMN
2012-02-24T00:00:00Z,743,1135,49471,392,0.007923834,0.022942734,0.0150189,2012,ILMN
2013-02-15T00:00:00Z,798,1193,50045,395,0.007892896,0.023838545,0.015945649,2013,ILMN
2014-02-18T00:00:00Z,836,1219,49795,383,0.007691535,0.02448037,0.016788834,2014,ILMN
2015-02-18T00:00:00Z,813,1105,48674,292,0.005999096,0.022702059,0.016702963,2015,ILMN
2016-03-02T00:00:00Z,818,1053,47327,235,0.004965453,0.022249456,0.017284003,2016,ILMN
2017-02-14T00:00:00Z,831,1075,47825,244,0.005101934,0.022477784,0.017375849,2017,ILMN
2018-02-13T00:00:00Z,763,1029,45472,266,0.005849754,0.02262931,0.016779557,2018,ILMN
2019-02-12T00:00:00Z,763,1014,45823,251,0.005477599,0.022128625,0.016651027,2019,ILMN
2010-02-22T00:00:00Z,1222,1486,75829,264,0.003481518,0.019596724,0.016115207,2010,EQIX
2011-02-25T00:00:00Z,1192,1496,74446,304,0.004083497,0.020095102,0.016011606,2011,EQIX
2012-02-24T00:00:00Z,1274,1665,78456,391,0.004983685,0.021222086,0.016238401,2012,EQIX
2013-02-26T00:00:00Z,1275,1765,82636,490,0.005929619,0.02135873,0.015429111,2013,EQIX
2014-02-28T00:00:00Z,1349,1873,90047,524,0.005819183,0.020800249,0.014981065,2014,EQIX
2015-03-02T00:00:00Z,1299,1723,81697,424,0.005189909,0.021090126,0.015900217,2015,EQIX
2016-02-26T00:00:00Z,1394,1902,88558,508,0.005736354,0.02147745,0.015741096,2016,EQIX
2017-02-27T00:00:00Z,1486,2007,92194,521,0.005651127,0.021769313,0.016118186,2017,EQIX
2018-02-26T00:00:00Z,1450,1856,90845,406,0.004469151,0.020430403,0.015961253,2018,EQIX
2019-02-22T00:00:00Z,1429,1754,84940,325,0.00382623,0.02064987,0.01682364,2019,EQIX
2009-08-19T00:00:00Z,383,738,35259,355,0.010068351,0.020930826,0.010862475,2009,COH
2010-08-25T00:00:00Z,361,675,33873,314,0.00926992,0.019927376,0.010657456,2010,COH
2011-08-19T00:00:00Z,351,694,34822,343,0.009850095,0.019929929,0.010079835,2011,COH
2012-08-22T00:00:00Z,388,726,38309,338,0.008822992,0.01895116,0.010128168,2012,COH
2013-08-22T00:00:00Z,488,956,43091,468,0.010860737,0.022185607,0.011324871,2013,COH
2014-08-15T00:00:00Z,616,979,46150,363,0.007865655,0.021213434,0.013347779,2014,COH
2015-08-14T00:00:00Z,713,1081,51534,368,0.007140917,0.020976443,0.013835526,2015,COH
2016-08-19T00:00:00Z,694,1152,54445,458,0.008412159,0.021158968,0.012746809,2016,COH
2017-08-18T00:00:00Z,731,1122,54326,391,0.00719729,0.020653094,0.013455804,2017,COH
2018-08-16T00:00:00Z,896,1072,54762,176,0.003213907,0.019575618,0.016361711,2018,COH
2011-08-29T00:00:00Z,342,797,30943,455,0.014704457,0.025757037,0.011052581,2011,JKHY
2012-08-27T00:00:00Z,321,798,29958,477,0.015922291,0.026637292,0.010715001,2012,JKHY
2013-08-27T00:00:00Z,322,744,27989,422,0.015077352,0.026581871,0.01150452,2013,JKHY
2014-08-27T00:00:00Z,327,718,27888,391,0.014020367,0.025745841,0.011725473,2014,JKHY
2015-09-11T00:00:00Z,417,785,31170,368,0.011806224,0.025184472,0.013378248,2015,JKHY
2016-08-29T00:00:00Z,401,833,31925,432,0.013531715,0.026092404,0.012560689,2016,JKHY
2017-08-25T00:00:00Z,365,846,32344,481,0.014871383,0.02615632,0.011284937,2017,JKHY
2018-08-24T00:00:00Z,400,882,34723,482,0.013881289,0.025401031,0.011519742,2018,JKHY
2010-02-24T00:00:00Z,667,1032,48399,365,0.007541478,0.021322755,0.013781276,2010,GRMN
2011-02-23T00:00:00Z,660,1027,48962,367,0.007495609,0.02097545,0.013479842,2011,GRMN
2012-02-29T00:00:00Z,715,1150,53796,435,0.008086103,0.021377054,0.013290951,2012,GRMN
2013-02-27T00:00:00Z,732,1111,54836,379,0.006911518,0.020260413,0.013348895,2013,GRMN
2014-02-19T00:00:00Z,850,1006,51868,156,0.003007635,0.019395388,0.016387754,2014,GRMN
2015-02-18T00:00:00Z,859,1037,49881,178,0.003568493,0.020789479,0.017220986,2015,GRMN
2016-02-17T00:00:00Z,826,1021,48808,195,0.003995247,0.020918702,0.016923455,2016,GRMN
2017-02-22T00:00:00Z,877,1118,52048,241,0.004630341,0.021480172,0.016849831,2017,GRMN
2018-02-21T00:00:00Z,774,1111,50285,337,0.0067018,0.022094064,0.015392264,2018,GRMN
2019-02-20T00:00:00Z,623,861,39221,238,0.006068178,0.021952525,0.015884348,2019,GRMN
2010-02-25T00:00:00Z,857,1245,51210,388,0.007576645,0.024311658,0.016735013,2010,FLR
2011-02-23T00:00:00Z,899,1326,52967,427,0.008061623,0.025034455,0.016972832,2011,FLR
2012-02-22T00:00:00Z,931,1431,55172,500,0.009062568,0.02593707,0.016874502,2012,FLR
2013-02-20T00:00:00Z,963,1462,56275,499,0.00886717,0.025979565,0.017112394,2013,FLR
2014-02-18T00:00:00Z,987,1490,56273,503,0.008938567,0.026478062,0.017539495,2014,FLR
2015-02-18T00:00:00Z,1020,1475,56254,455,0.008088314,0.026220358,0.018132044,2015,FLR
2016-02-18T00:00:00Z,1099,1566,58838,467,0.007937047,0.026615453,0.018678405,2016,FLR
2017-02-17T00:00:00Z,1102,1644,61122,542,0.008867511,0.026897026,0.018029515,2017,FLR
2018-02-20T00:00:00Z,1084,1714,61333,630,0.010271795,0.027945804,0.017674009,2018,FLR
2019-02-21T00:00:00Z,1045,1562,61250,517,0.008440816,0.025502041,0.017061224,2019,FLR
2010-02-26T00:00:00Z,842,1064,50049,222,0.004435653,0.021259166,0.016823513,2010,ALGN
2011-02-24T00:00:00Z,883,1050,47842,167,0.003490657,0.021947243,0.018456586,2011,ALGN
2012-02-29T00:00:00Z,875,1124,51584,249,0.004827078,0.021789702,0.016962624,2012,ALGN
2013-03-01T00:00:00Z,903,1285,54328,382,0.007031365,0.023652628,0.016621263,2013,ALGN
2014-02-28T00:00:00Z,936,1370,56139,434,0.007730811,0.024403712,0.016672901,2014,ALGN
2015-02-26T00:00:00Z,895,1378,58512,483,0.008254717,0.023550725,0.015296008,2015,ALGN
2016-02-25T00:00:00Z,864,1198,52410,334,0.00637283,0.022858233,0.016485404,2016,ALGN
2017-02-28T00:00:00Z,910,1242,52892,332,0.006276942,0.023481812,0.01720487,2017,ALGN
2018-02-28T00:00:00Z,923,1293,54356,370,0.006806976,0.023787622,0.016980646,2018,ALGN
2019-02-28T00:00:00Z,1020,1336,55818,316,0.005661256,0.023934931,0.018273675,2019,ALGN
2011-07-25T00:00:00Z,664,820,48276,156,0.003231419,0.016985666,0.013754246,2011,GPN
2012-07-27T00:00:00Z,856,908,53024,52,0.000980688,0.017124321,0.016143633,2012,GPN
2013-07-25T00:00:00Z,881,887,51923,6,0.000115556,0.017082988,0.016967433,2013,GPN
2014-07-29T00:00:00Z,845,865,47740,20,0.000418936,0.018118978,0.017700042,2014,GPN
2015-07-30T00:00:00Z,881,927,50710,46,0.000907119,0.018280418,0.017373299,2015,GPN
2016-07-28T00:00:00Z,956,978,52900,22,0.000415879,0.018487713,0.018071834,2016,GPN
2018-02-23T00:00:00Z,829,1025,55838,196,0.003510154,0.018356675,0.01484652,2018,GPN
2019-02-21T00:00:00Z,819,1050,57824,231,0.003994881,0.01815855,0.014163669,2019,GPN
2010-03-01T00:00:00Z,819,1705,68218,886,0.012987774,0.024993404,0.012005629,2010,ADS
2011-02-28T00:00:00Z,979,1795,73949,816,0.011034632,0.024273486,0.013238854,2011,ADS
2012-02-27T00:00:00Z,903,1721,71218,818,0.01148586,0.024165239,0.012679379,2012,ADS
2013-02-28T00:00:00Z,868,1616,66748,748,0.011206328,0.024210463,0.013004135,2013,ADS
2014-02-28T00:00:00Z,825,1558,63429,733,0.011556228,0.024562897,0.013006669,2014,ADS
2015-02-27T00:00:00Z,860,1481,62189,621,0.009985689,0.023814501,0.013828812,2015,ADS
2016-02-25T00:00:00Z,863,1494,62885,631,0.010034189,0.023757653,0.013723463,2016,ADS
2017-02-27T00:00:00Z,915,1640,66284,725,0.010937783,0.024742019,0.013804236,2017,ADS
2018-02-27T00:00:00Z,861,1515,61958,654,0.010555538,0.024452048,0.013896511,2018,ADS
2019-02-26T00:00:00Z,926,1540,63212,614,0.009713346,0.024362463,0.014649117,2019,ADS
2010-02-26T00:00:00Z,759,1265,51771,506,0.009773812,0.024434529,0.014660717,2010,CEY
2011-02-25T00:00:00Z,824,1187,53045,363,0.006843246,0.022377227,0.015533981,2011,CEY
2012-02-24T00:00:00Z,902,1222,54718,320,0.005848167,0.022332688,0.016484521,2012,CEY
2013-02-26T00:00:00Z,892,1137,52018,245,0.004709908,0.021857818,0.01714791,2013,CEY
2014-02-28T00:00:00Z,899,1105,49156,206,0.00419074,0.022479453,0.018288713,2014,CEY
2015-02-27T00:00:00Z,870,1103,47706,233,0.004884082,0.023120781,0.0182367,2015,CEY
2016-02-26T00:00:00Z,1068,1336,56704,268,0.004726298,0.023560948,0.01883465,2016,CEY
2017-02-23T00:00:00Z,1036,1366,57255,330,0.005763689,0.023858178,0.01809449,2017,CEY
2018-02-22T00:00:00Z,1035,1350,56807,315,0.005545091,0.023764677,0.018219586,2018,CEY
2019-02-21T00:00:00Z,1104,1427,58174,323,0.005552309,0.024529859,0.01897755,2019,CEY
2010-02-26T00:00:00Z,759,1265,51771,506,0.009773812,0.024434529,0.014660717,2010,FIS
2011-02-25T00:00:00Z,824,1187,53045,363,0.006843246,0.022377227,0.015533981,2011,FIS
2012-02-24T00:00:00Z,902,1222,54718,320,0.005848167,0.022332688,0.016484521,2012,FIS
2013-02-26T00:00:00Z,892,1137,52018,245,0.004709908,0.021857818,0.01714791,2013,FIS
2014-02-28T00:00:00Z,899,1105,49156,206,0.00419074,0.022479453,0.018288713,2014,FIS
2015-02-27T00:00:00Z,870,1103,47706,233,0.004884082,0.023120781,0.0182367,2015,FIS
2016-02-26T00:00:00Z,1068,1336,56704,268,0.004726298,0.023560948,0.01883465,2016,FIS
2017-02-23T00:00:00Z,1036,1366,57255,330,0.005763689,0.023858178,0.01809449,2017,FIS
2018-02-22T00:00:00Z,1035,1350,56807,315,0.005545091,0.023764677,0.018219586,2018,FIS
2019-02-21T00:00:00Z,1104,1427,58174,323,0.005552309,0.024529859,0.01897755,2019,FIS
2011-02-28T00:00:00Z,970,1297,58212,327,0.005617398,0.022280629,0.016663231,2011,KFT
2012-02-27T00:00:00Z,946,1247,57030,301,0.005277924,0.021865685,0.016587761,2012,KFT
2013-02-25T00:00:00Z,921,1332,59906,411,0.006860749,0.022234835,0.015374086,2013,KFT
2014-03-03T00:00:00Z,1175,1519,69761,344,0.004931122,0.021774344,0.016843222,2014,KFT
2015-02-20T00:00:00Z,1036,1454,61019,418,0.006850325,0.023828644,0.016978318,2015,KFT
2016-02-19T00:00:00Z,1176,1599,70194,423,0.006026156,0.022779725,0.016753569,2016,KFT
2017-02-24T00:00:00Z,1218,1695,74054,477,0.006441246,0.022888703,0.016447457,2017,KFT
2018-02-09T00:00:00Z,329,588,26193,259,0.009888138,0.022448746,0.012560608,2018,KFT
2019-02-08T00:00:00Z,1200,1689,74382,489,0.006574171,0.022707107,0.016132935,2019,KFT
2011-02-28T00:00:00Z,970,1297,58212,327,0.005617398,0.022280629,0.016663231,2011,MDLZ
2012-02-27T00:00:00Z,946,1247,57030,301,0.005277924,0.021865685,0.016587761,2012,MDLZ
2013-02-25T00:00:00Z,921,1332,59906,411,0.006860749,0.022234835,0.015374086,2013,MDLZ
2014-03-03T00:00:00Z,1175,1519,69761,344,0.004931122,0.021774344,0.016843222,2014,MDLZ
2015-02-20T00:00:00Z,1036,1454,61019,418,0.006850325,0.023828644,0.016978318,2015,MDLZ
2016-02-19T00:00:00Z,1176,1599,70194,423,0.006026156,0.022779725,0.016753569,2016,MDLZ
2017-02-24T00:00:00Z,1218,1695,74054,477,0.006441246,0.022888703,0.016447457,2017,MDLZ
2018-02-09T00:00:00Z,329,588,26193,259,0.009888138,0.022448746,0.012560608,2018,MDLZ
2019-02-08T00:00:00Z,1200,1689,74382,489,0.006574171,0.022707107,0.016132935,2019,MDLZ
2013-02-28T00:00:00Z,1390,1682,71317,292,0.004094395,0.02358484,0.019490444,2013,WSH
2014-02-27T00:00:00Z,1535,1842,80182,307,0.00382879,0.022972737,0.019143948,2014,WSH
2015-02-24T00:00:00Z,1367,1593,71349,226,0.003167529,0.022326872,0.019159344,2015,WSH
2016-02-29T00:00:00Z,1874,2154,94790,280,0.002953898,0.022723916,0.019770018,2016,WSH
2017-03-01T00:00:00Z,1655,2218,93581,563,0.006016178,0.023701392,0.017685214,2017,WSH
2018-02-28T00:00:00Z,1638,2494,100366,856,0.008528785,0.024849052,0.016320268,2018,WSH
2019-02-27T00:00:00Z,1618,2483,98192,865,0.008809272,0.025287192,0.016477921,2019,WSH
2013-02-28T00:00:00Z,1390,1682,71317,292,0.004094395,0.02358484,0.019490444,2013,WLTW
2014-02-27T00:00:00Z,1535,1842,80182,307,0.00382879,0.022972737,0.019143948,2014,WLTW
2015-02-24T00:00:00Z,1367,1593,71349,226,0.003167529,0.022326872,0.019159344,2015,WLTW
2016-02-29T00:00:00Z,1874,2154,94790,280,0.002953898,0.022723916,0.019770018,2016,WLTW
2017-03-01T00:00:00Z,1655,2218,93581,563,0.006016178,0.023701392,0.017685214,2017,WLTW
2018-02-28T00:00:00Z,1638,2494,100366,856,0.008528785,0.024849052,0.016320268,2018,WLTW
2019-02-27T00:00:00Z,1618,2483,98192,865,0.008809272,0.025287192,0.016477921,2019,WLTW
2010-02-25T00:00:00Z,718,1136,45214,418,0.009244924,0.025124961,0.015880037,2010,ZMH
2011-02-25T00:00:00Z,779,1140,46996,361,0.007681505,0.024257384,0.016575879,2011,ZMH
2012-02-27T00:00:00Z,841,1147,48782,306,0.006272806,0.023512771,0.017239966,2012,ZMH
2013-02-27T00:00:00Z,800,1080,45117,280,0.006206086,0.023937762,0.017731675,2013,ZMH
2014-02-28T00:00:00Z,832,1094,45694,262,0.005733794,0.023941874,0.01820808,2014,ZMH
2015-02-23T00:00:00Z,910,1165,49774,255,0.005123157,0.023405794,0.018282638,2015,ZMH
2016-02-29T00:00:00Z,960,1128,53479,168,0.00314142,0.021092391,0.017950971,2016,ZMH
2017-03-01T00:00:00Z,1028,1174,54675,146,0.002670325,0.021472337,0.018802012,2017,ZMH
2018-02-27T00:00:00Z,1066,1302,55747,236,0.004233412,0.023355517,0.019122105,2018,ZMH
2019-02-26T00:00:00Z,1053,1221,55590,168,0.003022126,0.021964382,0.018942256,2019,ZMH
2010-02-25T00:00:00Z,718,1136,45214,418,0.009244924,0.025124961,0.015880037,2010,ZBH
2011-02-25T00:00:00Z,779,1140,46996,361,0.007681505,0.024257384,0.016575879,2011,ZBH
2012-02-27T00:00:00Z,841,1147,48782,306,0.006272806,0.023512771,0.017239966,2012,ZBH
2013-02-27T00:00:00Z,800,1080,45117,280,0.006206086,0.023937762,0.017731675,2013,ZBH
2014-02-28T00:00:00Z,832,1094,45694,262,0.005733794,0.023941874,0.01820808,2014,ZBH
2015-02-23T00:00:00Z,910,1165,49774,255,0.005123157,0.023405794,0.018282638,2015,ZBH
2016-02-29T00:00:00Z,960,1128,53479,168,0.00314142,0.021092391,0.017950971,2016,ZBH
2017-03-01T00:00:00Z,1028,1174,54675,146,0.002670325,0.021472337,0.018802012,2017,ZBH
2018-02-27T00:00:00Z,1066,1302,55747,236,0.004233412,0.023355517,0.019122105,2018,ZBH
2019-02-26T00:00:00Z,1053,1221,55590,168,0.003022126,0.021964382,0.018942256,2019,ZBH
2010-10-26T00:00:00Z,902,1441,61126,539,0.008817852,0.023574256,0.014756405,2010,ACN
2011-10-21T00:00:00Z,860,1370,57985,510,0.008795378,0.0236268,0.014831422,2011,ACN
2012-10-30T00:00:00Z,883,1356,57475,473,0.008229665,0.023592866,0.015363201,2012,ACN
2013-10-29T00:00:00Z,902,1433,59511,531,0.00892272,0.024079582,0.015156862,2013,ACN
2014-10-24T00:00:00Z,837,1312,56601,475,0.008392078,0.023179802,0.014787725,2014,ACN
2015-10-30T00:00:00Z,779,1204,53156,425,0.007995334,0.022650312,0.014654978,2015,ACN
2016-10-28T00:00:00Z,786,1279,54600,493,0.009029304,0.023424908,0.014395604,2016,ACN
2017-10-26T00:00:00Z,787,1269,52900,482,0.009111531,0.023988658,0.014877127,2017,ACN
2018-10-24T00:00:00Z,773,1207,51066,434,0.008498805,0.023636079,0.015137273,2018,ACN
2013-02-28T00:00:00Z,993,2154,73484,1161,0.015799358,0.029312503,0.013513146,2013,LMC
2014-02-28T00:00:00Z,806,1890,60989,1084,0.017773697,0.030989195,0.013215498,2014,LMC
2015-02-26T00:00:00Z,1075,2272,80380,1197,0.014891764,0.028265738,0.013373974,2015,LMC
2016-02-26T00:00:00Z,786,1879,64157,1093,0.017036333,0.029287529,0.012251196,2016,LMC
2017-02-28T00:00:00Z,1201,3030,98818,1829,0.018508774,0.03066243,0.012153656,2017,LMC
2018-03-01T00:00:00Z,1265,2899,96353,1634,0.016958476,0.030087283,0.013128808,2018,LMC
2019-02-28T00:00:00Z,1245,2824,94788,1579,0.016658227,0.029792801,0.013134574,2019,LMC
2010-02-18T00:00:00Z,1366,2381,88166,1015,0.011512374,0.027005875,0.015493501,2010,ATH
2011-02-17T00:00:00Z,1448,2460,91382,1012,0.011074391,0.026919962,0.015845571,2011,ATH
2012-02-22T00:00:00Z,1279,2261,79203,982,0.01239852,0.028546898,0.016148378,2012,ATH
2013-02-22T00:00:00Z,1326,2381,83835,1055,0.012584243,0.028401026,0.015816783,2013,ATH
2014-02-20T00:00:00Z,1382,2447,85861,1065,0.012403769,0.028499552,0.016095783,2014,ATH
2015-02-24T00:00:00Z,1461,2504,88093,1043,0.01183976,0.028424506,0.016584746,2015,ATH
2016-02-19T00:00:00Z,1526,2561,92063,1035,0.011242301,0.027817907,0.016575606,2016,ATH
2017-02-22T00:00:00Z,1548,2651,94803,1103,0.011634653,0.02796325,0.016328597,2017,ATH
2018-02-21T00:00:00Z,1480,2575,93141,1095,0.011756369,0.027646257,0.015889887,2018,ATH
2019-02-20T00:00:00Z,1473,2500,89483,1027,0.01147704,0.027938268,0.016461227,2019,ATH
2010-02-18T00:00:00Z,1366,2381,88166,1015,0.011512374,0.027005875,0.015493501,2010,WLP
2011-02-17T00:00:00Z,1448,2460,91382,1012,0.011074391,0.026919962,0.015845571,2011,WLP
2012-02-22T00:00:00Z,1279,2261,79203,982,0.01239852,0.028546898,0.016148378,2012,WLP
2013-02-22T00:00:00Z,1326,2381,83835,1055,0.012584243,0.028401026,0.015816783,2013,WLP
2014-02-20T00:00:00Z,1382,2447,85861,1065,0.012403769,0.028499552,0.016095783,2014,WLP
2015-02-24T00:00:00Z,1461,2504,88093,1043,0.01183976,0.028424506,0.016584746,2015,WLP
2016-02-19T00:00:00Z,1526,2561,92063,1035,0.011242301,0.027817907,0.016575606,2016,WLP
2017-02-22T00:00:00Z,1548,2651,94803,1103,0.011634653,0.02796325,0.016328597,2017,WLP
2018-02-21T00:00:00Z,1480,2575,93141,1095,0.011756369,0.027646257,0.015889887,2018,WLP
2019-02-20T00:00:00Z,1473,2500,89483,1027,0.01147704,0.027938268,0.016461227,2019,WLP
2010-02-18T00:00:00Z,1366,2381,88166,1015,0.011512374,0.027005875,0.015493501,2010,ANTM
2011-02-17T00:00:00Z,1448,2460,91382,1012,0.011074391,0.026919962,0.015845571,2011,ANTM
2012-02-22T00:00:00Z,1279,2261,79203,982,0.01239852,0.028546898,0.016148378,2012,ANTM
2013-02-22T00:00:00Z,1326,2381,83835,1055,0.012584243,0.028401026,0.015816783,2013,ANTM
2014-02-20T00:00:00Z,1382,2447,85861,1065,0.012403769,0.028499552,0.016095783,2014,ANTM
2015-02-24T00:00:00Z,1461,2504,88093,1043,0.01183976,0.028424506,0.016584746,2015,ANTM
2016-02-19T00:00:00Z,1526,2561,92063,1035,0.011242301,0.027817907,0.016575606,2016,ANTM
2017-02-22T00:00:00Z,1548,2651,94803,1103,0.011634653,0.02796325,0.016328597,2017,ANTM
2018-02-21T00:00:00Z,1480,2575,93141,1095,0.011756369,0.027646257,0.015889887,2018,ANTM
2019-02-20T00:00:00Z,1473,2500,89483,1027,0.01147704,0.027938268,0.016461227,2019,ANTM
2010-02-17T00:00:00Z,2404,3060,116905,656,0.005611394,0.026175099,0.020563706,2010,PFG
2011-02-16T00:00:00Z,2390,3118,121005,728,0.00601628,0.02576753,0.01975125,2011,PFG
2012-02-15T00:00:00Z,2271,3080,120643,809,0.006705735,0.025529869,0.018824134,2012,PFG
2013-02-13T00:00:00Z,2368,3225,127168,857,0.006739117,0.025360153,0.018621037,2013,PFG
2014-02-12T00:00:00Z,2330,3240,127596,910,0.007131885,0.025392646,0.018260761,2014,PFG
2015-02-11T00:00:00Z,2305,3075,122216,770,0.006300321,0.025160372,0.018860051,2015,PFG
2016-02-10T00:00:00Z,2355,3080,122993,725,0.005894644,0.025042076,0.019147431,2016,PFG
2017-02-08T00:00:00Z,2381,3220,124632,839,0.006731818,0.025836061,0.019104243,2017,PFG
2018-02-09T00:00:00Z,2412,3321,126103,909,0.007208393,0.026335615,0.019127221,2018,PFG
2019-02-13T00:00:00Z,2349,3315,126417,966,0.007641377,0.026222739,0.018581362,2019,PFG
2010-03-02T00:00:00Z,605,1015,47215,410,0.008683681,0.021497405,0.012813724,2010,AAP
2011-03-01T00:00:00Z,565,912,44321,347,0.007829246,0.020577153,0.012747907,2011,AAP
2012-02-28T00:00:00Z,542,897,43109,355,0.008234939,0.02080772,0.012572781,2012,AAP
2013-02-25T00:00:00Z,604,884,44193,280,0.006335845,0.020003168,0.013667323,2013,AAP
2014-02-25T00:00:00Z,654,932,47788,278,0.00581736,0.019502804,0.013685444,2014,AAP
2015-03-03T00:00:00Z,651,950,47854,299,0.006248172,0.01985205,0.013603878,2015,AAP
2016-03-01T00:00:00Z,673,967,48567,294,0.006053493,0.019910639,0.013857146,2016,AAP
2017-02-28T00:00:00Z,623,978,47731,355,0.007437514,0.020489828,0.013052314,2017,AAP
2018-02-21T00:00:00Z,442,711,34407,269,0.007818177,0.0206644,0.012846223,2018,AAP
2019-02-19T00:00:00Z,455,719,34086,264,0.007745115,0.021093704,0.013348589,2019,AAP
2011-02-25T00:00:00Z,5065,6373,264168,1308,0.004951395,0.024124799,0.019173405,2011,PRU
2012-02-24T00:00:00Z,4947,6333,264902,1386,0.005232124,0.023906954,0.018674831,2012,PRU
2013-02-22T00:00:00Z,4112,5381,220633,1269,0.005751633,0.024388917,0.018637285,2013,PRU
2014-02-27T00:00:00Z,4495,5420,223250,925,0.004143337,0.024277716,0.020134378,2014,PRU
2015-02-20T00:00:00Z,4456,5249,216791,793,0.003657901,0.02421226,0.020554359,2015,PRU
2016-02-19T00:00:00Z,4189,5029,202778,840,0.004142461,0.024800521,0.02065806,2016,PRU
2017-02-17T00:00:00Z,4208,4876,201629,668,0.003313015,0.024183029,0.020870014,2017,PRU
2018-02-16T00:00:00Z,3816,4613,186480,797,0.004273917,0.024737237,0.02046332,2018,PRU
2019-02-15T00:00:00Z,3639,4361,179426,722,0.004023943,0.024305285,0.020281342,2019,PRU
2010-02-22T00:00:00Z,893,1000,47779,107,0.002239478,0.020929697,0.01869022,2010,CNTE
2011-02-22T00:00:00Z,875,1068,48496,193,0.00397971,0.022022435,0.018042725,2011,CNTE
2012-02-21T00:00:00Z,863,1106,47968,243,0.005065877,0.023057038,0.017991161,2012,CNTE
2013-02-19T00:00:00Z,906,1178,49973,272,0.005442939,0.023572729,0.01812979,2013,CNTE
2014-02-21T00:00:00Z,823,1028,46573,205,0.004401692,0.022072875,0.017671183,2014,CNTE
2015-02-23T00:00:00Z,852,1049,48237,197,0.004084002,0.021746792,0.01766279,2015,CNTE
2016-02-22T00:00:00Z,969,1164,54069,195,0.003606503,0.021528047,0.017921545,2016,CNTE
2017-02-21T00:00:00Z,1076,1468,61947,392,0.00632799,0.023697677,0.017369687,2017,CNTE
2018-02-20T00:00:00Z,1193,1555,65706,362,0.00550939,0.023666027,0.018156637,2018,CNTE
2019-02-19T00:00:00Z,1072,1445,61668,373,0.006048518,0.023431926,0.017383408,2019,CNTE
2012-02-10T00:00:00Z,566,722,38088,156,0.004095778,0.018956102,0.014860323,2012,NFLX
2013-02-01T00:00:00Z,526,778,37896,252,0.006649778,0.020529871,0.013880093,2013,NFLX
2014-02-03T00:00:00Z,510,662,34004,152,0.004470062,0.019468298,0.014998236,2014,NFLX
2015-01-29T00:00:00Z,500,676,32926,176,0.00534532,0.020530887,0.015185568,2015,NFLX
2016-01-28T00:00:00Z,556,661,33318,105,0.00315145,0.019839126,0.016687676,2016,NFLX
2017-01-27T00:00:00Z,508,649,31876,141,0.004423391,0.020360146,0.015936755,2017,NFLX
2018-01-29T00:00:00Z,522,671,33736,149,0.004416647,0.019889732,0.015473085,2018,NFLX
2019-01-29T00:00:00Z,543,675,34378,132,0.003839665,0.01963465,0.015794985,2019,NFLX
2012-02-22T00:00:00Z,790,814,44143,24,0.000543688,0.01844007,0.017896382,2012,XEC
2013-02-26T00:00:00Z,762,725,41866,-37,-0.000883772,0.017317155,0.018200927,2013,XEC
2014-02-26T00:00:00Z,763,703,40357,-60,-0.001486731,0.017419531,0.018906262,2014,XEC
2015-02-25T00:00:00Z,792,748,42279,-44,-0.001040706,0.017691998,0.018732704,2015,XEC
2016-02-23T00:00:00Z,906,794,46445,-112,-0.002411454,0.017095489,0.019506944,2016,XEC
2017-02-24T00:00:00Z,944,819,46430,-125,-0.002692225,0.017639457,0.020331682,2017,XEC
2018-02-23T00:00:00Z,968,842,48866,-126,-0.00257848,0.017230794,0.019809274,2018,XEC
2019-02-20T00:00:00Z,1017,957,52362,-60,-0.001145869,0.018276613,0.019422482,2019,XEC
2011-03-01T00:00:00Z,1158,1183,66947,25,0.00037343,0.017670695,0.017297265,2011,WYNN
2012-02-29T00:00:00Z,1230,1258,67789,28,0.000413046,0.018557583,0.018144537,2012,WYNN
2013-03-01T00:00:00Z,1481,1619,81005,138,0.001703599,0.019986421,0.018282822,2013,WYNN
2014-02-28T00:00:00Z,1473,1618,78648,145,0.001843658,0.020572678,0.01872902,2014,WYNN
2015-03-02T00:00:00Z,1543,1742,82853,199,0.002401844,0.021025189,0.018623345,2015,WYNN
2016-02-29T00:00:00Z,1457,1708,78495,251,0.003197656,0.021759348,0.018561692,2016,WYNN
2017-02-24T00:00:00Z,1393,1647,76219,254,0.003332502,0.021608785,0.018276283,2017,WYNN
2018-02-28T00:00:00Z,1317,1646,74895,329,0.004392817,0.021977435,0.017584618,2018,WYNN
2019-02-28T00:00:00Z,1337,1565,72568,228,0.003141881,0.021565979,0.018424099,2019,WYNN
2011-02-25T00:00:00Z,734,818,46771,84,0.001795985,0.01748947,0.015693485,2011,LKQX
2012-02-27T00:00:00Z,796,1002,53379,206,0.003859196,0.018771427,0.014912231,2012,LKQX
2013-03-01T00:00:00Z,748,1003,52523,255,0.004855016,0.019096396,0.01424138,2013,LKQX
2014-03-03T00:00:00Z,856,1012,55868,156,0.002792296,0.018114126,0.01532183,2014,LKQX
2015-03-02T00:00:00Z,900,1136,61091,236,0.003863089,0.01859521,0.014732121,2015,LKQX
2016-02-25T00:00:00Z,1030,1160,67089,130,0.001937725,0.017290465,0.01535274,2016,LKQX
2017-02-27T00:00:00Z,1102,1144,66374,42,0.000632778,0.017235665,0.016602887,2017,LKQX
2018-02-28T00:00:00Z,1202,1218,70526,16,0.000226867,0.017270227,0.01704336,2018,LKQX
2019-03-01T00:00:00Z,1315,1454,78075,139,0.001780339,0.018623119,0.016842779,2019,LKQX
2011-02-25T00:00:00Z,734,818,46771,84,0.001795985,0.01748947,0.015693485,2011,LKQ
2012-02-27T00:00:00Z,796,1002,53379,206,0.003859196,0.018771427,0.014912231,2012,LKQ
2013-03-01T00:00:00Z,748,1003,52523,255,0.004855016,0.019096396,0.01424138,2013,LKQ
2014-03-03T00:00:00Z,856,1012,55868,156,0.002792296,0.018114126,0.01532183,2014,LKQ
2015-03-02T00:00:00Z,900,1136,61091,236,0.003863089,0.01859521,0.014732121,2015,LKQ
2016-02-25T00:00:00Z,1030,1160,67089,130,0.001937725,0.017290465,0.01535274,2016,LKQ
2017-02-27T00:00:00Z,1102,1144,66374,42,0.000632778,0.017235665,0.016602887,2017,LKQ
2018-02-28T00:00:00Z,1202,1218,70526,16,0.000226867,0.017270227,0.01704336,2018,LKQ
2019-03-01T00:00:00Z,1315,1454,78075,139,0.001780339,0.018623119,0.016842779,2019,LKQ
2011-03-01T00:00:00Z,1224,1641,79119,417,0.005270542,0.020740909,0.015470367,2011,CBG
2012-02-29T00:00:00Z,1201,1688,83431,487,0.005837159,0.020232288,0.014395129,2012,CBG
2013-03-01T00:00:00Z,1285,1679,82533,394,0.004773848,0.020343378,0.01556953,2013,CBG
2014-03-03T00:00:00Z,1302,1754,82951,452,0.005449,0.021145013,0.015696013,2014,CBG
2015-03-02T00:00:00Z,1264,1789,82809,525,0.006339891,0.021603932,0.015264041,2015,CBG
2016-02-29T00:00:00Z,990,1365,65817,375,0.005697616,0.020739323,0.015041707,2016,CBG
2017-03-01T00:00:00Z,966,1321,63962,355,0.00555017,0.020652888,0.015102717,2017,CBG
2018-03-01T00:00:00Z,979,1353,65548,374,0.005705742,0.020641362,0.01493562,2018,CBG
2019-03-01T00:00:00Z,1052,1506,70144,454,0.0064724,0.021470119,0.014997719,2019,CBG
2011-03-01T00:00:00Z,1224,1641,79119,417,0.005270542,0.020740909,0.015470367,2011,CBRE
2012-02-29T00:00:00Z,1201,1688,83431,487,0.005837159,0.020232288,0.014395129,2012,CBRE
2013-03-01T00:00:00Z,1285,1679,82533,394,0.004773848,0.020343378,0.01556953,2013,CBRE
2014-03-03T00:00:00Z,1302,1754,82951,452,0.005449,0.021145013,0.015696013,2014,CBRE
2015-03-02T00:00:00Z,1264,1789,82809,525,0.006339891,0.021603932,0.015264041,2015,CBRE
2016-02-29T00:00:00Z,990,1365,65817,375,0.005697616,0.020739323,0.015041707,2016,CBRE
2017-03-01T00:00:00Z,966,1321,63962,355,0.00555017,0.020652888,0.015102717,2017,CBRE
2018-03-01T00:00:00Z,979,1353,65548,374,0.005705742,0.020641362,0.01493562,2018,CBRE
2019-03-01T00:00:00Z,1052,1506,70144,454,0.0064724,0.021470119,0.014997719,2019,CBRE
2004-03-30T00:00:00Z,653,921,51473,268,0.005206613,0.017892876,0.012686263,2004,EXR
2005-03-16T00:00:00Z,796,1084,58840,288,0.00489463,0.018422842,0.013528212,2005,EXR
2006-03-15T00:00:00Z,991,1288,67365,297,0.004408818,0.019119721,0.014710903,2006,EXR
2007-04-02T00:00:00Z,934,1293,65331,359,0.005495094,0.019791523,0.014296429,2007,EXR
2008-04-29T00:00:00Z,669,906,44793,237,0.005291005,0.020226375,0.014935369,2008,EXR
2009-03-31T00:00:00Z,644,898,42510,254,0.005975065,0.021124441,0.015149377,2009,EXR
2013-02-28T00:00:00Z,1246,2637,98249,1391,0.014157905,0.026839968,0.012682063,2013,DLR
2014-03-03T00:00:00Z,1271,2677,101724,1406,0.013821714,0.026316307,0.012494593,2014,DLR
2015-03-02T00:00:00Z,1328,2885,105549,1557,0.014751442,0.027333276,0.012581834,2015,DLR
2016-02-29T00:00:00Z,1341,3042,108283,1701,0.015708837,0.028093052,0.012384215,2016,DLR
2017-03-01T00:00:00Z,1372,2988,107923,1616,0.014973639,0.027686406,0.012712767,2017,DLR
2018-03-01T00:00:00Z,1401,2902,101101,1501,0.01484654,0.028703969,0.01385743,2018,DLR
2019-02-25T00:00:00Z,1410,3005,104742,1595,0.015227893,0.028689542,0.013461649,2019,DLR
2011-07-19T00:00:00Z,524,553,33266,29,0.000871761,0.01662358,0.015751819,2011,MOS
2012-07-17T00:00:00Z,1125,1518,77569,393,0.005066457,0.019569673,0.014503216,2012,MOS
2013-07-17T00:00:00Z,1172,1576,81250,404,0.004972308,0.019396923,0.014424615,2013,MOS
2015-02-17T00:00:00Z,1111,1501,82774,390,0.004711624,0.018133713,0.013422089,2015,MOS
2016-02-19T00:00:00Z,1193,1646,85359,453,0.005306998,0.019283262,0.013976265,2016,MOS
2017-02-15T00:00:00Z,1268,1778,86422,510,0.005901275,0.020573465,0.01467219,2017,MOS
2018-02-21T00:00:00Z,1225,1699,84024,474,0.005641245,0.020220413,0.014579168,2018,MOS
2019-03-13T00:00:00Z,1287,1836,90050,549,0.006096613,0.020388673,0.01429206,2019,MOS
2010-02-18T00:00:00Z,1298,1831,92401,533,0.005768336,0.019815803,0.014047467,2010,NDAQ
2011-02-24T00:00:00Z,1397,1876,98171,479,0.004879241,0.019109513,0.014230272,2011,NDAQ
2012-02-24T00:00:00Z,1298,1869,92393,571,0.006180122,0.020228805,0.014048683,2012,NDAQ
2013-02-21T00:00:00Z,1362,1955,97172,593,0.006102581,0.020118964,0.014016383,2013,NDAQ
2014-02-24T00:00:00Z,1283,1803,93170,520,0.005581196,0.019351723,0.013770527,2014,NDAQ
2015-02-17T00:00:00Z,1206,1565,82139,359,0.00437064,0.019053069,0.014682429,2015,NDAQ
2016-02-26T00:00:00Z,1224,1635,84332,411,0.004873595,0.019387658,0.014514063,2016,NDAQ
2017-03-01T00:00:00Z,1052,1420,75488,368,0.004874947,0.018810937,0.01393599,2017,NDAQ
2018-02-28T00:00:00Z,1103,1531,78373,428,0.005461064,0.019534789,0.014073724,2018,NDAQ
2019-02-22T00:00:00Z,1193,1550,76924,357,0.004640944,0.020149758,0.015508814,2019,NDAQ
2006-03-23T00:00:00Z,457,1066,45439,609,0.013402584,0.023460023,0.01005744,2006,DISCA
2007-02-28T00:00:00Z,434,1145,47173,711,0.015072181,0.024272359,0.009200178,2007,DISCA
2008-02-15T00:00:00Z,702,1622,67116,920,0.013707611,0.024167114,0.010459503,2008,DISCA
2010-02-24T00:00:00Z,1866,2470,102982,604,0.005865103,0.023984774,0.018119671,2010,AMP
2011-02-28T00:00:00Z,2033,2724,113415,691,0.006092669,0.024017987,0.017925319,2011,AMP
2012-02-24T00:00:00Z,2156,2771,116390,615,0.005283959,0.023807887,0.018523928,2012,AMP
2013-02-27T00:00:00Z,2171,2839,116820,668,0.005718199,0.024302345,0.018584147,2013,AMP
2014-02-27T00:00:00Z,2296,2900,119232,604,0.005065754,0.02432233,0.019256575,2014,AMP
2015-02-24T00:00:00Z,2361,2893,120842,532,0.004402443,0.023940352,0.019537909,2015,AMP
2016-02-25T00:00:00Z,2181,2663,112687,482,0.004277335,0.02363183,0.019354495,2016,AMP
2017-02-23T00:00:00Z,2279,2795,117403,516,0.004395118,0.023806887,0.01941177,2017,AMP
2018-02-23T00:00:00Z,2274,2885,120197,611,0.005083322,0.024002263,0.018918941,2018,AMP
2019-02-27T00:00:00Z,2240,2791,125304,551,0.004397306,0.02227383,0.017876524,2019,AMP
2004-03-30T00:00:00Z,653,921,51473,268,0.005206613,0.017892876,0.012686263,2004,UARM
2005-03-16T00:00:00Z,796,1084,58840,288,0.00489463,0.018422842,0.013528212,2005,UARM
2006-03-15T00:00:00Z,991,1288,67365,297,0.004408818,0.019119721,0.014710903,2006,UARM
2007-04-02T00:00:00Z,934,1293,65331,359,0.005495094,0.019791523,0.014296429,2007,UARM
2008-04-29T00:00:00Z,669,906,44793,237,0.005291005,0.020226375,0.014935369,2008,UARM
2009-03-31T00:00:00Z,644,898,42510,254,0.005975065,0.021124441,0.015149377,2009,UARM
2011-02-24T00:00:00Z,550,789,39888,239,0.005991777,0.019780385,0.013788608,2011,UAA
2012-02-27T00:00:00Z,604,831,41150,227,0.005516403,0.020194411,0.014678007,2012,UAA
2013-02-25T00:00:00Z,617,814,41044,197,0.004799727,0.019832375,0.015032648,2013,UAA
2014-02-21T00:00:00Z,664,869,42183,205,0.004859778,0.020600716,0.015740938,2014,UAA
2015-02-20T00:00:00Z,674,878,42446,204,0.004806107,0.020685106,0.015878999,2015,UAA
2016-02-22T00:00:00Z,702,982,45680,280,0.006129597,0.021497373,0.015367776,2016,UAA
2017-02-23T00:00:00Z,728,959,46336,231,0.004985325,0.020696651,0.015711326,2017,UAA
2018-02-28T00:00:00Z,862,1129,50535,267,0.005283467,0.022340952,0.017057485,2018,UAA
2019-02-25T00:00:00Z,929,1189,53385,260,0.004870282,0.022272174,0.017401892,2019,UAA
2006-03-10T00:00:00Z,1118,1578,83603,460,0.005502195,0.018874921,0.013372726,2006,ICE
2007-02-26T00:00:00Z,1016,1511,79911,495,0.006194391,0.018908536,0.012714144,2007,ICE
2008-02-13T00:00:00Z,1165,1909,91437,744,0.00813675,0.020877763,0.012741013,2008,ICE
2009-02-11T00:00:00Z,1120,1856,85401,736,0.008618166,0.021732767,0.013114601,2009,ICE
2010-02-10T00:00:00Z,1106,1988,86532,882,0.010192761,0.02297416,0.012781399,2010,ICE
2011-02-09T00:00:00Z,1171,2087,88402,916,0.010361757,0.023608063,0.013246307,2011,ICE
2012-02-08T00:00:00Z,1156,1823,80293,667,0.008307075,0.022704345,0.01439727,2012,ICE
2013-02-06T00:00:00Z,1183,1898,81791,715,0.008741793,0.023205487,0.014463694,2013,ICE
2010-02-25T00:00:00Z,1011,1436,71513,425,0.005942975,0.020080265,0.01413729,2010,VIAB
2011-02-25T00:00:00Z,978,1368,70187,390,0.005556585,0.019490789,0.013934204,2011,VIAB
2012-02-23T00:00:00Z,927,1365,70209,438,0.006238516,0.019441952,0.013203435,2012,VIAB
2013-02-15T00:00:00Z,872,1250,68978,378,0.005480008,0.01812172,0.012641712,2013,VIAB
2014-02-14T00:00:00Z,873,1288,70403,415,0.005894635,0.018294675,0.01240004,2014,VIAB
2015-02-13T00:00:00Z,890,1201,64377,311,0.004830918,0.018655731,0.013824813,2015,VIAB
2016-02-16T00:00:00Z,847,1261,65382,414,0.006332018,0.019286654,0.012954636,2016,VIAB
2017-02-17T00:00:00Z,918,1334,67810,416,0.006134788,0.019672615,0.013537826,2017,VIAB
2018-02-20T00:00:00Z,947,1409,69677,462,0.006630595,0.020221881,0.013591286,2018,VIAB
2019-02-15T00:00:00Z,1003,1496,77478,493,0.006363097,0.019308707,0.01294561,2019,VIAB
2010-02-19T00:00:00Z,416,675,30250,259,0.008561983,0.02231405,0.013752066,2010,CMG
2011-02-17T00:00:00Z,459,760,32187,301,0.009351602,0.023612017,0.014260416,2011,CMG
2012-02-10T00:00:00Z,474,772,32393,298,0.009199518,0.023832309,0.014632791,2012,CMG
2013-02-08T00:00:00Z,541,810,33882,269,0.007939319,0.023906499,0.01596718,2013,CMG
2014-02-05T00:00:00Z,550,828,34538,278,0.008049105,0.023973594,0.015924489,2014,CMG
2015-02-04T00:00:00Z,566,840,35466,274,0.007725709,0.023684656,0.015958947,2015,CMG
2016-02-05T00:00:00Z,681,989,39185,308,0.007860151,0.02523925,0.017379099,2016,CMG
2017-02-07T00:00:00Z,689,1001,38563,312,0.008090657,0.025957524,0.017866867,2017,CMG
2018-02-08T00:00:00Z,764,1036,40420,272,0.006729342,0.025630876,0.018901534,2018,CMG
2019-02-08T00:00:00Z,831,1101,42948,270,0.006286672,0.025635652,0.01934898,2019,CMG
2011-02-22T00:00:00Z,1443,2015,104583,572,0.00546934,0.019266994,0.013797654,2011,UAUA
2012-02-22T00:00:00Z,1240,1768,94535,528,0.005585233,0.018702068,0.013116835,2012,UAUA
2013-02-25T00:00:00Z,1270,1589,87560,319,0.003643216,0.018147556,0.01450434,2013,UAUA
2014-02-20T00:00:00Z,1083,1278,71643,195,0.002721829,0.017838449,0.01511662,2014,UAUA
2015-02-20T00:00:00Z,1062,1199,67174,137,0.00203948,0.017849168,0.015809688,2015,UAUA
2016-02-18T00:00:00Z,1021,1158,65826,137,0.002081244,0.017591833,0.015510589,2016,UAUA
2017-02-23T00:00:00Z,867,1032,62632,165,0.002634436,0.0164772,0.013842764,2017,UAUA
2018-02-22T00:00:00Z,839,1030,64073,191,0.002980975,0.016075414,0.013094439,2018,UAUA
2019-02-28T00:00:00Z,829,1095,62702,266,0.004242289,0.017463558,0.013221269,2019,UAUA
2011-11-18T00:00:00Z,662,891,48619,229,0.004710093,0.018326169,0.013616076,2011,TDG
2012-11-16T00:00:00Z,693,950,52827,257,0.004864936,0.017983228,0.013118292,2012,TDG
2013-11-15T00:00:00Z,696,929,56980,233,0.004089154,0.016303966,0.012214812,2013,TDG
2014-11-14T00:00:00Z,703,893,55250,190,0.003438914,0.016162896,0.012723982,2014,TDG
2015-11-13T00:00:00Z,789,951,58072,162,0.00278964,0.016376223,0.013586582,2015,TDG
2016-11-15T00:00:00Z,754,968,58735,214,0.003643483,0.016480804,0.01283732,2016,TDG
2017-11-13T00:00:00Z,805,976,58991,171,0.002898747,0.016544897,0.013646149,2017,TDG
2018-11-09T00:00:00Z,873,1058,65058,185,0.002843616,0.016262412,0.013418796,2018,TDG
2011-02-24T00:00:00Z,1111,1711,77593,600,0.007732656,0.022050958,0.014318302,2011,MA
2012-02-16T00:00:00Z,1102,1722,75988,620,0.008159183,0.022661473,0.01450229,2012,MA
2013-02-14T00:00:00Z,1097,1633,69910,536,0.007667,0.023358604,0.015691603,2013,MA
2014-02-14T00:00:00Z,952,1334,57005,382,0.006701167,0.023401456,0.016700289,2014,MA
2015-02-13T00:00:00Z,884,1241,52433,357,0.006808689,0.0236683,0.016859611,2015,MA
2016-02-12T00:00:00Z,883,1181,50328,298,0.005921157,0.023466063,0.017544905,2016,MA
2017-02-15T00:00:00Z,921,1281,53882,360,0.006681266,0.023774173,0.017092907,2017,MA
2018-02-14T00:00:00Z,1048,1504,61700,456,0.0073906,0.024376013,0.016985413,2018,MA
2019-02-13T00:00:00Z,1010,1546,60809,536,0.008814485,0.025423868,0.016609383,2019,MA
2010-02-26T00:00:00Z,1152,1570,73696,418,0.00567195,0.021303734,0.015631785,2010,WU
2011-02-25T00:00:00Z,1194,1575,73501,381,0.005183603,0.02142828,0.016244677,2011,WU
2012-02-24T00:00:00Z,1260,1638,76990,378,0.004909729,0.02127549,0.016365762,2012,WU
2013-02-22T00:00:00Z,1297,1650,76853,353,0.004593184,0.021469559,0.016876374,2013,WU
2014-02-24T00:00:00Z,1544,1687,81779,143,0.001748615,0.020628768,0.018880153,2014,WU
2015-02-20T00:00:00Z,1541,1649,80406,108,0.001343183,0.02050842,0.019165236,2015,WU
2016-02-19T00:00:00Z,1632,1653,81013,21,0.000259218,0.020404133,0.020144915,2016,WU
2017-02-22T00:00:00Z,1720,1701,85921,-19,-0.000221133,0.019797256,0.020018389,2017,WU
2018-02-22T00:00:00Z,1742,1709,88441,-33,-0.00037313,0.019323617,0.019696747,2018,WU
2019-02-21T00:00:00Z,1738,1758,88320,20,0.000226449,0.019904891,0.019678442,2019,WU
2010-03-30T00:00:00Z,216,485,25596,269,0.010509455,0.018948273,0.008438819,2010,ROST
2011-03-29T00:00:00Z,206,479,25531,273,0.010692883,0.018761506,0.008068622,2011,ROST
2012-03-27T00:00:00Z,227,529,26410,302,0.011435062,0.020030292,0.008595229,2012,ROST
2013-04-02T00:00:00Z,232,467,24501,235,0.009591445,0.019060447,0.009469001,2013,ROST
2014-04-01T00:00:00Z,243,454,24386,211,0.008652506,0.018617239,0.009964734,2014,ROST
2015-03-31T00:00:00Z,244,467,24409,223,0.009135974,0.019132287,0.009996313,2015,ROST
2016-03-29T00:00:00Z,387,592,28441,205,0.007207904,0.020815021,0.013607116,2016,ROST
2017-03-28T00:00:00Z,394,614,28379,220,0.007752211,0.021635717,0.013883505,2017,ROST
2018-04-03T00:00:00Z,409,663,29550,254,0.008595601,0.022436548,0.013840948,2018,ROST
2019-04-02T00:00:00Z,418,658,30274,240,0.007927595,0.021734822,0.013807227,2019,ROST
2010-03-15T00:00:00Z,719,929,42351,210,0.004958561,0.021935728,0.016977167,2010,IPGP
2011-03-15T00:00:00Z,701,907,42796,206,0.004813534,0.021193569,0.016380036,2011,IPGP
2012-02-27T00:00:00Z,700,948,44355,248,0.005591252,0.021373013,0.015781761,2012,IPGP
2013-02-28T00:00:00Z,697,1000,45642,303,0.006638622,0.021909645,0.015271022,2013,IPGP
2014-02-28T00:00:00Z,709,981,44585,272,0.006100707,0.022002916,0.015902209,2014,IPGP
2015-03-02T00:00:00Z,714,977,45042,263,0.005838995,0.021690866,0.015851872,2015,IPGP
2016-02-26T00:00:00Z,750,1013,46845,263,0.00561426,0.021624506,0.016010247,2016,IPGP
2017-02-27T00:00:00Z,750,1066,49648,316,0.006364808,0.021471157,0.015106349,2017,IPGP
2018-02-28T00:00:00Z,776,1127,50819,351,0.006906866,0.022176745,0.015269879,2018,IPGP
2019-02-27T00:00:00Z,820,1178,55708,358,0.006426366,0.021145975,0.014719609,2019,IPGP
2004-03-30T00:00:00Z,653,921,51473,268,0.005206613,0.017892876,0.012686263,2004,TEL
2005-03-16T00:00:00Z,796,1084,58840,288,0.00489463,0.018422842,0.013528212,2005,TEL
2006-03-15T00:00:00Z,991,1288,67365,297,0.004408818,0.019119721,0.014710903,2006,TEL
2007-04-02T00:00:00Z,934,1293,65331,359,0.005495094,0.019791523,0.014296429,2007,TEL
2008-04-29T00:00:00Z,669,906,44793,237,0.005291005,0.020226375,0.014935369,2008,TEL
2009-03-31T00:00:00Z,644,898,42510,254,0.005975065,0.021124441,0.015149377,2009,TEL
2010-03-31T00:00:00Z,587,944,36637,357,0.009744248,0.025766302,0.016022054,2010,ULTA
2011-03-30T00:00:00Z,516,900,35118,384,0.010934563,0.025627883,0.01469332,2011,ULTA
2012-03-28T00:00:00Z,506,843,34041,337,0.009899827,0.024764255,0.014864428,2012,ULTA
2013-04-03T00:00:00Z,470,786,32127,316,0.009835964,0.024465403,0.014629439,2013,ULTA
2014-04-02T00:00:00Z,542,818,34768,276,0.007938334,0.023527382,0.015589047,2014,ULTA
2015-04-01T00:00:00Z,538,867,36874,329,0.008922276,0.023512502,0.014590226,2015,ULTA
2016-03-30T00:00:00Z,480,910,37298,430,0.011528768,0.024398091,0.012869323,2016,ULTA
2017-03-28T00:00:00Z,470,999,37989,529,0.013925084,0.026297086,0.012372002,2017,ULTA
2018-04-03T00:00:00Z,505,1019,38976,514,0.013187603,0.026144294,0.012956691,2018,ULTA
2019-04-02T00:00:00Z,479,1027,38017,548,0.014414604,0.02701423,0.012599626,2019,ULTA
2004-03-30T00:00:00Z,653,921,51473,268,0.005206613,0.017892876,0.012686263,2004,MXB
2005-03-16T00:00:00Z,796,1084,58840,288,0.00489463,0.018422842,0.013528212,2005,MXB
2006-03-15T00:00:00Z,991,1288,67365,297,0.004408818,0.019119721,0.014710903,2006,MXB
2007-04-02T00:00:00Z,934,1293,65331,359,0.005495094,0.019791523,0.014296429,2007,MXB
2008-04-29T00:00:00Z,669,906,44793,237,0.005291005,0.020226375,0.014935369,2008,MXB
2009-03-31T00:00:00Z,644,898,42510,254,0.005975065,0.021124441,0.015149377,2009,MXB
2004-03-30T00:00:00Z,653,921,51473,268,0.005206613,0.017892876,0.012686263,2004,MSCI
2005-03-16T00:00:00Z,796,1084,58840,288,0.00489463,0.018422842,0.013528212,2005,MSCI
2006-03-15T00:00:00Z,991,1288,67365,297,0.004408818,0.019119721,0.014710903,2006,MSCI
2007-04-02T00:00:00Z,934,1293,65331,359,0.005495094,0.019791523,0.014296429,2007,MSCI
2008-04-29T00:00:00Z,669,906,44793,237,0.005291005,0.020226375,0.014935369,2008,MSCI
2009-03-31T00:00:00Z,644,898,42510,254,0.005975065,0.021124441,0.015149377,2009,MSCI
2004-03-30T00:00:00Z,653,921,51473,268,0.005206613,0.017892876,0.012686263,2004,PM
2005-03-16T00:00:00Z,796,1084,58840,288,0.00489463,0.018422842,0.013528212,2005,PM
2006-03-15T00:00:00Z,991,1288,67365,297,0.004408818,0.019119721,0.014710903,2006,PM
2007-04-02T00:00:00Z,934,1293,65331,359,0.005495094,0.019791523,0.014296429,2007,PM
2008-04-29T00:00:00Z,669,906,44793,237,0.005291005,0.020226375,0.014935369,2008,PM
2009-03-31T00:00:00Z,644,898,42510,254,0.005975065,0.021124441,0.015149377,2009,PM
2010-02-10T00:00:00Z,827,1450,56649,623,0.010997546,0.025596215,0.014598669,2010,UNH
2011-02-10T00:00:00Z,943,1529,59460,586,0.009855365,0.025714766,0.015859401,2011,UNH
2012-02-09T00:00:00Z,930,1568,60576,638,0.010532224,0.025884839,0.015352615,2012,UNH
2013-02-07T00:00:00Z,908,1697,62031,789,0.012719447,0.027357289,0.014637842,2013,UNH
2014-02-12T00:00:00Z,865,1540,58109,675,0.011616101,0.026501919,0.014885818,2014,UNH
2015-02-10T00:00:00Z,855,1430,56680,575,0.010144672,0.025229358,0.015084686,2015,UNH
2016-02-09T00:00:00Z,792,1330,54295,538,0.009908831,0.02449581,0.014586979,2016,UNH
2017-02-08T00:00:00Z,760,1217,51836,457,0.008816267,0.023477892,0.014661625,2017,UNH
2018-02-13T00:00:00Z,689,1116,46994,427,0.009086266,0.023747712,0.014661446,2018,UNH
2019-02-12T00:00:00Z,681,1073,45703,392,0.008577117,0.023477671,0.014900554,2019,UNH
2010-03-09T00:00:00Z,1039,1305,58697,266,0.004531748,0.022232823,0.017701075,2010,VRSK
2011-02-28T00:00:00Z,1008,1281,59165,273,0.004614214,0.021651314,0.0170371,2011,VRSK
2012-02-28T00:00:00Z,1010,1319,61170,309,0.005051496,0.021562858,0.016511362,2012,VRSK
2013-02-26T00:00:00Z,1095,1297,59679,202,0.003384775,0.021732938,0.018348163,2013,VRSK
2014-02-25T00:00:00Z,1277,1317,61700,40,0.000648298,0.021345219,0.020696921,2014,VRSK
2015-02-24T00:00:00Z,1113,1266,57534,153,0.002659297,0.02200438,0.019345083,2015,VRSK
2016-02-24T00:00:00Z,1094,1212,55933,118,0.002109667,0.021668782,0.019559115,2016,VRSK
2017-02-21T00:00:00Z,1091,1254,56795,163,0.002869971,0.022079408,0.019209437,2017,VRSK
2018-02-20T00:00:00Z,1066,1335,58457,269,0.004601673,0.022837299,0.018235626,2018,VRSK
2019-02-19T00:00:00Z,938,1302,58548,364,0.006217121,0.022238164,0.016021043,2019,VRSK
2012-02-28T00:00:00Z,1048,1112,52383,64,0.00122177,0.021228261,0.020006491,2012,FTNT
2013-02-27T00:00:00Z,1074,1151,53073,77,0.001450832,0.02168711,0.020236278,2013,FTNT
2014-03-03T00:00:00Z,1071,1188,54462,117,0.002148287,0.021813374,0.019665088,2014,FTNT
2015-03-02T00:00:00Z,1072,1167,51338,95,0.001850481,0.0227317,0.020881219,2015,FTNT
2016-02-26T00:00:00Z,1144,1329,54788,185,0.003376652,0.024257137,0.020880485,2016,FTNT
2017-03-01T00:00:00Z,1189,1396,57401,207,0.003606209,0.024320134,0.020713925,2017,FTNT
2018-02-26T00:00:00Z,1224,1403,59744,179,0.002996117,0.02348353,0.020487413,2018,FTNT
2019-02-27T00:00:00Z,1265,1349,60400,84,0.001390728,0.022334437,0.020943709,2019,FTNT
2011-03-16T00:00:00Z,663,1019,57176,356,0.006226389,0.017822163,0.011595774,2011,CBOE
2012-02-28T00:00:00Z,611,909,50801,298,0.005866026,0.017893349,0.012027322,2012,CBOE
2013-02-28T00:00:00Z,642,824,48622,182,0.003743162,0.016947061,0.013203899,2013,CBOE
2014-02-21T00:00:00Z,644,785,46395,141,0.003039121,0.016919927,0.013880806,2014,CBOE
2015-02-20T00:00:00Z,669,790,45799,121,0.002641979,0.017249285,0.014607306,2015,CBOE
2016-02-19T00:00:00Z,694,880,48958,186,0.003799175,0.01797459,0.014175416,2016,CBOE
2017-02-21T00:00:00Z,851,1131,59461,280,0.004708969,0.019020871,0.014311902,2017,CBOE
2018-02-22T00:00:00Z,1125,1481,74715,356,0.004764773,0.01982199,0.015057217,2018,CBOE
2019-02-22T00:00:00Z,1112,1447,75758,335,0.004421975,0.019100293,0.014678318,2019,CBOE